Year,Country / territory of asylum/residence,Location Name,Female 0-4,Female 5-11,Female 5-17,Female 12-17,Female 18-59,Female 60+,F: Unknown,F: Total,Male 0-4,Male 5-11,Male 5-17,Male 12-17,Male 18-59,Male 60+,M: Unknown,M: Total
2001,Afghanistan,Kabul,0,0,1,0,1,0,0,2,0,0,0,0,2,0,0,2
2001,Afghanistan,Various,14335,0,45451,0,99880,19234,412004,590904,14716,0,47522,0,114965,13025,435492,625720
2001,Afghanistan,Herat,0,0,0,0,1,0,0,1,0,0,0,0,1,0,0,1
2001,Angola,Viana,484,0,1687,0,1282,43,0,3496,597,0,1645,0,787,34,0,3063
2001,Angola,Moxico,219,0,734,0,427,25,0,1405,226,0,711,0,139,15,0,1091
2001,Angola,Malange,61,0,141,0,188,7,0,397,64,0,158,0,125,8,0,355
2001,Angola,Lunda Sul,7,0,109,0,141,2,0,259,9,0,119,0,199,34,0,361
2001,Angola,Lunda Norte,25,0,41,0,136,0,0,202,18,0,54,0,207,0,0,279
2001,Angola,Luanda,28,0,85,0,100,0,0,213,43,0,95,0,213,3,0,354
2001,Angola,Kwanza Sul,2,0,42,0,79,2,0,125,4,0,44,0,65,18,0,131
2001,Angola,Kwanza Norte,4,0,9,0,10,1,0,24,2,0,9,0,8,0,0,19
2001,Angola,Kifangondo,30,0,111,0,122,3,0,266,27,0,105,0,71,7,0,210
2001,Albania,Tirana,14,0,30,0,81,10,0,135,16,0,35,0,107,10,0,168
2001,Albania,Shkoder,0,0,2,0,3,1,0,6,1,0,1,0,3,0,0,5
2001,Albania,Shkallnur,0,0,1,0,3,1,0,5,1,0,0,0,2,3,0,6
2001,Albania,Shengjin,0,0,0,0,0,1,0,1,0,0,0,0,2,0,0,2
2001,Albania,Kurbin,0,0,1,0,0,1,0,2,0,0,0,0,0,1,0,1
2001,Albania,Fier,0,0,2,0,1,0,0,3,0,0,1,0,0,0,0,1
2001,Albania,Durres,0,0,1,0,2,1,0,4,0,0,0,0,2,2,0,4
2001,Albania,Diber,0,0,0,0,1,0,0,1,0,0,0,0,1,0,0,1
2001,Argentina,Buenos Aires,18,0,91,0,221,7,0,337,29,0,66,0,493,23,0,611
2001,Armenia,Yerevan,843,0,2381,0,14875,14062,0,32161,953,0,1990,0,13678,12287,0,28908
2001,Armenia,Vayots Dzor,140,0,278,0,946,986,0,2350,142,0,288,0,895,873,0,2198
2001,Armenia,Tavush,258,0,617,0,2420,2717,0,6012,289,0,618,0,2389,2395,0,5691
2001,Armenia,Syunik,257,0,675,0,3589,3481,0,8002,256,0,555,0,3540,3384,0,7735
2001,Armenia,Shirak,74,0,247,0,1075,808,0,2204,59,0,222,0,1022,644,0,1947
2001,Armenia,Lori,244,0,577,0,3942,4502,0,9265,278,0,640,0,3933,4030,0,8881
2001,Armenia,Kotayk,236,0,877,0,7689,8857,0,17659,280,0,932,0,7302,7622,0,16136
2001,Armenia,Gegharkunik,624,0,1578,0,6472,6366,0,15040,695,0,1527,0,5666,5772,0,13660
2001,Armenia,Armavir,153,0,384,0,5903,10590,0,17030,154,0,428,0,2944,4829,0,8355
2001,Armenia,Ararat,804,0,2173,0,14114,11936,0,29027,816,0,2241,0,11958,9084,0,24099
2001,Armenia,Aragatsotn,86,0,273,0,2458,1725,0,4542,89,0,287,0,1844,1215,0,3435
2001,Azerbaijan,Baku,358,0,1009,0,2076,66,0,3509,337,0,878,0,2127,60,0,3402
2001,Burundi,Plaine de Imbo,951,0,1513,0,1826,43,0,4333,917,0,1426,0,1019,34,0,3396
2001,Burundi,Cibitoke,453,0,803,0,944,24,0,2224,448,0,774,0,531,19,0,1772
2001,Burundi,Bujumbura,2796,0,4431,0,5894,226,0,13347,2714,0,4287,0,3617,200,0,10818
2001,Benin,Ouidah,13,0,23,0,27,0,0,63,14,0,29,0,44,0,0,87
2001,Benin,Kpomasse,78,0,155,0,270,7,0,510,91,0,191,0,377,0,0,659
2001,Benin,Cotonou,160,0,416,0,998,5,0,1579,133,0,410,0,1580,4,0,2127
2001,Bangladesh,Nayapara,1238,0,2781,0,2772,151,0,6942,1259,0,2715,0,2476,145,0,6595
2001,Bangladesh,Kutapalong,782,0,1747,0,1745,97,0,4371,793,0,1707,0,1556,97,0,4153
2001,Bangladesh,Dhaka,4,0,14,0,20,0,0,38,1,0,13,0,60,0,0,74
2001,Bahrain,Manama,0,0,0,0,1,0,0,1,0,0,0,0,0,0,0,0
2001,Belarus,Vitebsk Region,2,0,4,0,6,0,0,12,0,0,4,0,37,0,0,41
2001,Belarus,Mogilev Region,1,0,0,0,2,0,0,3,0,0,0,0,15,0,0,15
2001,Belarus,Minsk Region,2,0,26,0,21,2,0,51,4,0,13,0,33,1,0,51
2001,Belarus,Minsk,16,0,102,0,116,12,0,246,19,0,101,0,270,6,0,396
2001,Belarus,Grodno Region,0,0,0,0,1,1,0,2,0,0,0,0,1,0,0,1
2001,Belarus,Gomel Region,1,0,12,0,21,8,0,42,0,0,8,0,35,3,0,46
2001,Belarus,Brest Region,0,0,2,0,3,0,0,5,0,0,4,0,9,0,0,13
2001,Belize,Stann Creek,0,0,0,0,0,0,329,329,0,0,0,0,0,0,375,375
2001,Belize,San Ignacio,0,0,0,0,0,0,66,66,0,0,0,0,0,0,81,81
2001,Belize,Belize City,0,0,0,0,0,0,1,1,0,0,0,0,0,0,22,22
2001,Bolivia (Plurinational State of),Santa Cruz,0,0,0,0,1,0,0,1,0,0,1,0,1,0,0,2
2001,Bolivia (Plurinational State of),La Paz,0,0,1,0,1,0,0,2,1,0,0,0,0,0,0,1
2001,Bolivia (Plurinational State of),Cochabamba,0,0,0,0,1,0,0,1,0,0,0,0,1,0,0,1
2001,Botswana,Gaborone,1,0,5,0,18,0,0,24,0,0,11,0,26,0,0,37
2001,Botswana,Dukwi,218,0,438,0,601,49,0,1306,226,0,475,0,1444,69,0,2214
2001,Central African Rep.,Molangue,262,0,402,0,428,19,0,1111,233,0,464,0,501,15,0,1213
2001,Central African Rep.,Mboki,3305,0,5269,0,7118,0,0,15692,3563,0,6928,0,9535,0,0,20026
2001,Central African Rep.,Kbando,16,0,21,0,9,0,0,46,14,0,54,0,44,0,0,112
2001,Central African Rep.,Boubou,38,0,132,0,119,0,0,289,54,0,178,0,113,0,0,345
2001,Central African Rep.,Bangui,732,0,2046,0,2219,0,0,4997,512,0,2058,0,2838,0,0,5408
2001,Chile,Santiago de Chile,11,0,30,0,74,0,0,115,14,0,31,0,86,4,0,135
2001,China,Yunnan,1421,0,6139,0,12702,1750,0,22012,2675,0,6350,0,12459,1352,0,22836
2001,China,Jiangxi,31,0,92,0,452,158,0,733,51,0,106,0,450,168,0,775
2001,China,Hainan,813,0,3088,0,8290,2068,0,14259,1136,0,4114,0,8827,2338,0,16415
2001,China,Guangxi,0,0,0,0,0,0,51256,51256,0,0,0,0,0,0,57422,57422
2001,China,Guangdong,2019,0,8215,0,22196,6797,0,39227,2485,0,9394,0,24238,6570,0,42687
2001,China,Fujian,821,0,3695,0,8147,626,0,13289,1102,0,3950,0,8593,715,0,14360
2001,Côte d'Ivoire,Zone d'accueil,8749,0,26501,0,24990,4831,0,65071,6224,0,23683,0,21542,3920,0,55369
2001,Côte d'Ivoire,Yamoussoukrou,0,0,0,0,0,0,0,0,0,0,0,0,1,0,0,1
2001,Côte d'Ivoire,Tabou,0,0,1,0,1,0,0,2,0,0,4,0,3,0,0,7
2001,Côte d'Ivoire,Nicla,626,0,1368,0,1337,113,0,3444,560,0,921,0,856,69,0,2406
2001,Côte d'Ivoire,Khorogo,0,0,2,0,1,0,0,3,0,0,1,0,1,0,0,2
2001,Côte d'Ivoire,Gagnoa,0,0,0,0,0,0,0,0,0,0,0,0,1,0,0,1
2001,Côte d'Ivoire,Danane,0,0,0,0,0,0,0,0,0,0,0,0,1,0,0,1
2001,Côte d'Ivoire,Daloa,0,0,0,0,0,0,0,0,0,0,0,0,1,0,0,1
2001,Côte d'Ivoire,Bouake,0,0,3,0,13,0,0,16,2,0,4,0,6,0,0,12
2001,Côte d'Ivoire,Abidjan,44,0,257,0,744,22,0,1067,55,0,244,0,829,25,0,1153
2001,Cameroon,Yaounde,150,0,314,0,1894,4,0,2362,137,0,331,0,1513,4,0,1985
2001,Dem. Rep. of the Congo,Tshilonda (Kasai),29,0,31,0,66,2,0,128,44,0,39,0,116,2,0,201
2001,Dem. Rep. of the Congo,Tshimbumbulu,2065,0,1971,0,3590,529,0,8155,1201,0,2562,0,2829,579,0,7171
2001,Dem. Rep. of the Congo,Tshabobo,50,0,65,0,122,0,0,237,60,0,55,0,140,4,0,259
2001,Dem. Rep. of the Congo,Tshifwameso,288,0,841,0,828,44,0,2001,275,0,832,0,439,35,0,1581
2001,Dem. Rep. of the Congo,TC Kimpese,3,0,8,0,3,0,0,14,3,0,6,0,0,6,0,15
2001,Dem. Rep. of the Congo,Nkondo,1457,0,2167,0,2612,79,0,6315,1564,0,2126,0,1656,58,0,5404
2001,Dem. Rep. of the Congo,Napassa,320,0,731,0,626,34,0,1711,295,0,614,0,299,29,0,1237
2001,Dem. Rep. of the Congo,Mbanza Ngungu,186,0,299,0,359,13,0,857,179,0,347,0,512,15,0,1053
2001,Dem. Rep. of the Congo,Lusuku,59,0,72,0,175,7,0,313,59,0,70,0,75,2,0,206
2001,Dem. Rep. of the Congo,Kulindji,382,0,1068,0,981,71,0,2502,352,0,960,0,455,41,0,1808
2001,Dem. Rep. of the Congo,Kipindi,49,0,157,0,165,23,0,394,68,0,203,0,101,33,0,405
2001,Dem. Rep. of the Congo,Kisenge,1342,0,3147,0,4162,164,0,8815,1249,0,3099,0,3135,114,0,7597
2001,Dem. Rep. of the Congo,Kinsalulu,295,0,466,0,507,95,0,1363,305,0,486,0,335,46,0,1172
2001,Dem. Rep. of the Congo,Kinshasa,0,0,13,0,1295,0,0,1308,0,0,12,0,2095,0,0,2107
2001,Dem. Rep. of the Congo,Kinsafu,190,0,276,0,338,55,0,859,226,0,281,0,241,20,0,768
2001,Dem. Rep. of the Congo,Kimfwakata,354,0,536,0,605,73,0,1568,321,0,466,0,414,26,0,1227
2001,Dem. Rep. of the Congo,Kilueka,1216,0,2437,0,2391,180,0,6224,1144,0,2553,0,1685,118,0,5500
2001,Dem. Rep. of the Congo,Katsha,33,0,41,0,90,3,0,167,41,0,39,0,78,7,0,165
2001,Dem. Rep. of the Congo,Goma,5,0,19,0,14,1,0,39,6,0,26,0,21,2,0,55
2001,Dem. Rep. of the Congo,Dungu,429,0,1550,0,1556,17,0,3552,611,0,2094,0,1953,32,0,4690
2001,Dem. Rep. of the Congo,Doruma,718,0,1451,0,1389,63,0,3621,724,0,1599,0,1671,44,0,4038
2001,Dem. Rep. of the Congo,Divuma,1559,0,2876,0,3781,441,0,8657,1648,0,2839,0,3061,368,0,7916
2001,Dem. Rep. of the Congo,Bukavu,6,0,34,0,39,2,0,81,11,0,53,0,42,5,0,111
2001,Dem. Rep. of the Congo,Biringi,552,0,1103,0,1542,50,0,3247,598,0,1535,0,1324,99,0,3556
2001,Dem. Rep. of the Congo,Aba,1301,0,3595,0,3217,360,0,8473,1430,0,4362,0,3301,305,0,9398
2001,Congo,Pointe-Noire,0,0,0,0,0,0,50,50,0,0,0,0,0,0,195,195
2001,Congo,Ndjoundou/Liranga,0,0,0,0,0,0,2243,2243,0,0,0,0,0,0,2163,2163
2001,Congo,Mavoadi,16,0,31,0,22,8,0,77,14,0,25,0,11,3,0,53
2001,Congo,Loukolela,205,0,364,0,330,15,0,914,220,0,302,0,340,14,0,876
2001,Congo,Kondi Mbaka,189,0,259,0,517,38,0,1003,213,0,472,0,469,72,0,1226
2001,Congo,Komi,112,0,192,0,269,17,0,590,97,0,174,0,193,19,0,483
2001,Congo,Kintele,0,0,0,0,0,0,751,751,0,0,0,0,0,0,1449,1449
2001,Congo,Brazzaville,3,0,11,0,17,2,0,33,10,0,10,0,25,1,0,46
2001,Colombia,San Andres,0,0,2,0,10,1,0,13,0,0,1,0,12,1,0,14
2001,Colombia,Leticia,0,0,0,0,0,1,0,1,0,0,0,0,0,0,0,0
2001,Colombia,Duitama,0,0,1,0,1,1,0,3,0,0,1,0,1,0,0,2
2001,Colombia,Buenaventura,0,0,3,0,1,0,0,4,2,0,2,0,2,0,0,6
2001,Colombia,Bogota,3,0,7,0,47,20,0,77,4,0,10,0,70,18,0,102
2001,Colombia,Armenia,1,0,0,0,1,0,0,2,0,0,2,0,1,0,0,3
2001,Cuba,Havana,0,0,11,0,17,0,0,28,3,0,7,0,38,0,0,48
2001,Cuba,Guantanamo,0,0,0,0,0,0,0,0,0,0,0,0,1,0,0,1
2001,Czech Rep.,Kasava,36,0,53,0,53,3,0,145,33,0,59,0,51,2,0,145
2001,Djibouti,Djibouti City,0,0,0,0,0,0,1401,1401,0,0,0,0,0,0,727,727
2001,Djibouti,Hol-Hol,479,0,2139,0,2241,109,0,4968,382,0,2221,0,1314,120,0,4037
2001,Djibouti,Ali-Adde,640,0,2914,0,3046,175,0,6775,451,0,2179,0,2505,133,0,5268
2001,Algeria,Tindouf,13038,0,29253,0,33630,185,0,76106,13001,0,31748,0,33658,917,0,79324
2001,Egypt,Cairo,375,0,954,0,1677,175,5086,8267,409,0,1069,0,2460,111,10569,14618
2001,Eritrea,Emkulu,208,0,284,0,282,18,0,792,218,0,344,0,366,23,0,951
2001,Eritrea,Elit,59,0,32,0,92,8,0,191,88,0,52,0,188,10,0,338
2001,Estonia,Tallinn,0,0,2,0,3,0,0,5,0,0,2,0,10,0,0,12
2001,Estonia,Johvi,0,0,0,0,0,0,0,0,0,0,0,0,2,0,0,2
2001,Estonia,Kohtla-Järve,0,0,0,0,0,0,0,0,0,0,0,0,1,0,0,1
2001,Estonia,Illuka,1,0,1,0,1,0,0,3,1,0,0,0,7,0,0,8
2001,Ethiopia,Jijiga (Rabasso),87,0,2466,0,2554,266,0,5373,85,0,2539,0,1652,162,0,4438
2001,Ethiopia,Jijiga (Hartisheik),402,0,2678,0,2895,102,0,6077,425,0,2627,0,2408,105,0,5565
2001,Ethiopia,Jijiga (Kebribeyah),402,0,2678,0,2988,102,0,6170,422,0,2630,0,2332,80,0,5464
2001,Ethiopia,Jijiga (Camaboker),58,0,4723,0,5164,438,0,10383,66,0,5191,0,3888,321,0,9466
2001,Ethiopia,Jijiga (Daror),1,0,6,0,3,0,0,10,3,0,6,0,5,0,0,14
2001,Ethiopia,Gambella (Fugnido),2966,0,4575,0,6024,142,0,13707,3204,0,6124,0,5412,96,0,14836
2001,Ethiopia,Jijiga (Aisha),486,0,3015,0,3351,122,0,6974,250,0,2998,0,2760,1000,0,7008
2001,Ethiopia,Gambella (Bonga),2598,0,2240,0,3226,101,0,8165,2706,0,2400,0,2081,84,0,7271
2001,Ethiopia,Gambella (Dimma),1575,0,1541,0,2497,95,0,5708,1511,0,2944,0,5436,93,0,9984
2001,Ethiopia,Bamboudi (Yarenja),75,0,188,0,299,3,0,565,86,0,182,0,283,7,0,558
2001,Ethiopia,Addis Ababa,45,0,72,0,109,0,0,226,29,0,72,0,96,0,0,197
2001,Ethiopia,Assosa (Sherkole),1263,0,1873,0,2757,28,0,5921,1252,0,2557,0,3071,61,0,6941
2001,Ethiopia, Shimelba (Shire/Shiraro) ,346,0,700,0,740,342,0,2128,363,0,792,0,596,333,0,2084
2001,Gabon,Voungou-Pont,3,0,6,0,11,3,0,23,1,0,3,0,7,2,0,13
2001,Gabon,Rinanzala,14,0,21,0,39,4,0,78,9,0,42,0,44,0,0,95
2001,Gabon,Tchibanga,147,0,380,0,569,4,0,1100,133,0,400,0,662,5,0,1200
2001,Gabon,Pana,1,0,4,0,19,1,0,25,2,0,7,0,17,0,0,26
2001,Gabon,Rebe,2,0,7,0,6,0,0,15,2,0,7,0,8,3,0,20
2001,Gabon,Ngouoni,6,0,5,0,20,0,0,31,0,0,17,0,6,1,0,24
2001,Gabon,Nzinga,8,0,22,0,21,3,0,54,6,0,19,0,15,2,0,42
2001,Gabon,Ndende,25,0,58,0,148,4,0,235,28,0,52,0,139,2,0,221
2001,Gabon,Ndindi,3,0,10,0,17,0,0,30,3,0,5,0,17,2,0,27
2001,Gabon,Moulengui-Binza,57,0,168,0,263,25,0,513,52,0,195,0,378,18,0,643
2001,Gabon,Mounana,24,0,46,0,68,1,0,139,10,0,66,0,104,4,0,184
2001,Gabon,Moanda,124,0,390,0,585,33,0,1132,109,0,526,0,1003,162,0,1800
2001,Gabon,Mouila,17,0,49,0,93,1,0,160,14,0,41,0,112,0,0,167
2001,Gabon,Malinga,9,0,24,0,45,2,0,80,12,0,20,0,33,3,0,68
2001,Gabon,Mayumba,5,0,20,0,27,0,0,52,8,0,19,0,56,0,0,83
2001,Gabon,Libreville,201,0,641,0,1351,25,0,2218,216,0,730,0,2231,51,0,3228
2001,Gabon,Mabanda,5,0,21,0,32,1,0,59,6,0,22,0,38,1,0,67
2001,Gabon,Lebamba,4,0,16,0,20,6,0,46,2,0,9,0,17,3,0,31
2001,Gabon,Lekindou,9,0,14,0,28,2,0,53,9,0,24,0,29,5,0,67
2001,Gabon,Koumou-Doussala,2,0,3,0,8,0,0,13,1,0,8,0,6,0,0,15
2001,Gabon,Lastourville,16,0,20,0,36,1,0,73,8,0,20,0,61,2,0,91
2001,Gabon,Frontiere,6,0,18,0,37,4,0,65,9,0,16,0,28,4,0,57
2001,Gabon,Koula-Moutou,8,0,25,0,23,3,0,59,20,0,24,0,125,5,0,174
2001,Gabon,Doussala,0,0,1,0,7,2,0,10,1,0,3,0,5,0,0,9
2001,Gabon,Franceville,113,0,368,0,637,19,0,1137,70,0,320,0,1169,44,0,1603
2001,Gabon,Dienga,12,0,6,0,18,2,0,38,4,0,8,0,21,1,0,34
2001,Gabon,Dilemba,34,0,105,0,117,13,0,269,46,0,115,0,110,6,0,277
2001,Gabon,Banda Mamba,1,0,6,0,9,2,0,18,1,0,5,0,11,1,0,18
2001,Gabon,Boumango,44,0,88,0,313,19,0,464,39,0,95,0,286,8,0,428
2001,Gabon,Bakoumba,23,0,63,0,82,5,0,173,52,0,78,0,12,1,0,143
2001,Georgia,Tbilisi,1551,0,9736,0,30146,8952,0,50385,1624,0,9808,0,22732,5401,0,39565
2001,Georgia,Rustavi,77,0,535,0,1420,357,0,2389,78,0,474,0,1052,238,0,1842
2001,Georgia,Samegrelo,1313,0,11917,0,29622,12045,0,54897,1465,0,11625,0,24134,7845,0,45069
2001,Georgia,Kvemo Kartli,81,0,994,0,2258,525,0,3858,85,0,923,0,1728,354,0,3090
2001,Georgia,Poti,108,0,793,0,2450,763,0,4114,126,0,884,0,2040,499,0,3549
2001,Georgia,Khalatsani,5,0,24,0,31,5,0,65,7,0,22,0,39,1,0,69
2001,Georgia,Kutaisi,230,0,1730,0,4995,1546,0,8501,244,0,1622,0,3777,933,0,6576
2001,Georgia,Jokolo,124,0,452,0,622,45,0,1243,146,0,491,0,411,37,0,1085
2001,Georgia,Kartli,156,0,1143,0,2943,836,0,5078,175,0,1192,0,2390,613,0,4370
2001,Georgia,Duisi,291,0,900,0,1314,131,0,2636,295,0,938,0,1084,79,0,2396
2001,Georgia,Imereti,265,0,2038,0,5343,1944,0,9590,246,0,2100,0,4219,1201,0,7766
2001,Georgia,Akhmeta,4,0,21,0,21,2,0,48,4,0,13,0,10,1,0,28
2001,Georgia,Batumi,34,0,230,0,953,300,0,1517,34,0,276,0,706,148,0,1164
2001,Ghana,Volta Region,12,0,41,0,112,9,0,174,5,0,65,0,201,8,0,279
2001,Ghana,Krisan,68,0,281,0,506,17,0,872,89,0,232,0,662,15,0,998
2001,Ghana,Kumasi,0,0,0,0,0,0,0,0,0,0,0,0,1,1,0,2
2001,Ghana,Accra,14,0,127,0,247,3,0,391,12,0,128,0,208,9,0,357
2001,Ghana,Buduburam,159,0,1755,0,2226,2,0,4142,151,0,1753,0,2673,0,0,4577
2001,Guinea,Yomou,530,0,1342,0,1173,111,0,3156,592,0,1131,0,1413,231,0,3367
2001,Guinea,Sembakouya,502,0,1203,0,1667,176,0,3548,514,0,1296,0,1933,211,0,3954
2001,Guinea,Telikoro,933,0,1932,0,2640,522,0,6027,809,0,2068,0,2277,361,0,5515
2001,Guinea,Nzerekore peripherie,206,0,634,0,620,26,0,1486,421,0,1298,0,1187,85,0,2991
2001,Guinea,Nzerekore ville,385,0,3318,0,3224,318,0,7245,1550,0,4044,0,2397,610,0,8601
2001,Guinea,Lola,491,0,837,0,1235,104,0,2667,982,0,1660,0,1777,236,0,4655
2001,Guinea,Kouankan,1235,0,2068,0,3155,2062,0,8520,1217,0,1600,0,649,1514,0,4980
2001,Guinea,Kountaya,1953,0,4437,0,5566,1085,0,13041,1968,0,4473,0,5666,821,0,12928
2001,Guinea,Hafia,1,0,2,0,2,0,0,5,0,0,5,0,10,0,0,15
2001,Guinea,Kola,617,0,1273,0,1206,56,0,3152,588,0,1349,0,797,67,0,2801
2001,Guinea,Boreah,972,0,2199,0,2828,523,0,6522,919,0,2325,0,2477,453,0,6174
2001,Guinea,Beyla,10,0,18,0,67,13,0,108,31,0,74,0,113,26,0,244
2001,Gambia,Basse,43,0,171,0,216,5,0,435,52,0,208,0,363,2,0,625
2001,Gambia,Bambali,22,0,60,0,78,7,0,167,18,0,72,0,69,11,0,170
2001,Guinea-Bissau,Sao Domingos,200,0,435,0,872,137,0,1644,176,0,493,0,602,161,0,1432
2001,Guinea-Bissau,Ingore,255,0,742,0,912,81,0,1990,296,0,729,0,622,100,0,1747
2001,Guinea-Bissau,Jolmete,35,0,94,0,94,11,0,234,31,0,143,0,101,10,0,285
2001,Guinea-Bissau,Bissau,17,0,19,0,58,0,0,94,25,0,27,0,225,0,0,277
2001,Greece,Lavrion,31,0,56,0,143,3,0,233,38,0,131,0,479,2,0,650
2001,Greece,Athens,49,0,154,0,321,13,0,537,53,0,170,0,772,14,0,1009
2001,Guatemala,Guatemala City,15,0,68,0,262,22,0,367,8,0,60,0,282,21,0,371
2001,"China, Hong Kong SAR",Hong Kong,3,0,5,0,20,0,0,28,2,0,5,0,484,0,0,491
2001,Honduras,Tegucigalpa,0,0,3,0,3,0,0,6,0,0,0,0,6,1,0,7
2001,Honduras,Trujillo,0,0,0,0,0,0,0,0,0,0,0,0,7,0,0,7
2001,Honduras,Guanaja,0,0,0,0,0,0,0,0,0,0,0,0,4,0,0,4
2001,Croatia,Rakitje,4,0,2,0,8,0,0,14,3,0,8,0,9,0,0,20
2001,Croatia,Jezevo,0,0,0,0,2,0,0,2,0,0,1,0,27,0,0,28
2001,Indonesia,West Timor,0,0,0,0,0,0,35060,35060,0,0,0,0,0,0,37982,37982
2001,Indonesia,Tanjung Balai,6,0,9,0,15,0,0,30,7,0,9,0,21,0,0,37
2001,Indonesia,Tanjung Pinang,0,0,0,0,0,0,0,0,0,0,0,0,2,0,0,2
2001,Indonesia,Singkawang,0,0,1,0,0,0,0,1,1,0,3,0,17,0,0,21
2001,Indonesia,Situbondo,4,0,4,0,11,0,0,19,4,0,14,0,21,0,0,39
2001,Indonesia,Mataram,0,0,3,0,4,0,0,7,2,0,4,0,6,0,0,12
2001,Indonesia,Pekanbaru,0,0,0,0,0,0,0,0,0,0,1,0,12,0,0,13
2001,Indonesia,Jakarta,18,0,55,0,103,1,0,177,31,0,91,0,483,6,0,611
2001,Indonesia,Kupang,8,0,12,0,36,0,0,56,11,0,26,0,198,0,0,235
2001,Indonesia,Batam,1,0,5,0,9,0,0,15,3,0,13,0,24,0,0,40
2001,India,New Delhi,213,0,2334,0,3734,322,0,6603,284,0,2412,0,3487,360,0,6543
2001,Iraq,South,510,0,1356,0,1617,147,0,3630,490,0,1287,0,1397,146,0,3320
2001,Iraq,Sulaimaniya,126,0,425,0,491,11,0,1053,130,0,372,0,600,21,0,1123
2001,Iraq,Erbil,110,0,382,0,538,53,0,1083,108,0,360,0,857,30,1,1356
2001,Iraq,Makhmour,503,0,2146,0,1858,181,0,4688,510,0,2126,0,1823,175,0,4634
2001,Iraq,Baghdad,1,0,2,0,0,0,0,3,0,0,1,0,2,0,0,3
2001,Iraq,Dohuk,329,0,674,0,711,45,0,1759,377,0,741,0,683,45,0,1846
2001,Iraq,Al-Tash ,832,0,2505,0,2280,214,0,5831,873,0,2802,0,2325,320,0,6320
2001,Jordan,Amman,181,0,898,0,1511,65,0,2655,170,0,993,0,2454,92,0,3709
2001,Kenya,Kakuma,6808,0,11070,0,14165,793,0,32836,7885,0,17915,0,25265,651,0,51716
2001,Kenya,Nairobi,915,0,3431,0,4531,292,0,9169,827,0,3647,0,6808,220,0,11502
2001,Kenya,Hagadera (Dadaab),3113,0,8604,0,11618,571,0,23906,3321,0,9349,0,11037,677,0,24384
2001,Kenya,Ifo (Dadaab),3020,0,8164,0,12107,584,0,23875,3221,0,9592,0,11910,672,0,25395
2001,Kenya,Dagahaley (Dadaab),2731,0,6217,0,8635,355,0,17938,2802,0,7185,0,8023,490,0,18500
2001,Kyrgyzstan,Bishkek,74,0,153,0,305,21,0,553,67,0,139,0,331,16,0,553
2001,Cambodia,Ratanakiri,2,0,1,0,16,0,0,19,2,0,4,0,367,0,0,373
2001,Cambodia,Phnom Penh,4,0,14,0,40,1,0,59,0,0,25,0,59,4,0,88
2001,Cambodia,Mondulkiri,40,0,55,0,84,5,0,184,48,0,76,0,249,5,0,378
2001,Kuwait,Kuwait City,18,0,196,0,410,30,0,654,10,0,185,0,467,19,0,681
2001,Lebanon,Beirut,82,0,281,0,554,54,0,971,103,0,307,0,1372,62,0,1844
2001,Liberia,Montserrado,2296,0,2761,0,4305,294,0,9656,1977,0,2826,0,3694,380,0,8877
2001,Liberia,Grand Cape Mount,1486,0,1885,0,3859,458,0,7688,1394,0,2100,0,3783,302,0,7579
2001,Sri Lanka,Colombo,2,0,11,0,5,0,0,18,4,0,6,0,19,0,0,29
2001,Lithuania,Telsiai,0,0,0,0,1,0,0,1,2,0,2,0,4,0,0,8
2001,Lithuania,Vilnius,2,0,2,0,5,0,0,9,1,0,1,0,13,0,0,15
2001,Lithuania,Panevezys,0,0,0,0,0,0,0,0,0,0,0,0,1,0,0,1
2001,Lithuania,Rukla,6,0,15,0,31,0,0,52,14,0,22,0,43,0,0,79
2001,Lithuania,Klaipeda,0,0,1,0,1,0,0,2,0,0,0,0,1,0,0,1
2001,Lithuania,Pabrade,1,0,3,0,7,0,0,11,3,0,15,0,45,0,0,63
2001,Lithuania,Jonava,2,0,6,0,8,0,0,16,5,0,6,0,11,0,0,22
2001,Lithuania,Kaunas,0,0,9,0,8,0,0,17,3,0,8,0,19,0,0,30
2001,Latvia,Riga,0,0,0,0,1,0,0,1,0,0,1,0,4,0,0,5
2001,Latvia,Mucenieki,0,0,0,0,0,0,0,0,0,0,0,0,3,0,0,3
2001,Latvia,Mucenieki Villige,0,0,0,0,0,0,0,0,0,0,0,0,1,0,0,1
2001,Morocco,Sale,0,0,0,0,0,0,0,0,0,0,0,0,0,1,0,1
2001,Morocco,Casablanca,3,0,6,0,126,3,0,138,1,0,15,0,334,0,0,350
2001,Morocco,Rabat,0,0,0,0,0,0,0,0,0,0,0,0,0,2,0,2
2001,Rep. of Moldova,Chisinau,13,0,35,0,55,5,0,108,18,0,24,0,120,2,0,164
2001,Mexico,Mexico City,17,0,379,0,1078,139,0,1613,21,0,390,0,1489,103,0,2003
2001,Mexico,Qintana Roo,79,0,187,0,104,24,0,394,82,0,192,0,98,17,0,389
2001,Mexico,Chiapas,667,0,2285,0,1618,190,0,4760,645,0,2230,0,1883,198,0,4956
2001,Mexico,Campeche,49,0,152,0,177,19,0,397,58,0,162,0,336,23,0,579
2001,The former Yugoslav Republic of Macedonia,Zdravko Cevtkovski,3,0,8,0,48,9,0,68,4,0,12,0,41,10,0,67
2001,The former Yugoslav Republic of Macedonia,Tome Stefanovski-Senic,1,0,11,0,48,7,0,67,2,0,23,0,52,6,0,83
2001,The former Yugoslav Republic of Macedonia,Tetovo,71,0,390,0,1043,282,0,1786,108,0,430,0,989,279,0,1806
2001,The former Yugoslav Republic of Macedonia,Suto Orizari,95,0,157,0,287,22,0,561,108,0,204,0,254,18,0,584
2001,The former Yugoslav Republic of Macedonia,Stiv Naumov,9,0,65,0,221,52,0,347,19,0,85,0,229,30,0,363
2001,The former Yugoslav Republic of Macedonia,Skopje,257,0,788,0,1516,226,0,2787,294,0,816,0,1485,206,0,2801
2001,The former Yugoslav Republic of Macedonia,Ranka Milanovic,3,0,12,0,36,4,0,55,1,0,8,0,32,11,0,52
2001,The former Yugoslav Republic of Macedonia,Partenije Zografski,3,0,5,0,37,10,0,55,3,0,9,0,46,7,0,65
2001,The former Yugoslav Republic of Macedonia,Olimpisko Selo,7,0,31,0,106,9,0,153,11,0,29,0,97,14,0,151
2001,The former Yugoslav Republic of Macedonia,Kumanovo,182,0,693,0,1242,249,0,2366,174,0,727,0,1151,225,0,2277
2001,The former Yugoslav Republic of Macedonia,Katlanovo,29,0,82,0,107,8,0,226,27,0,84,0,119,8,0,238
2001,The former Yugoslav Republic of Macedonia,Hotel Pelagonija,12,0,39,0,159,35,0,245,11,0,56,0,175,30,0,272
2001,The former Yugoslav Republic of Macedonia,Hotel Kuba,6,0,18,0,33,20,0,77,6,0,17,0,46,12,0,81
2001,The former Yugoslav Republic of Macedonia,Hotel Kristal,4,0,21,0,37,17,0,79,3,0,15,0,48,15,0,81
2001,The former Yugoslav Republic of Macedonia,Gazi Baba,8,0,5,0,10,0,0,23,4,0,5,0,11,0,0,20
2001,The former Yugoslav Republic of Macedonia,Dom za stari,1,0,0,0,3,9,0,13,0,0,0,0,1,7,0,8
2001,The former Yugoslav Republic of Macedonia,Dolno Konjare,1,0,2,0,11,18,0,32,0,0,6,0,9,15,0,30
2001,The former Yugoslav Republic of Macedonia,Dimitrar Vlahov,3,0,8,0,15,1,0,27,2,0,3,0,13,3,0,21
2001,The former Yugoslav Republic of Macedonia,Cicino Selo,8,0,17,0,35,8,0,68,13,0,26,0,39,5,0,83
2001,The former Yugoslav Republic of Macedonia,Children embassy Megashi,2,0,4,0,7,0,0,13,3,0,0,0,6,0,0,9
2001,The former Yugoslav Republic of Macedonia,25 Maj,3,0,8,0,19,2,0,32,4,0,6,0,15,0,0,25
2001,Mali,Kayes,802,0,1156,0,571,90,0,2619,324,0,1838,0,1208,126,0,3496
2001,Mozambique,Nampula,216,0,144,0,275,1,0,636,217,0,182,0,426,0,0,825
2001,Mozambique,Maputo,16,0,30,0,53,0,0,99,5,0,20,0,164,0,0,189
2001,Mozambique,Massaca,2,0,2,0,6,0,0,10,5,0,2,0,9,0,0,16
2001,Mozambique,Bobole,87,0,121,0,213,0,0,421,109,0,126,0,694,0,0,929
2001,Mauritania,Nouakchott,15,0,25,0,103,9,0,152,8,0,22,0,172,11,0,213
2001,Malawi,Dzaleka,734,0,988,0,1212,3,0,2937,816,0,1080,0,1362,5,0,3263
2001,Malaysia,Semenyih,1,0,0,0,2,0,0,3,0,0,1,0,0,0,0,1
2001,Malaysia,Langkap,0,0,0,0,0,0,0,0,0,0,0,0,1,0,0,1
2001,Malaysia,Kamunting,0,0,0,0,0,0,0,0,0,0,0,0,1,0,0,1
2001,Malaysia,Kuala Lumpur,12,0,31,0,51,5,0,99,10,0,22,0,126,2,0,160
2001,Malaysia,Kajang,0,0,0,0,0,0,0,0,0,0,0,0,1,0,0,1
2001,Namibia,Osire,2268,0,3672,0,4073,249,0,10262,2260,0,4193,0,5484,224,0,12161
2001,Namibia,Onambutu,1,0,3,0,1,0,0,5,0,0,0,0,0,0,0,0
2001,Niger,Niamey,20,0,43,0,87,1,9,160,12,0,44,0,292,3,15,366
2001,Nigeria,Oru Camp,105,0,208,0,1527,11,0,1851,99,0,234,0,1406,19,0,1758
2001,Nigeria,Lagos,45,0,89,0,205,6,0,345,51,0,101,0,211,15,0,378
2001,Nicaragua,Managua,0,0,0,0,151,0,0,151,0,0,0,0,165,30,0,195
2001,Nepal,Timai,476,0,1618,0,2380,191,0,4665,482,0,1637,0,2504,288,0,4911
2001,Nepal,Khudunabari,502,0,2257,0,3261,252,0,6272,510,0,2166,0,3313,382,0,6371
2001,Nepal,Sanischare,966,0,3671,0,4638,392,0,9667,992,0,3769,0,4761,596,0,10118
2001,Nepal,Goldhap,362,0,1446,0,2350,180,0,4338,358,0,1521,0,2507,270,0,4656
2001,Nepal,Kathmandu,0,0,1,0,4,0,0,5,1,0,5,0,26,0,0,32
2001,Nepal,Beldangi 2,864,0,3457,0,5616,648,0,10585,856,0,3642,0,5784,642,0,10924
2001,Nepal,Beldangi 2 extension,445,0,1776,0,2888,222,0,5331,550,0,1759,0,2970,330,0,5609
2001,Nepal,Beldangi 1,865,0,2766,0,4495,346,0,8472,869,0,2953,0,4519,521,0,8862
2001,Oman,Muscat,0,0,1,0,1,0,0,2,1,0,0,0,19,1,0,21
2001,Pakistan,Quetta,4,0,11,0,11,0,0,26,6,0,10,0,20,1,0,37
2001,Pakistan,Peshawar,12,0,20,0,31,0,0,63,20,0,22,0,37,0,0,79
2001,Pakistan,Punjab,3213,0,7854,0,6248,535,0,17850,2915,0,7374,0,6345,516,0,17150
2001,Pakistan,Karachi,3,0,10,0,20,1,0,34,5,0,18,0,34,3,0,60
2001,Pakistan,North West Frontier Province,100731,0,268617,0,282048,20148,0,671544,101238,0,273939,0,196521,23822,0,595520
2001,Pakistan,Balochistan,18647,0,48265,0,39489,3293,0,109694,16536,0,42801,0,34046,3893,0,97276
2001,Pakistan,Islamabad,36,0,71,0,129,3,0,239,46,0,98,0,244,4,0,392
2001,Panama,Puerto Obaldia,7,0,27,0,14,6,0,54,11,0,23,0,28,6,0,68
2001,Panama,Herrera,0,0,0,0,2,1,0,3,0,0,2,0,0,0,0,2
2001,Panama,Jaque,25,0,67,0,56,4,0,152,24,0,46,0,63,7,0,140
2001,Panama,Darien Centro,12,0,63,0,61,6,0,142,13,0,83,0,94,8,0,198
2001,Panama,David,0,0,0,0,8,1,0,9,0,0,3,0,8,0,0,11
2001,Panama,Cocle,0,0,2,0,2,1,0,5,0,0,0,0,8,1,0,9
2001,Panama,Darien,0,0,2,0,7,1,0,10,2,0,5,0,8,2,0,17
2001,Panama,Bocas del Toro,0,0,2,0,1,0,0,3,0,0,1,0,1,0,0,2
2001,Peru,Lima,0,0,47,0,296,57,0,400,3,0,44,0,187,49,0,283
2001,Philippines,Manila,0,0,0,0,0,0,0,0,0,0,0,0,1,0,0,1
2001,Philippines,Quezon City,0,0,0,0,0,0,0,0,0,0,0,0,2,0,0,2
2001,Philippines,Legaspi City,0,0,0,0,0,0,0,0,0,0,0,0,1,0,0,1
2001,Philippines,Makati,0,0,0,0,0,0,0,0,0,0,0,0,1,0,0,1
2001,Philippines,Cavite,0,0,0,0,0,0,0,0,0,0,0,0,1,0,0,1
2001,Papua New Guinea,Vanimo,24,0,39,0,76,0,0,139,17,0,46,0,109,2,0,174
2001,Papua New Guinea,East Awin,0,0,0,0,0,0,194,194,0,0,0,0,0,0,238,238
2001,Paraguay,Asuncion,0,0,8,0,6,1,0,15,0,0,1,0,17,0,0,18
2001,Qatar,Doha,2,0,8,0,8,0,0,18,1,0,9,0,51,0,0,61
2001,Romania,Stolnicul Camp,0,0,0,0,1,0,0,1,0,0,1,0,115,0,0,116
2001,Romania,Timisoara,0,0,0,0,0,0,0,0,0,0,0,0,2,0,0,2
2001,Romania,Rahova prison,0,0,0,0,0,0,0,0,0,0,0,0,1,0,0,1
2001,Romania,Scurtu Mare,0,0,0,0,0,0,0,0,0,0,0,0,2,0,0,2
2001,Romania,Posta,1,0,2,0,2,0,0,5,0,0,0,0,2,0,0,2
2001,Romania,Produlesti,1,0,1,0,1,0,0,3,0,0,1,0,0,0,0,1
2001,Romania,Otopeni Centre,0,0,0,0,0,0,0,0,0,0,0,0,36,0,0,36
2001,Romania,Pantelimon,0,0,0,0,1,0,0,1,0,0,3,0,2,0,0,5
2001,Romania,Lunca Corbului,0,0,0,0,0,0,0,0,0,0,0,0,1,0,0,1
2001,Romania,Oradea,0,0,0,0,0,0,0,0,0,0,0,0,2,0,0,2
2001,Romania,Ciorchina,0,0,0,0,0,0,0,0,0,0,0,0,1,0,0,1
2001,Romania,Gociu Camp,3,0,13,0,30,0,0,46,5,0,27,0,547,4,0,583
2001,Romania,Cernica,0,0,0,0,0,0,0,0,0,0,0,0,1,0,0,1
2001,Romania,Chitila,0,0,0,0,1,0,0,1,0,0,1,0,2,0,0,3
2001,Romania,Brasov,0,0,0,0,0,0,0,0,0,0,0,0,1,0,0,1
2001,Romania,Bucuresti,19,0,41,0,138,6,0,204,37,0,90,0,1203,7,0,1337
2001,Romania,Botosesti,0,0,0,0,0,0,0,0,0,0,0,0,1,0,0,1
2001,Romania,Braila,0,0,0,0,0,0,0,0,0,0,0,0,1,0,0,1
2001,Romania,Afumati,0,0,0,0,0,0,0,0,0,0,0,0,2,0,0,2
2001,Romania,Botoroga,1,0,0,0,1,0,0,2,0,0,0,0,2,0,0,2
2001,Rwanda,Kigali,101,0,506,0,440,18,0,1065,95,0,433,0,733,14,0,1275
2001,Rwanda,Gikongoro,56,0,78,0,95,4,0,233,64,0,104,0,114,8,0,290
2001,Rwanda,Kibuye,1750,0,3204,0,2945,424,0,8323,1458,0,2939,0,2117,318,0,6832
2001,Rwanda,Byumba,2023,0,3481,0,3009,504,0,9017,1945,0,3066,0,2317,423,0,7751
2001,Saudi Arabia,Rafha ,299,0,793,0,600,55,0,1747,299,0,791,0,2310,46,0,3446
2001,Saudi Arabia,Gulf,6,0,27,0,62,2,0,97,13,0,30,0,158,11,0,212
2001,Sudan,Wad Sherife,4536,0,7194,0,7889,0,0,19619,3120,0,7529,0,6287,0,0,16936
2001,Sudan,Wad Awad,120,0,130,0,210,0,0,460,37,0,165,0,117,0,0,319
2001,Sudan,Wad El Hilea,394,0,950,0,895,0,0,2239,414,0,968,0,745,0,0,2127
2001,Sudan,Um Sagata,336,0,426,0,691,0,0,1453,521,0,598,0,615,0,0,1734
2001,Sudan,Umbrush,168,0,258,0,342,0,0,768,157,0,308,0,252,0,0,717
2001,Sudan,Um Ali,250,0,320,0,443,0,0,1013,250,0,338,0,370,0,0,958
2001,Sudan,Um Gargur,299,0,653,0,787,0,0,1739,308,0,765,0,767,0,0,1840
2001,Sudan,Suki,428,0,612,0,963,0,0,2003,269,0,447,0,663,0,0,1379
2001,Sudan,Suwakin,53,0,89,0,102,0,0,244,50,0,96,0,88,0,0,234
2001,Sudan,Salmin,315,0,483,0,641,0,0,1439,295,0,577,0,472,0,0,1344
2001,Sudan,"Shagrabs 1, 2 & 3",3005,0,4604,0,4889,0,0,12498,3163,0,4708,0,5085,0,0,12956
2001,Sudan,Mafaza,293,0,273,0,359,0,0,925,128,0,325,0,249,0,0,702
2001,Sudan,Salalab,196,0,329,0,372,0,0,897,183,0,355,0,325,0,0,863
2001,Sudan,Karkora,464,0,850,0,1142,0,0,2456,516,0,1057,0,1130,0,0,2703
2001,Sudan,Kilo 26,844,0,2069,0,2312,0,0,5225,862,0,2308,0,1906,0,0,5076
2001,Sudan,Girba,899,0,2159,0,2130,0,0,5188,1034,0,2253,0,1736,0,0,5023
2001,Sudan,Hawata,213,0,326,0,433,0,0,972,199,0,390,0,319,0,0,908
2001,Sudan,Daim El Nour,209,0,349,0,396,0,0,954,195,0,377,0,346,0,0,918
2001,Sudan,Fau 5,230,0,277,0,349,0,0,856,270,0,443,0,320,0,0,1033
2001,Sudan,Ading/El Zarzur,225,0,345,0,458,0,0,1028,210,0,412,0,337,0,0,959
2001,Sudan,Asotriba,263,0,439,0,497,0,0,1199,244,0,474,0,435,0,0,1153
2001,Sudan,Abu Rakhman,216,0,528,0,494,0,0,1238,241,0,564,0,544,0,0,1349
2001,Sudan,Abuda,567,0,859,0,1021,0,0,2447,537,0,1001,0,898,0,0,2436
2001,Senegal,Matam,949,0,2270,0,1358,240,0,4817,638,0,1514,0,906,160,0,3218
2001,Senegal,Podor,942,0,2265,0,1355,239,0,4801,628,0,1509,0,904,160,0,3201
2001,Senegal,Dagana,229,0,542,0,323,57,0,1151,153,0,361,0,216,38,0,768
2001,Senegal,Dakar,49,0,234,0,887,17,0,1187,86,0,272,0,1932,87,0,2377
2001,Senegal,Bakel,217,0,517,0,308,54,0,1096,145,0,344,0,206,36,0,731
2001,Singapore,Singapore,0,0,0,0,1,0,0,1,0,0,0,0,3,0,0,3
2001,El Salvador,San Salvador,0,0,1,0,6,0,0,7,3,0,5,0,5,0,0,13
2001,El Salvador,Libertad,0,0,3,0,1,0,0,4,0,0,1,0,0,0,0,1
2001,El Salvador,San Miguel,6,0,1,0,5,0,0,12,2,0,0,0,5,0,0,7
2001,El Salvador,La Union,2,0,1,0,4,0,0,7,7,0,4,0,7,5,0,23
2001,Somalia,Hargeisa,51,0,63,0,181,0,0,295,45,0,71,0,238,0,0,354
2001,Serbia and Kosovo (S/RES/1244 (1999)),Kosovo,483,0,1785,0,3413,482,0,6163,546,0,1870,0,2342,343,0,5101
2001,Serbia and Kosovo (S/RES/1244 (1999)),Serbia,11333,0,56206,0,173599,58307,0,299445,12155,0,59156,0,163963,42574,0,277848
2001,Serbia and Kosovo (S/RES/1244 (1999)),Montenegro,1179,0,4752,0,12590,3652,0,22173,1258,0,5005,0,11705,2769,0,20737
2001,Slovenia,Ptuj,0,0,0,0,1,0,0,1,0,0,0,0,0,0,0,0
2001,Slovenia,Vrhnika,0,0,0,0,1,0,0,1,0,0,0,0,0,0,0,0
2001,Slovenia,Novo Mesto,6,0,17,0,45,10,0,78,5,0,19,0,37,6,0,67
2001,Slovenia,Postojna,7,0,26,0,85,24,0,142,7,0,21,0,52,14,0,94
2001,Slovenia,Maribor,1,0,20,0,60,13,0,94,1,0,20,0,22,7,0,50
2001,Slovenia,Medvode,0,0,0,0,0,0,0,0,0,0,0,0,1,0,0,1
2001,Slovenia,Kranj,0,0,0,0,1,0,0,1,0,0,0,0,0,0,0,0
2001,Slovenia,Ljubljana,24,0,67,0,237,100,0,428,11,0,54,0,158,22,0,245
2001,Slovenia,Illirska Bistrica,5,0,10,0,44,10,0,69,4,0,13,0,20,7,0,44
2001,Slovenia,Kozina,0,0,6,0,13,15,0,34,1,0,0,0,8,6,0,15
2001,Slovenia,Grgar,0,0,0,0,0,1,0,1,0,0,0,0,0,0,0,0
2001,Slovenia,Hrastnik,0,0,0,0,7,2,0,9,0,0,4,0,3,3,0,10
2001,Slovenia,Celje,6,0,13,0,87,6,0,112,4,0,16,0,51,8,0,79
2001,Slovenia,Crnomelj,1,0,11,0,29,6,0,47,1,0,14,0,26,4,0,45
2001,Swaziland,Malindza,8,0,30,0,41,1,0,80,7,0,34,0,32,0,0,73
2001,Syrian Arab Rep.,Damascus,160,0,557,0,778,39,0,1534,155,0,634,0,900,48,0,1737
2001,Togo,Sotouboua,912,0,1389,0,1201,24,0,3526,901,0,1108,0,733,20,0,2762
2001,Togo,Dankpen,302,0,602,0,792,17,0,1713,277,0,257,0,295,27,0,856
2001,Togo,Lome,50,0,167,0,301,6,0,524,47,0,156,0,396,4,0,603
2001,Togo,Bassar,274,0,612,0,547,9,0,1442,289,0,298,0,301,21,0,909
2001,Thailand,Um Pium (Pob Phra),911,0,2611,0,3570,266,0,7358,934,0,2848,0,3749,239,0,7770
2001,Thailand,Pangkwai,877,0,1961,0,2811,151,0,5800,899,0,2032,0,3127,184,0,6242
2001,Thailand,Tham Hin,650,0,1615,0,1848,160,0,4273,689,0,1642,0,1728,161,0,4220
2001,Thailand,Napho,1,0,6,0,4,1,0,12,3,0,13,0,6,0,0,22
2001,Thailand,Nu Po (Umphang),618,0,1473,0,1838,149,0,4078,556,0,1533,0,2011,111,0,4211
2001,Thailand,Mae Surin,195,0,468,0,632,28,0,1323,232,0,457,0,877,47,0,1613
2001,Thailand,Nai Soi,336,0,633,0,990,40,0,1999,318,0,663,0,1268,55,0,2304
2001,Thailand,Mae La (Thasongyang),2146,0,5388,0,7464,552,0,15550,2278,0,5664,0,7750,540,0,16232
2001,Thailand,Mae Ra Ma Luang (Sob Moei),623,0,1492,0,1918,196,0,4229,657,0,1673,0,2180,199,0,4709
2001,Thailand,Don Yang,282,0,713,0,849,43,0,1887,282,0,726,0,728,58,0,1794
2001,Thailand,Mae Kong Kha (Mae Sariang),799,0,2347,0,3067,218,0,6431,926,0,2558,0,3370,270,0,7124
2001,Thailand,Bangkok,47,0,154,0,362,10,0,573,58,0,177,0,705,17,0,957
2001,Tajikistan,Panj,0,0,0,0,0,0,518,518,0,0,0,0,0,0,502,502
2001,Tajikistan,Khujand,16,0,96,0,91,5,0,208,25,0,61,0,115,4,0,205
2001,Tajikistan,Kumsang,0,0,0,0,0,0,4140,4140,0,0,0,0,0,0,5562,5562
2001,Tajikistan,Dushanbe,172,0,619,0,518,85,0,1394,338,0,1041,0,990,234,0,2603
2001,Turkmenistan,Yashlik,0,0,0,0,0,0,56,56,0,0,0,0,0,0,84,84
2001,Turkmenistan,Watan,0,0,0,0,0,0,32,32,0,0,0,0,0,0,48,48
2001,Turkmenistan,Turkmenistan village,0,0,0,0,0,0,180,180,0,0,0,0,0,0,270,270
2001,Turkmenistan,Turkmenbashy,0,0,0,0,0,0,18,18,0,0,0,0,0,0,19,19
2001,Turkmenistan,Turkmenabad,0,0,0,0,0,0,236,236,0,0,0,0,0,0,338,338
2001,Turkmenistan,Tejen,0,0,0,0,0,0,5,5,0,0,0,0,0,0,2,2
2001,Turkmenistan,Taze-Durmush,0,0,0,0,0,0,280,280,0,0,0,0,0,0,420,420
2001,Turkmenistan,Taze Yurt,0,0,0,0,0,0,210,210,0,0,0,0,0,0,254,254
2001,Turkmenistan,Soltandash,0,0,0,0,0,0,120,120,0,0,0,0,0,0,180,180
2001,Turkmenistan,Seidi,0,0,0,0,0,0,120,120,0,0,0,0,0,0,170,170
2001,Turkmenistan,Merdan,0,0,0,0,0,0,480,480,0,0,0,0,0,0,720,720
2001,Turkmenistan,Mary province,0,0,0,0,0,0,742,742,0,0,0,0,0,0,1114,1114
2001,Turkmenistan,Mary,0,0,0,0,0,0,33,33,0,0,0,0,0,0,45,45
2001,Turkmenistan,Lebap province,0,0,0,0,0,0,600,600,0,0,0,0,0,0,900,900
2001,Turkmenistan,Karaev,0,0,0,0,0,0,35,35,0,0,0,0,0,0,45,45
2001,Turkmenistan,Hanhauz,0,0,0,0,0,0,237,237,0,0,0,0,0,0,357,357
2001,Turkmenistan,Gulistan,0,0,0,0,0,0,366,366,0,0,0,0,0,0,551,551
2001,Turkmenistan,Geldiev,0,0,0,0,0,0,200,200,0,0,0,0,0,0,300,300
2001,Turkmenistan,Gaurdak,0,0,0,0,0,0,109,109,0,0,0,0,0,0,165,165
2001,Turkmenistan,Dashoguz,0,0,0,0,0,0,0,0,0,0,0,0,0,0,1,1
2001,Turkmenistan,Dostluk,0,0,0,0,0,0,40,40,0,0,0,0,0,0,60,60
2001,Turkmenistan,Babadurmaz,0,0,0,0,0,0,445,445,0,0,0,0,0,0,667,667
2001,Turkmenistan,Balkanabat,0,0,0,0,0,0,18,18,0,0,0,0,0,0,19,19
2001,Turkmenistan,Ashgabat,0,0,0,0,0,0,370,370,0,0,0,0,0,0,510,510
2001,Turkmenistan,Azatlik,0,0,0,0,0,0,308,308,0,0,0,0,0,0,462,462
2001,Turkmenistan,Akhal province,0,0,0,0,0,0,240,240,0,0,0,0,0,0,360,360
2001,Tunisia,Tunis,1,0,4,0,29,9,0,43,2,0,6,0,39,7,0,54
2001,Turkey,Yozgat,1,0,8,0,5,0,0,14,1,0,3,0,6,0,0,10
2001,Turkey,Sivas,1,0,10,0,11,0,0,22,1,0,12,0,11,0,0,24
2001,Turkey,Van,54,0,182,0,339,7,0,582,82,0,242,0,897,6,0,1227
2001,Turkey,Nevsehir,8,0,30,0,75,4,0,117,6,0,29,0,76,4,0,115
2001,Turkey,Nigde,9,0,19,0,72,3,0,103,8,0,34,0,77,3,0,122
2001,Turkey,Kirsehir,7,0,16,0,63,3,0,89,8,0,21,0,71,6,0,106
2001,Turkey,Konya,9,0,33,0,50,2,0,94,12,0,37,0,66,1,0,116
2001,Turkey,Kayseri,18,0,89,0,216,3,0,326,22,0,122,0,238,8,0,390
2001,Turkey,Kirklareli,2,0,13,0,22,7,0,44,1,0,13,0,29,5,0,48
2001,Turkey,Istanbul,16,0,46,0,107,9,0,178,13,0,69,0,144,6,0,232
2001,Turkey,Kastamonu,3,0,4,0,24,0,0,31,4,0,14,0,36,0,0,54
2001,Turkey,Cankiri,0,0,3,0,11,0,0,14,6,0,10,0,11,1,0,28
2001,Turkey,Eskisehir,12,0,20,0,70,0,0,102,6,0,21,0,85,2,0,114
2001,Turkey,Bilecik,0,0,8,0,20,0,0,28,5,0,13,0,41,0,0,59
2001,Turkey,Burdur,6,0,14,0,39,0,0,59,8,0,19,0,120,0,0,147
2001,Turkey,Aksaray,4,0,30,0,79,10,0,123,8,0,17,0,62,9,0,96
2001,Turkey,Ankara,22,0,80,0,124,2,0,228,29,0,90,0,154,2,0,275
2001,Turkey,Afyon,6,0,12,0,47,1,0,66,4,0,28,0,54,0,0,86
2001,Turkey,Agri,0,0,3,0,14,0,0,17,2,0,8,0,31,0,0,41
2001,United Rep. of Tanzania,Ulyankulu,0,0,0,0,0,0,23184,23184,0,0,0,0,0,0,18816,18816
2001,United Rep. of Tanzania,Nyarugusu (Kasulu),4606,0,10089,0,11300,743,0,26738,4544,0,10293,0,9966,570,0,25373
2001,United Rep. of Tanzania,Nduta (Kibondo),5677,0,7941,0,9472,390,0,23480,5585,0,7889,0,10407,450,0,24331
2001,United Rep. of Tanzania,Myovosi (Kasulu),3456,0,6457,0,8058,323,0,18294,3475,0,6793,0,8668,381,0,19317
2001,United Rep. of Tanzania,Mwisa (Ngara),0,0,0,0,2,0,0,2,0,0,0,0,47,0,0,47
2001,United Rep. of Tanzania,Mtendeli (Kibondo),4998,0,6979,0,8264,365,0,20606,4918,0,7016,0,8866,338,0,21138
2001,United Rep. of Tanzania,Mtabila-2 (Kasulu),3665,0,7417,0,8096,572,0,19750,3646,0,7670,0,8223,580,0,20119
2001,United Rep. of Tanzania,Mtabila-1 (Kasulu),1456,0,3137,0,3153,181,0,7927,1410,0,3201,0,3123,196,0,7930
2001,United Rep. of Tanzania,Mkuyu (Handeni Tanga),305,0,700,0,680,142,0,1827,402,0,705,0,400,90,0,1597
2001,United Rep. of Tanzania,Mkugwa (Kibondo),204,0,263,0,358,15,0,840,201,0,272,0,396,12,0,881
2001,United Rep. of Tanzania,Mishamo,0,0,0,0,0,0,24840,24840,0,0,0,0,0,0,20160,20160
2001,United Rep. of Tanzania,Mbuba (Ngara),17,0,31,0,33,7,0,88,18,0,32,0,33,8,0,91
2001,United Rep. of Tanzania,Lukole (Ngara),11632,0,21598,0,25801,1108,0,60139,11704,0,22528,0,26681,1070,0,61983
2001,United Rep. of Tanzania,Lugufu (Kigoma),5783,0,12489,0,14065,781,0,33118,5562,0,13538,0,12575,605,0,32280
2001,United Rep. of Tanzania,Kitali Hill (Ngara),1246,0,2133,0,2991,75,0,6445,1253,0,2515,0,3706,115,0,7589
2001,United Rep. of Tanzania,Katumba,0,0,0,0,0,0,46920,46920,0,0,0,0,0,0,38080,38080
2001,United Rep. of Tanzania,Karago (Kibondo),4252,0,6576,0,7794,473,0,19095,4391,0,6608,0,7135,359,0,18493
2001,United Rep. of Tanzania,Kane Mbwa (Kibondo),2168,0,3169,0,3604,239,0,9180,2272,0,3183,0,3684,245,0,9384
2001,Uganda,Rhino Camp,1636,0,5414,0,4548,151,0,11749,1792,0,6280,0,4659,110,0,12841
2001,Uganda,Oruchinga,954,0,721,0,523,0,0,2198,968,0,805,0,502,2,0,2277
2001,Uganda,Nakivale,1106,0,1474,0,2215,51,0,4846,1117,0,1633,0,2517,44,0,5311
2001,Uganda,Moyo,1572,0,4630,0,5279,225,0,11706,1837,0,5159,0,5023,205,0,12224
2001,Uganda,Masindi,1091,0,2364,0,2983,177,0,6615,1111,0,2730,0,2604,280,0,6725
2001,Uganda,Kyaka 2,381,0,417,0,583,5,0,1386,319,0,438,0,584,2,0,1343
2001,Uganda,Kitgum,2328,0,3917,0,4333,338,0,10916,2583,0,5708,0,3920,283,0,12494
2001,Uganda,Kampala,45,0,171,0,215,6,0,437,55,0,134,0,267,8,0,464
2001,Uganda,Imvepi,653,0,2591,0,2443,92,0,5779,841,0,3269,0,2686,68,0,6864
2001,Uganda,Hoima,650,0,1197,0,1432,86,0,3365,613,0,1187,0,1288,91,0,3179
2001,Uganda,Adjumani,3578,0,11024,0,12775,600,0,27977,3931,0,12309,0,12705,722,0,29667
2001,Ukraine,Odessa,17,0,33,0,58,6,0,114,6,0,54,0,427,3,0,490
2001,Ukraine,Kiev,36,0,192,0,190,14,0,432,35,0,180,0,520,20,0,755
2001,Uruguay,Montevideo,0,0,2,0,14,9,0,25,2,0,5,0,44,14,0,65
2001,Uzbekistan,Termez,11,0,56,0,47,1,0,115,10,0,62,0,54,3,0,129
2001,Uzbekistan,Tashkent,117,0,697,0,770,31,0,1615,131,0,756,0,1050,38,0,1975
2001,Venezuela (Bolivarian Republic of),Caracas,0,0,6,0,15,2,0,23,2,0,5,0,26,3,0,36
2001,Viet Nam,Binh Duong,0,0,0,0,0,0,1118,1118,0,0,0,0,0,0,963,963
2001,Yemen,Taiz,71,0,815,0,1451,111,0,2448,75,0,770,0,1304,72,0,2221
2001,Yemen,Shihir,4,0,24,0,19,3,0,50,4,0,28,0,20,0,0,52
2001,Yemen,Sana'a,1064,0,4480,0,6567,1076,0,13187,1110,0,3461,0,5205,990,0,10766
2001,Yemen,Sada'a,4,0,39,0,50,1,0,94,8,0,46,0,84,1,0,139
2001,Yemen,Mukalla,23,0,188,0,217,29,0,457,36,0,184,0,247,19,0,486
2001,Yemen,Mahra,14,0,32,0,63,2,0,111,15,0,22,0,64,2,0,103
2001,Yemen,Hodeidah,5,0,125,0,200,30,0,360,10,0,115,0,151,8,0,284
2001,Yemen,Dhamar,0,0,9,0,15,0,0,24,3,0,6,0,13,0,0,22
2001,Yemen,Al-Kharaz,979,0,1882,0,2017,56,0,4934,957,0,2045,0,1462,48,0,4512
2001,Yemen,Al-Baida,4,0,38,0,54,4,0,100,2,0,29,0,61,0,0,92
2001,Yemen,Aden,975,0,2359,0,3977,920,0,8231,1007,0,2387,0,4721,854,0,8969
2001,Zambia,Ukwimi,0,0,0,0,0,0,899,899,0,0,0,0,0,0,1446,1446
2001,Zambia,Nangweshi,0,0,0,0,0,0,9911,9911,0,0,0,0,0,0,12591,12591
2001,Zambia,Mwange,0,0,0,0,0,0,10440,10440,0,0,0,0,0,0,12622,12622
2001,Zambia,Meheba,0,0,0,0,0,0,20122,20122,0,0,0,0,0,0,27034,27034
2001,Zambia,Mayukwayukwa,0,0,0,0,0,0,11358,11358,0,0,0,0,0,0,13358,13358
2001,Zambia,Kala,0,0,0,0,0,0,12191,12191,0,0,0,0,0,0,12220,12220
2001,Zimbabwe,Tongogara,86,0,121,0,188,0,0,395,97,0,268,0,631,0,0,996
2002,Afghanistan,Various,24013,0,90337,0,227899,50424,1563574,1956247,24196,0,95335,0,263719,39678,1891309,2314237
2002,Angola,Viana,484,0,1687,0,1281,44,0,3496,597,0,1645,0,787,34,0,3063
2002,Angola,Moxico,219,0,734,0,427,25,0,1405,226,0,711,0,139,15,0,1091
2002,Angola,Malange,61,0,141,0,188,7,0,397,64,0,158,0,125,8,0,355
2002,Angola,Lunda Sul,7,0,109,0,143,2,0,261,9,0,120,0,201,34,0,364
2002,Angola,Lunda Norte,25,0,41,0,136,0,0,202,18,0,54,0,207,0,0,279
2002,Angola,Luanda,61,0,166,0,427,2,0,656,82,0,169,0,576,6,1,834
2002,Angola,Kwanza Sul,2,0,42,0,79,2,0,125,4,0,44,0,65,18,0,131
2002,Angola,Kwanza Norte,4,0,9,0,10,1,0,24,2,0,9,0,8,0,0,19
2002,Angola,Kifangondo,30,0,111,0,122,3,0,266,27,0,105,0,71,7,0,210
2002,Albania,Tirana,8,0,14,0,29,0,0,51,7,0,13,0,31,0,0,51
2002,Albania,Peshkopi,0,0,1,0,1,0,0,2,1,0,0,0,0,0,0,1
2002,Albania,Lac,0,0,0,0,2,0,0,2,0,0,1,0,1,1,0,3
2002,Albania,Fier,0,0,3,0,1,0,0,4,0,0,0,0,0,0,0,0
2002,Albania,CIC reception center,0,0,0,0,0,0,0,0,0,0,2,0,15,0,0,17
2002,Armenia,Ararat,0,0,0,0,0,0,26857,26857,0,0,0,0,0,0,22879,22879
2002,Armenia,Aragatsotn,0,0,0,0,0,0,4012,4012,0,0,0,0,0,0,3418,3418
2002,Armenia,Gegharkunik,0,0,0,0,0,0,14852,14852,0,0,0,0,0,0,12651,12651
2002,Armenia,Armavir,0,0,0,0,0,0,13344,13344,0,0,0,0,0,0,11367,11367
2002,Armenia,Lori,0,0,0,0,0,0,9317,9317,0,0,0,0,0,0,7937,7937
2002,Armenia,Kotayk,0,0,0,0,0,0,17054,17054,0,0,0,0,0,0,14527,14527
2002,Armenia,Syunik,0,0,0,0,0,0,8031,8031,0,0,0,0,0,0,6842,6842
2002,Armenia,Shirak,0,0,0,0,0,0,2118,2118,0,0,0,0,0,0,1805,1805
2002,Armenia,Vayots Dzor,0,0,0,0,0,0,2265,2265,0,0,0,0,0,0,1930,1930
2002,Armenia,Tavush,0,0,0,0,0,0,5847,5847,0,0,0,0,0,0,4980,4980
2002,Armenia,Yerevan,0,0,0,0,2,0,0,2,0,0,0,0,13,0,0,13
2002,Azerbaijan,Agcabedi,0,0,0,0,0,0,9565,9565,0,0,0,0,0,0,8731,8731
2002,Azerbaijan,Ali-Bayramli,0,0,0,0,0,0,2378,2378,0,0,0,0,0,0,2343,2343
2002,Azerbaijan,Agdam,0,0,0,0,0,0,11334,11334,0,0,0,0,0,0,9275,9275
2002,Azerbaijan,Barda,0,0,0,0,0,0,26046,26046,0,0,0,0,0,0,23400,23400
2002,Azerbaijan,Baku,211,0,1569,0,2381,76,80972,85209,192,0,1489,0,2589,67,72420,76757
2002,Azerbaijan,Bilasuvar,0,0,0,0,0,0,10192,10192,0,0,0,0,0,0,9671,9671
2002,Azerbaijan,Beylagan,0,0,0,0,0,0,8798,8798,0,0,0,0,0,0,7497,7497
2002,Azerbaijan,Ganja,0,0,0,0,0,0,8811,8811,0,0,0,0,0,0,6493,6493
2002,Azerbaijan,Fizuli,0,0,0,0,0,0,26659,26659,0,0,0,0,0,0,23496,23496
2002,Azerbaijan,Lachin,0,0,0,0,0,0,8663,8663,0,0,0,0,0,0,8323,8323
2002,Azerbaijan,Imishli,0,0,0,0,0,0,8661,8661,0,0,0,0,0,0,6807,6807
2002,Azerbaijan,Naftalan,0,0,0,0,0,0,1758,1758,0,0,0,0,0,0,1632,1632
2002,Azerbaijan,Mingachevir,0,0,0,0,0,0,9894,9894,0,0,0,0,0,0,8444,8444
2002,Azerbaijan,Sabirabad,0,0,0,0,0,0,9583,9583,0,0,0,0,0,0,8270,8270
2002,Azerbaijan,Saatli,0,0,0,0,0,0,7464,7464,0,0,0,0,0,0,6192,6192
2002,Azerbaijan,Tartar,0,0,0,0,0,0,7827,7827,0,0,0,0,0,0,7238,7238
2002,Azerbaijan,Sumgait,0,0,0,0,0,0,22527,22527,0,0,0,0,0,0,21152,21152
2002,Azerbaijan,Yevlah,0,0,0,0,0,0,6372,6372,0,0,0,0,0,0,5138,5138
2002,Burundi,Bujumbura,3120,0,4964,0,5967,142,4808,19001,3009,0,3343,0,4712,112,3933,15109
2002,Burundi,Cishemeye,284,0,634,0,618,32,0,1568,231,0,564,0,462,25,0,1282
2002,Burundi,Cibitoke,95,0,149,0,165,4,0,413,99,0,95,0,155,3,0,352
2002,Burundi,Gatumba,116,0,256,0,249,12,0,633,93,0,227,0,187,10,0,517
2002,Burundi,Gasorwe,306,0,669,0,660,35,0,1670,318,0,755,0,632,29,0,1734
2002,Burundi,Rugombo,703,0,1562,0,1523,79,0,3867,570,0,1392,0,1139,63,0,3164
2002,Benin,Kpomasse,82,0,148,0,265,7,0,502,101,0,183,0,373,0,0,657
2002,Benin,Cotonou,5,0,13,0,43,0,0,61,5,0,20,0,228,0,0,253
2002,Bangladesh,Kutapalong/Nayapara (Cox Bazaar),2215,0,4283,0,4413,297,0,11208,2230,0,4160,0,4035,269,0,10694
2002,Bangladesh,Dhaka,2,0,20,0,24,0,0,46,2,0,15,0,60,0,0,77
2002,Bahrain,Manama,0,0,0,0,0,0,0,0,0,0,0,0,1,0,0,1
2002,Bosnia and Herzegovina,Brcko,161,0,1548,0,6206,2247,0,10162,202,0,1694,0,6096,1751,0,9743
2002,Belarus,Gomel Region,2,0,11,0,25,6,0,44,3,0,9,0,37,3,0,52
2002,Belarus,Brest Region,0,0,0,0,1,0,0,1,0,0,2,0,6,0,0,8
2002,Belarus,Minsk,16,0,77,0,103,16,0,212,19,0,95,0,265,7,0,386
2002,Belarus,Grodno Region,1,0,0,0,2,0,0,3,0,0,0,0,3,0,0,3
2002,Belarus,Mogilev Region,0,0,0,0,3,0,0,3,0,0,0,0,17,0,0,17
2002,Belarus,Minsk Region,2,0,34,0,31,4,0,71,5,0,13,0,39,3,0,60
2002,Belarus,Vitebsk Region,1,0,6,0,10,0,0,17,1,0,6,0,23,0,0,30
2002,Belize,Belize City,27,0,58,0,109,15,0,209,24,0,52,0,109,13,0,198
2002,Bolivia (Plurinational State of),"La Paz, Santa Cruz",10,0,23,0,67,5,0,105,10,0,28,0,99,2,0,139
2002,Botswana,Dukwi,235,0,362,0,434,40,0,1071,214,0,408,0,996,55,0,1673
2002,Botswana,Gaborone,1,0,5,0,18,0,0,24,0,0,11,0,26,0,0,37
2002,Central African Rep.,Boubou,38,0,132,0,118,0,0,288,54,0,178,0,109,0,0,341
2002,Central African Rep.,Bangui,698,0,2087,0,2058,0,0,4843,662,0,2055,0,2670,1,0,5388
2002,Central African Rep.,Mboki,3430,0,5386,0,7244,0,0,16060,3656,0,7038,0,9649,0,0,20343
2002,Central African Rep.,Kbando,16,0,35,0,29,0,0,80,23,0,34,0,34,0,0,91
2002,Central African Rep.,Sam ouandja,23,0,56,0,50,0,0,129,35,0,78,0,62,58,0,233
2002,Central African Rep.,Molangue,332,0,530,0,529,22,0,1413,326,0,582,0,590,18,0,1516
2002,Chile,Santiago de Chile,4,0,2,0,15,0,0,21,4,0,5,0,30,2,0,41
2002,China,Guangdong,2099,0,7299,0,23396,6870,0,39664,2535,0,8972,0,25474,6327,0,43308
2002,China,Fujian,848,0,3684,0,8125,667,0,13324,1131,0,3944,0,8568,689,0,14332
2002,China,Hainan,668,0,3191,0,7532,1991,0,13382,901,0,4310,0,9832,2010,0,17053
2002,China,Guangxi,2579,0,10505,0,32315,6383,0,51782,3511,0,11965,0,36013,6744,0,58233
2002,China,Yunnan,1427,0,6118,0,12589,1743,0,21877,2647,0,6339,0,12348,1369,0,22703
2002,China,Jiangxi,42,0,82,0,474,167,0,765,61,0,91,0,471,170,0,793
2002,Côte d'Ivoire,Tabou,1389,0,2617,0,4186,281,0,8473,1388,0,2289,0,3538,242,0,7457
2002,Côte d'Ivoire,San Pedro,58,0,81,0,227,7,0,373,48,0,93,0,169,5,0,315
2002,Côte d'Ivoire,Nicla,2,0,4,0,3,0,0,9,1,0,5,0,7,2,0,15
2002,Côte d'Ivoire,Man,0,0,3,0,16,0,0,19,2,0,2,0,16,1,0,21
2002,Côte d'Ivoire,Guiglo,286,0,573,0,1355,124,0,2338,254,0,879,0,821,116,0,2070
2002,Côte d'Ivoire,Danane,662,0,2509,0,2985,231,0,6387,601,0,2236,0,2666,174,0,5677
2002,Côte d'Ivoire,Abidjan,171,0,588,0,1367,86,0,2212,187,0,578,0,1537,50,0,2352
2002,Cameroon,Yaounde,102,0,178,0,582,0,0,862,150,0,204,0,1680,1,0,2035
2002,Dem. Rep. of the Congo,Zomfi,258,0,164,0,227,10,0,659,237,0,221,0,105,21,0,584
2002,Dem. Rep. of the Congo,Tshimbumbulu,1016,0,1896,0,2102,483,0,5497,1923,0,1464,0,2706,391,0,6484
2002,Dem. Rep. of the Congo,Tshilonda (Kasai),22,0,26,0,51,1,0,100,32,0,37,0,86,1,0,156
2002,Dem. Rep. of the Congo,Tshifwameso,357,0,936,0,813,43,0,2149,347,0,873,0,418,35,0,1673
2002,Dem. Rep. of the Congo,Tshabobo,56,0,50,0,103,0,0,209,70,0,47,0,133,3,0,253
2002,Dem. Rep. of the Congo,Sadi-Zulu,615,0,481,0,555,63,0,1714,703,0,631,0,383,41,0,1758
2002,Dem. Rep. of the Congo,Nkondo,1548,0,2037,0,2438,56,0,6079,1642,0,2018,0,1496,32,0,5188
2002,Dem. Rep. of the Congo,Napassa,266,0,798,0,695,29,0,1788,282,0,739,0,328,35,0,1384
2002,Dem. Rep. of the Congo,Mole-Zongo,180,0,699,0,534,28,0,1441,172,0,710,0,511,16,0,1409
2002,Dem. Rep. of the Congo,Lusuku,58,0,75,0,181,6,0,320,44,0,75,0,83,4,0,206
2002,Dem. Rep. of the Congo,Lubumbashi,48,0,112,0,172,16,0,348,57,0,117,0,186,9,0,369
2002,Dem. Rep. of the Congo,Kulindji,393,0,1006,0,925,68,0,2392,356,0,879,0,413,38,0,1686
2002,Dem. Rep. of the Congo,Kisenge,1056,0,2390,0,2371,22,0,5839,1201,0,2395,0,2938,42,0,6576
2002,Dem. Rep. of the Congo,Kinshasa,0,0,0,0,903,0,0,903,0,0,1,0,1750,0,0,1751
2002,Dem. Rep. of the Congo,Kinsalulu,311,0,611,0,617,65,0,1604,345,0,698,0,390,25,0,1458
2002,Dem. Rep. of the Congo,Kinsafu,270,0,781,0,583,56,0,1690,278,0,767,0,487,30,0,1562
2002,Dem. Rep. of the Congo,Kimpindi,59,0,168,0,146,21,0,394,70,0,181,0,78,13,0,342
2002,Dem. Rep. of the Congo,Kimfwakata,258,0,643,0,473,51,0,1425,265,0,629,0,354,24,0,1272
2002,Dem. Rep. of the Congo,Kimaza,158,0,300,0,349,10,0,817,151,0,314,0,477,15,0,957
2002,Dem. Rep. of the Congo,Kilueka,1343,0,2359,0,2280,168,0,6150,1246,0,2487,0,1590,111,0,5434
2002,Dem. Rep. of the Congo,Katsha,43,0,77,0,105,4,0,229,44,0,42,0,66,4,0,156
2002,Dem. Rep. of the Congo,Goma (Bukavu),12,0,57,0,57,4,0,130,24,0,73,0,72,5,0,174
2002,Dem. Rep. of the Congo,Dungu (Kpezu),58,0,169,0,272,3,0,502,68,0,173,0,323,13,0,577
2002,Dem. Rep. of the Congo,Dungu (Kaka2),252,0,963,0,937,12,0,2164,378,0,1276,0,1118,15,0,2787
2002,Dem. Rep. of the Congo,Dungu (Kaka1),142,0,425,0,371,2,0,940,205,0,661,0,563,8,0,1437
2002,Dem. Rep. of the Congo,Doruma (Mandofi),735,0,1443,0,1385,64,0,3627,741,0,1595,0,1669,45,0,4050
2002,Dem. Rep. of the Congo,Divuma,1687,0,2440,0,2601,308,0,7036,1537,0,2466,0,3213,424,0,7640
2002,Dem. Rep. of the Congo,Boga,354,0,929,0,821,154,0,2258,291,0,684,0,711,87,0,1773
2002,Dem. Rep. of the Congo,Biringi (Biringi),273,0,568,0,729,39,0,1609,308,0,834,0,860,69,0,2071
2002,Dem. Rep. of the Congo,Biringi (Ayamba),296,0,541,0,823,12,0,1672,311,0,699,0,478,29,0,1517
2002,Dem. Rep. of the Congo,Bas-Fleuve,50,0,229,0,217,33,0,529,47,0,204,0,212,16,0,479
2002,Dem. Rep. of the Congo,Aba (Rudu2),1077,0,2884,0,2654,295,0,6910,1144,0,3270,0,2667,245,0,7326
2002,Dem. Rep. of the Congo,Aba (Rudu1),349,0,733,0,626,72,0,1780,399,0,1097,0,733,57,0,2286
2002,Congo,Brazzaville,219,0,888,0,1282,5,0,2394,287,0,917,0,1856,93,0,3153
2002,Congo,Betou,1888,0,4272,0,4731,423,0,11314,1875,0,4308,0,4695,306,0,11184
2002,Congo,Kimongo-Malolo II,54,0,211,0,89,7,0,361,45,0,189,0,103,2,0,339
2002,Congo,Impfondo,5941,0,11915,0,10444,803,0,29103,5503,0,12326,0,8781,611,0,27221
2002,Congo,Komi,23,0,48,0,95,7,0,173,29,0,70,0,118,9,0,226
2002,Congo,Kintele,32,0,165,0,359,2,0,558,82,0,287,0,496,77,0,942
2002,Congo,Kouilou,124,0,3087,0,4275,676,0,8162,310,0,2377,0,4368,105,0,7160
2002,Congo,Kondi Mbaka,47,0,95,0,189,12,0,343,58,0,141,0,232,18,0,449
2002,Congo,Ndjoundou/Liranga,372,0,780,0,633,44,0,1829,350,0,729,0,598,31,0,1708
2002,Congo,Loukolela,822,0,550,0,859,34,0,2265,639,0,530,0,1219,23,0,2411
2002,Congo,Pointe-Noire,34,0,84,0,160,7,0,285,39,0,96,0,224,23,0,382
2002,Colombia,Armenia,1,0,0,0,1,0,0,2,0,0,2,0,1,0,0,3
2002,Colombia,Buenaventura,0,0,3,0,1,0,0,4,2,0,2,0,2,0,0,6
2002,Colombia,Bogotá,2,0,7,0,40,19,0,68,2,0,10,0,65,18,0,95
2002,Colombia,Duitama,0,0,1,0,1,1,0,3,0,0,1,0,1,0,0,2
2002,Colombia,Cali,1,0,0,0,2,0,0,3,0,0,1,0,2,0,0,3
2002,Colombia,San Andrés,0,0,2,0,10,1,0,13,0,0,1,0,12,1,0,14
2002,Colombia,Leticia,0,0,0,0,0,1,0,1,0,0,0,0,0,0,0,0
2002,Costa Rica,San Jose,53,0,271,0,1206,29,0,1559,53,0,289,0,1503,23,0,1868
2002,Costa Rica,Alajuela,8,0,42,0,138,5,0,193,10,0,49,0,164,6,0,229
2002,Costa Rica,Guanacaste,2,0,8,0,27,0,0,37,1,0,12,0,22,2,0,37
2002,Costa Rica,Cartago,1,0,16,0,43,2,0,62,2,0,21,0,44,1,0,68
2002,Costa Rica,Limon,0,0,7,0,19,0,0,26,0,0,4,0,25,1,0,30
2002,Costa Rica,Heredia,15,0,82,0,282,8,0,387,11,0,79,0,326,7,0,423
2002,Costa Rica,Puntarenas,1,0,8,0,37,1,0,47,2,0,11,0,42,3,0,58
2002,Cuba,Havana,0,0,9,0,18,0,0,27,2,0,9,0,24,0,0,35
2002,Cuba,Guantanamo,0,0,0,0,0,0,0,0,0,0,0,0,1,0,0,1
2002,Czech Rep.,Kasava,62,0,81,0,73,6,0,222,45,0,71,0,61,6,0,183
2002,Algeria,Smara,3055,0,5775,0,10504,1716,0,21050,3139,0,5859,0,10337,1465,0,20800
2002,Algeria,Dakhla,2952,0,5580,0,10150,1658,0,20340,3033,0,5661,0,9988,1415,0,20097
2002,Algeria,Ausserd,2512,0,4748,0,8637,1411,0,17308,2581,0,4817,0,8499,1204,0,17101
2002,Algeria,Alger,0,0,0,0,0,0,0,0,0,0,0,0,0,0,5,5
2002,Algeria,Al Ayoun,2828,0,5346,0,9723,1588,0,19485,2905,0,5423,0,9568,1356,0,19252
2002,Egypt,Cairo,548,0,1218,0,2428,180,0,4374,631,0,1377,0,3997,115,0,6120
2002,Eritrea,Emkulu,354,0,280,0,640,13,0,1287,204,0,494,0,983,22,0,1703
2002,Eritrea,Elit,52,0,61,0,100,3,0,216,80,0,79,0,239,8,0,406
2002,Eritrea,Asmara,1,0,1,0,1,0,0,3,0,0,1,0,3,0,0,4
2002,Estonia,Tallinn,0,0,2,0,2,0,0,4,1,0,2,0,4,0,0,7
2002,Estonia,Johvi,0,0,0,0,0,0,0,0,0,0,0,0,2,0,0,2
2002,Estonia,Illuka,0,0,0,0,0,0,0,0,0,0,0,0,3,0,0,3
2002,Ethiopia,Sherkole (Assosa),1799,0,2312,0,3264,35,0,7410,1834,0,3046,0,3614,70,0,8564
2002,Ethiopia,Kebribeyah (Jijiga),208,0,2819,0,2681,177,0,5885,202,0,2933,0,2377,231,0,5743
2002,Ethiopia,Hartisheik (Jijiga),226,0,2896,0,2499,133,0,5754,207,0,3344,0,2281,156,0,5988
2002,Ethiopia,Fugnido (Gambella),3227,0,4470,0,5763,130,0,13590,3502,0,5851,0,4891,91,0,14335
2002,Ethiopia,Dimma (Gambella),1830,0,1689,0,2804,111,0,6434,1786,0,3185,0,5869,96,0,10936
2002,Ethiopia,Bonga (Gambella),3158,0,2288,0,3255,88,0,8789,3326,0,2531,0,2200,81,0,8138
2002,Ethiopia,Bamboudi (Yarenja),257,0,696,0,937,29,0,1919,255,0,724,0,893,54,0,1926
2002,Ethiopia,Aisha (Jijiga),611,0,2906,0,3177,329,0,7023,617,0,3281,0,2692,366,0,6956
2002,Ethiopia, Shimelba (Shire/Shiraro) ,347,0,655,0,980,79,0,2061,392,0,765,0,1773,135,0,3065
2002,Gabon,Voungou-Pont,8,0,11,0,18,3,0,40,7,0,14,0,15,2,0,38
2002,Gabon,Tchibanga,172,0,364,0,473,11,0,1020,165,0,353,0,591,7,0,1116
2002,Gabon,Rinanzala,29,0,27,0,55,4,0,115,24,0,53,0,52,1,0,130
2002,Gabon,Rebe,3,0,2,0,3,0,0,8,0,0,2,0,0,0,0,2
2002,Gabon,Port-Gentil,8,0,24,0,31,2,0,65,3,0,26,0,142,9,0,180
2002,Gabon,Pana,1,0,4,0,1,0,0,6,0,0,3,0,7,0,0,10
2002,Gabon,Nzinga,9,0,18,0,23,4,0,54,11,0,15,0,9,1,0,36
2002,Gabon,Ngouoni,1,0,5,0,9,0,0,15,5,0,1,0,46,0,0,52
2002,Gabon,Ndende,52,0,86,0,172,9,0,319,55,0,81,0,145,3,0,284
2002,Gabon,Mounana,23,0,37,0,56,2,0,118,15,0,25,0,83,4,0,127
2002,Gabon,Moulengui B.F,11,0,24,0,38,2,0,75,12,0,22,0,33,0,0,67
2002,Gabon,Moulengui B.C,36,0,71,0,93,12,0,212,44,0,84,0,67,6,0,201
2002,Gabon,Mouila,43,0,62,0,133,3,0,241,32,0,62,0,190,0,0,284
2002,Gabon,Moanda,237,0,591,0,760,29,0,1617,256,0,515,0,900,20,0,1691
2002,Gabon,Mayumba,10,0,13,0,33,0,0,56,8,0,21,0,46,0,0,75
2002,Gabon,Mabanda,13,0,22,0,31,1,0,67,8,0,28,0,40,2,0,78
2002,Gabon,Libreville,240,0,690,0,1139,33,0,2102,215,0,641,0,2221,80,0,3157
2002,Gabon,Lekindou,7,0,22,0,22,1,0,52,9,0,17,0,17,3,0,46
2002,Gabon,Lebamba,8,0,11,0,17,0,0,36,11,0,16,0,26,2,0,55
2002,Gabon,Lastourville,17,0,25,0,34,1,0,77,8,0,26,0,27,1,0,62
2002,Gabon,Lambarene,0,0,4,0,11,0,0,15,1,0,4,0,22,2,0,29
2002,Gabon,Koumou-Doussala,0,0,4,0,4,1,0,9,2,0,4,0,9,0,0,15
2002,Gabon,Koula-Moutou,12,0,40,0,36,1,0,89,24,0,32,0,135,3,0,194
2002,Gabon,Gamba,10,0,15,0,72,0,0,97,13,0,11,0,111,2,0,137
2002,Gabon,Franceville,224,0,514,0,813,24,0,1575,269,0,395,0,1360,23,0,2047
2002,Gabon,Doussala,4,0,1,0,6,1,0,12,4,0,2,0,7,2,0,15
2002,Gabon,Dilemba,25,0,68,0,80,9,0,182,37,0,60,0,88,8,0,193
2002,Gabon,Dienga,4,0,6,0,6,2,0,18,3,0,5,0,8,0,0,16
2002,Gabon,Boumango,29,0,38,0,51,8,0,126,12,0,46,0,42,6,0,106
2002,Gabon,Banda Mamba,4,0,11,0,14,2,0,31,5,0,12,0,24,2,0,43
2002,Gabon,Bakoumba,28,0,35,0,50,4,0,117,23,0,33,0,26,2,0,84
2002,Georgia,Tbilisi,2411,0,10072,0,30477,8751,16,51727,2642,0,10108,0,22943,5206,16,40915
2002,Georgia,South Ossetia,0,0,0,0,0,0,273,273,0,0,0,0,0,0,258,258
2002,Georgia,Samegrelo,2121,0,11815,0,28356,10875,0,53167,2277,0,11511,0,22488,6946,0,43222
2002,Georgia,Rustavi,108,0,519,0,1313,331,0,2271,134,0,466,0,965,213,0,1778
2002,Georgia,Poti,160,0,775,0,2369,709,0,4013,198,0,880,0,1926,460,0,3464
2002,Georgia,Kvemo Kartli,138,0,1015,0,2073,455,0,3681,150,0,941,0,1579,295,0,2965
2002,Georgia,Kutaisi,353,0,1780,0,4651,1412,0,8196,391,0,1643,0,3505,824,0,6363
2002,Georgia,Khalatsani,15,0,21,0,39,1,0,76,24,0,32,0,48,2,0,106
2002,Georgia,Kartli,286,0,1234,0,2982,815,0,5317,371,0,1279,0,2367,570,0,4587
2002,Georgia,Jokolo,92,0,178,0,247,7,0,524,115,0,199,0,182,9,0,505
2002,Georgia,Imereti,416,0,1924,0,4983,1803,0,9126,379,0,1994,0,3902,1119,0,7394
2002,Georgia,Duisi,222,0,449,0,627,39,0,1337,253,0,494,0,600,31,0,1378
2002,Georgia,Batumi,56,0,220,0,915,282,0,1473,53,0,273,0,655,148,0,1129
2002,Georgia,Akhmeta,5,0,14,0,15,2,0,36,5,0,8,0,18,0,0,31
2002,Ghana,Volta Region,12,0,41,0,112,9,0,174,5,0,65,0,201,8,0,279
2002,Ghana,Kumasi,0,0,0,0,0,0,0,0,0,0,0,0,1,1,0,2
2002,Ghana,Krisan,85,0,297,0,507,21,0,910,108,0,256,0,661,17,0,1042
2002,Ghana,Buduburam,492,0,5435,0,6894,7,0,12828,467,0,5429,0,8276,1,0,14173
2002,Ghana,Accra,14,0,127,0,246,3,0,390,12,0,126,0,210,9,0,357
2002,Guinea,Yomou,530,0,1342,0,1173,118,0,3163,592,0,1131,0,1413,231,0,3367
2002,Guinea,Telikoro,773,0,1925,0,2481,368,0,5547,706,0,1934,0,1790,199,0,4629
2002,Guinea,Sembakouya,585,0,1063,0,1442,114,0,3204,591,0,1172,0,1635,161,0,3559
2002,Guinea,Nzerekore ville,385,0,3318,0,3224,318,0,7245,1550,0,4044,0,2397,610,0,8601
2002,Guinea,Nzerekore peripherie,267,0,634,0,620,26,0,1547,421,0,1298,0,1187,85,0,2991
2002,Guinea,Nonah,168,0,367,0,345,22,0,902,223,0,485,0,566,30,0,1304
2002,Guinea,Lola,494,0,847,0,1247,104,0,2692,990,0,1671,0,1801,239,0,4701
2002,Guinea,Laine,725,0,1166,0,1790,200,0,3881,700,0,1190,0,1424,144,0,3458
2002,Guinea,Kountaya,1244,0,3783,0,4693,763,0,10483,1368,0,3755,0,4209,522,0,9854
2002,Guinea,Kouankan,3375,0,5951,0,7903,2994,0,20223,3208,0,5473,0,2616,1902,0,13199
2002,Guinea,Kola,681,0,1451,0,1368,65,0,3565,679,0,1561,0,906,78,0,3224
2002,Guinea,Boreah,812,0,2120,0,2659,426,0,6017,793,0,2136,0,2016,338,0,5283
2002,Guinea,Beyla,879,0,2931,0,1574,294,0,5678,1867,0,4297,0,2213,553,0,8930
2002,Gambia,Basse,43,0,171,0,216,5,0,435,52,0,208,0,363,2,0,625
2002,Gambia,Bambali,22,0,60,0,78,7,0,167,18,0,72,0,69,11,0,170
2002,Guinea-Bissau,Sao Domingos,200,0,436,0,873,137,0,1646,184,0,488,0,587,161,0,1420
2002,Guinea-Bissau,Jolmete,35,0,94,0,94,11,0,234,31,0,143,0,101,10,0,285
2002,Guinea-Bissau,Ingore,255,0,742,0,912,81,0,1990,296,0,729,0,622,100,0,1747
2002,Guinea-Bissau,Bissau,14,0,22,0,51,0,0,87,20,0,31,0,219,0,0,270
2002,Greece,Lavrion,18,0,48,0,72,4,0,142,38,0,83,0,487,2,0,610
2002,Greece,Athens,20,0,68,0,387,8,0,483,21,0,302,0,2723,27,0,3073
2002,Guatemala,Guatemala City,1,0,1,0,339,35,0,376,2,0,5,0,325,35,0,367
2002,"China, Hong Kong SAR",Hong Kong,6,0,9,0,45,0,0,60,16,0,8,0,218,2,0,244
2002,Honduras,Trujillo,0,0,0,0,0,0,0,0,0,0,0,0,7,0,0,7
2002,Honduras,Tegucigalpa and San Pedro,0,0,1,0,7,0,0,8,0,0,0,0,16,1,0,17
2002,Honduras,La Ceiba,0,0,0,0,0,0,0,0,0,0,0,0,2,0,0,2
2002,Croatia,Rakitje,1,0,0,0,1,0,0,2,1,0,0,0,4,0,0,5
2002,Croatia,Jezevo,2,0,0,0,1,0,0,3,0,0,5,0,37,0,0,42
2002,Indonesia,Tanjung Pinang,0,0,0,0,0,0,0,0,0,0,0,0,2,0,0,2
2002,Indonesia,Situbondo ,0,0,4,0,9,0,0,13,1,0,10,0,27,0,0,38
2002,Indonesia,Mataram,0,0,0,0,1,0,0,1,0,0,0,0,4,0,0,4
2002,Indonesia,Jakarta,25,0,77,0,118,2,0,222,39,0,96,0,316,5,0,456
2002,India,Tamil Nadu,0,0,0,0,0,0,31884,31884,0,0,0,0,0,0,31884,31884
2002,India,New Delhi,227,0,2152,0,3732,325,0,6436,268,0,2230,0,3445,367,0,6310
2002,Iran (Islamic Rep. of),Qom,1,0,0,0,1,0,0,2,1,0,0,0,1,0,0,2
2002,Iraq,Wasit,247,0,531,0,571,65,0,1414,231,0,529,0,545,54,0,1359
2002,Iraq,Sulaimaniya,122,0,281,0,424,9,0,836,124,0,343,0,429,18,0,914
2002,Iraq,Makhmour,628,0,1999,0,1944,202,0,4773,693,0,2051,0,1692,175,0,4611
2002,Iraq,Maisan,189,0,475,0,491,71,0,1226,210,0,471,0,534,69,0,1284
2002,Iraq,Erbil,118,0,219,0,317,13,0,667,83,0,196,0,430,11,0,720
2002,Iraq,Dohuk,265,0,863,0,452,549,0,2129,273,0,775,0,457,582,0,2087
2002,Iraq,Baghdad,5,0,38,0,25,3,0,71,10,0,52,0,49,5,0,116
2002,Iraq,Al-Tash,776,0,2465,0,2269,256,0,5766,782,0,2753,0,2297,365,0,6197
2002,Jordan,Amman,115,0,746,0,1187,47,0,2095,133,0,811,0,1878,70,0,2892
2002,Kenya,Nairobi,630,0,2397,0,3385,173,0,6585,572,0,2645,0,5086,112,0,8415
2002,Kenya,Kakuma,7290,0,10628,0,14695,748,0,33361,8419,0,16060,0,23719,657,0,48855
2002,Kenya,Ifo (Dadaab),3709,0,8160,0,12044,590,0,24503,4028,0,9596,0,11926,669,0,26219
2002,Kenya,Hagadera (Dadaab),3918,0,8884,0,11935,624,0,25361,4147,0,9785,0,11773,744,0,26449
2002,Kenya,Dagahaley (Dadaab),2866,0,5597,0,7838,349,0,16650,2941,0,6467,0,7392,473,0,17273
2002,Kyrgyzstan,Osh and Djelalabad region,75,0,86,0,240,11,0,412,80,0,92,0,258,12,0,442
2002,Kyrgyzstan,Issyk-Kul,2,0,1,0,6,0,0,9,1,0,2,0,4,0,0,7
2002,Kyrgyzstan,Chui region,478,0,552,0,1525,75,0,2630,513,0,591,0,1633,78,0,2815
2002,Kyrgyzstan,Bishkek,76,0,86,0,243,12,0,417,83,0,96,0,271,13,0,463
2002,Kyrgyzstan,Batken,42,0,54,0,148,11,0,255,39,0,54,0,150,15,0,258
2002,Cambodia,Phnom Penh,5,0,8,0,44,0,0,57,3,0,11,0,63,3,0,80
2002,Cambodia,Site ,10,0,15,0,21,0,0,46,6,0,20,0,71,1,0,98
2002,Lebanon,Beirut,91,0,281,0,590,43,0,1005,109,0,307,0,1354,46,0,1816
2002,Liberia,Nimba,799,0,1628,0,1852,205,0,4484,797,0,1891,0,1380,153,0,4221
2002,Liberia,Montserrado,3808,0,4523,0,5146,571,0,14048,3432,0,4019,0,4546,500,0,12497
2002,Liberia,Maryland,96,0,109,0,106,12,0,323,67,0,104,0,82,9,0,262
2002,Liberia,Grand Cape Mount,1434,0,1542,0,1969,219,0,5164,1049,0,2087,0,1411,157,0,4704
2002,Libya,Tripoli,112,0,238,0,431,135,0,916,106,0,205,0,307,175,0,793
2002,Sri Lanka,Colombo,3,0,8,0,4,0,0,15,2,0,5,0,19,0,0,26
2002,Lithuania,Vilnius,2,0,1,0,4,1,0,8,1,0,1,0,18,0,0,20
2002,Lithuania,Telsiai,3,0,5,0,5,0,0,13,4,0,5,0,10,0,0,19
2002,Lithuania,Rukla,13,0,14,0,36,0,0,63,17,0,24,0,73,1,0,115
2002,Lithuania,Pabrade,12,0,21,0,36,0,0,69,9,0,22,0,53,2,0,86
2002,Lithuania,Marijampole,0,0,0,0,0,0,0,0,0,0,0,0,1,0,0,1
2002,Lithuania,Klaipeda,0,0,1,0,1,0,0,2,0,0,0,0,1,0,0,1
2002,Lithuania,Kaunas,2,0,12,0,11,0,0,25,7,0,13,0,25,0,0,45
2002,Lithuania,Jonava,6,0,13,0,22,0,0,41,9,0,18,0,27,0,0,54
2002,Lithuania,Druskininkai,1,0,0,0,2,0,0,3,0,0,3,0,1,0,0,4
2002,Latvia,Riga,0,0,0,0,0,0,0,0,0,0,0,0,3,0,0,3
2002,Latvia,Mucenieki,0,0,3,0,2,0,0,5,0,0,1,0,9,0,0,10
2002,Morocco,Tetouan,0,0,5,0,2,0,0,7,0,0,0,0,2,0,0,2
2002,Morocco,Tanger,0,0,0,0,5,1,0,6,0,0,0,0,13,0,0,13
2002,Morocco,Settat,0,0,0,0,0,0,0,0,0,0,0,0,2,0,0,2
2002,Morocco,Sale,0,0,1,0,1,0,0,2,1,0,1,0,4,2,0,8
2002,Morocco,Safi,0,0,0,0,0,0,0,0,0,0,0,0,1,0,0,1
2002,Morocco,Rabat,1,0,14,0,218,3,0,236,0,0,14,0,301,2,0,317
2002,Morocco,Oujda,0,0,0,0,0,0,0,0,0,0,0,0,1,0,0,1
2002,Morocco,Mohamadia,0,0,2,0,202,241,0,445,0,0,31,0,555,120,0,706
2002,Morocco,Meknes,0,0,0,0,0,0,0,0,0,0,0,0,2,0,0,2
2002,Morocco,Marrakech ,0,0,0,0,5,0,0,5,1,0,0,0,14,1,0,16
2002,Morocco,Fes,0,0,0,0,0,0,0,0,0,0,0,0,1,0,0,1
2002,Morocco,Casablanca,2,0,2,0,211,3,0,218,1,0,5,0,236,5,0,247
2002,Morocco,Benimellal,0,0,0,0,0,0,0,0,0,0,0,0,2,0,0,2
2002,Morocco,Agadir,0,0,0,0,2,0,0,2,0,0,0,0,6,0,0,6
2002,Mexico,Qintana Roo,57,0,137,0,74,17,0,285,58,0,143,0,74,12,0,287
2002,Mexico,Mexico City,4,0,280,0,1137,160,0,1581,12,0,273,0,1482,118,0,1885
2002,Mexico,Chiapas,458,0,1364,0,1942,126,0,3890,453,0,1362,0,2102,125,0,4042
2002,Mexico,Campeche,34,0,112,0,126,14,0,286,42,0,118,0,237,15,0,412
2002,The former Yugoslav Republic of Macedonia,Zdravko Cevtkovski,3,0,8,0,51,9,0,71,4,0,12,0,42,10,0,68
2002,The former Yugoslav Republic of Macedonia,Tome Stefanovski-Senic,1,0,11,0,47,7,0,66,2,0,23,0,50,6,0,81
2002,The former Yugoslav Republic of Macedonia,Tetovo,30,0,143,0,301,70,0,544,42,0,131,0,289,76,0,538
2002,The former Yugoslav Republic of Macedonia,Suto Orizari,67,0,182,0,236,16,0,501,62,0,179,0,256,15,0,512
2002,The former Yugoslav Republic of Macedonia,Stiv Naumov,7,0,50,0,169,40,0,266,15,0,66,0,177,23,0,281
2002,The former Yugoslav Republic of Macedonia,Skopje,187,0,585,0,1210,195,0,2177,231,0,617,0,1183,173,0,2204
2002,The former Yugoslav Republic of Macedonia,Ranka Milanovic,3,0,12,0,36,4,0,55,1,0,8,0,33,11,0,53
2002,The former Yugoslav Republic of Macedonia,Partenije Zografski,3,0,5,0,38,10,0,56,3,0,9,0,46,7,0,65
2002,The former Yugoslav Republic of Macedonia,Olimpisko Selo,4,0,19,0,66,6,0,95,7,0,18,0,60,9,0,94
2002,The former Yugoslav Republic of Macedonia,Kumanovo,87,0,316,0,783,170,0,1356,89,0,387,0,771,155,0,1402
2002,The former Yugoslav Republic of Macedonia,Katlanovo,17,0,78,0,88,7,0,190,18,0,73,0,98,7,0,196
2002,The former Yugoslav Republic of Macedonia,Internat,1,0,2,0,11,20,0,34,0,0,6,0,9,17,0,32
2002,The former Yugoslav Republic of Macedonia,Hotel Pelagonija,8,0,27,0,108,24,0,167,8,0,38,0,119,21,0,186
2002,The former Yugoslav Republic of Macedonia,Hotel Kuba,8,0,18,0,35,20,0,81,7,0,17,0,48,12,0,84
2002,The former Yugoslav Republic of Macedonia,Hotel Kristal,4,0,21,0,37,15,0,77,3,0,15,0,48,14,0,80
2002,The former Yugoslav Republic of Macedonia,Gerantoloski,0,0,0,0,0,1,0,1,0,0,0,0,0,0,0,0
2002,The former Yugoslav Republic of Macedonia,Gazi Baba,0,0,1,0,4,0,0,5,1,0,3,0,3,0,0,7
2002,The former Yugoslav Republic of Macedonia,Dom za stari,1,0,0,0,3,7,0,11,0,0,0,0,1,5,0,6
2002,The former Yugoslav Republic of Macedonia,Dimitrar Vlahov,3,0,8,0,15,1,0,27,2,0,3,0,14,3,0,22
2002,The former Yugoslav Republic of Macedonia,Cicino Selo,5,0,12,0,29,5,0,51,8,0,20,0,30,3,0,61
2002,The former Yugoslav Republic of Macedonia,Children embassy Megashi,3,0,4,0,7,0,0,14,3,0,0,0,6,0,0,9
2002,The former Yugoslav Republic of Macedonia,25 Maj,3,0,4,0,9,0,0,16,2,0,3,0,7,0,0,12
2002,Mali,Sikasso,17,0,63,0,103,3,0,186,27,0,50,0,152,7,0,236
2002,Mali,Kayes,802,0,1156,0,572,90,0,2620,324,0,1838,0,1207,126,0,3495
2002,Mali,Faraguara,5,0,19,0,31,1,0,56,8,0,15,0,46,2,0,71
2002,Mali,Bamako,117,0,430,0,705,43,0,1295,182,0,353,0,1079,43,0,1657
2002,Mozambique,Marratane,0,0,0,0,0,0,857,857,0,0,0,0,0,0,1169,1169
2002,Mozambique,Maputo,13,0,19,0,39,0,0,71,17,0,38,0,124,1,0,180
2002,Mozambique,Bobole,58,0,83,0,98,0,0,239,58,0,87,0,407,2,0,554
2002,Mauritania,Nouakchott,16,0,27,0,115,9,0,167,10,0,23,0,195,10,0,238
2002,Malawi,Dzaleka,1537,0,2694,0,2360,6,0,6597,1375,0,2824,0,2412,26,0,6637
2002,Malaysia,Sungei Buloh,0,0,0,0,0,0,0,0,0,0,0,0,1,0,0,1
2002,Malaysia,Sepang,2,0,0,0,2,0,0,4,0,0,5,0,3,0,0,8
2002,Malaysia,Macap Umbo,0,0,0,0,1,0,0,1,0,0,0,0,1,0,0,1
2002,Malaysia,Langkap,0,0,0,0,0,0,0,0,0,0,0,0,1,0,0,1
2002,Malaysia,Kuala Lumpur,13,0,38,0,73,4,0,128,29,0,30,0,207,2,0,268
2002,Namibia,Sibinda (Caprivi),0,0,0,0,2,0,0,2,2,0,0,0,8,0,0,10
2002,Namibia,Osire,1343,0,3356,0,2861,250,0,7810,1321,0,3762,0,2907,200,0,8190
2002,Namibia,Omega 3 (Caprivi),67,0,64,0,88,13,0,232,48,0,66,0,65,5,0,184
2002,Namibia,Omega 1(Caprivi),5,0,24,0,19,0,0,48,6,0,20,0,36,2,0,64
2002,Namibia,Ngweze (Caprivi),1,0,0,0,1,0,0,2,1,0,0,0,12,0,0,13
2002,Namibia,Napengu (Caprivi),0,0,0,0,0,0,0,0,0,0,0,0,1,0,0,1
2002,Namibia,Mushambo (Caprivi),1,0,0,0,1,0,0,2,1,0,1,0,3,0,0,5
2002,Namibia,Mukete (Caprivi),0,0,0,0,0,0,0,0,0,0,0,0,1,0,0,1
2002,Namibia,Lusu (Caprivi),1,0,0,0,2,0,0,3,1,0,0,0,1,0,0,2
2002,Namibia,Luhoto (Caprivi),0,0,0,0,0,0,0,0,0,0,0,0,1,0,0,1
2002,Namibia,Linyanti (Caprivi),1,0,0,0,2,0,0,3,2,0,1,0,5,0,0,8
2002,Namibia,Kuliyangilek (Caprivi),0,0,0,0,1,0,0,1,1,0,0,0,0,0,0,1
2002,Namibia,Kanono (Caprivi),0,0,0,0,0,0,0,0,0,0,0,0,1,0,0,1
2002,Namibia,Greenwell (Caprivi),0,0,0,0,1,0,0,1,1,0,0,0,0,0,0,1
2002,Namibia,Chetto (Caprivi),26,0,69,0,65,18,0,178,33,0,68,0,87,13,0,201
2002,Namibia,Bagani (Caprivi),6,0,5,0,11,1,0,23,4,0,7,0,11,0,0,22
2002,Niger,Niamey,14,0,24,0,47,0,0,85,13,0,28,0,86,0,0,127
2002,Niger,Goure,10,0,25,0,23,3,0,61,10,0,25,0,29,3,0,67
2002,Nigeria,Oru Camp,105,0,193,0,1537,11,0,1846,104,0,219,0,1424,18,0,1765
2002,Nigeria,Lagos,31,0,90,0,232,10,0,363,35,0,98,0,262,16,0,411
2002,Nicaragua,Managua,0,0,0,0,150,0,0,150,0,0,0,0,162,29,0,191
2002,Nepal,Timai,438,0,1587,0,2482,243,0,4750,419,0,1625,0,2639,302,0,4985
2002,Nepal,Sanischare,904,0,3615,0,4879,422,0,9820,1059,0,3687,0,5024,504,0,10274
2002,Nepal,Khudunabari,538,0,2176,0,3391,267,0,6372,512,0,2112,0,3419,384,0,6427
2002,Nepal,Kathmandu,0,0,2,0,4,1,0,7,0,0,4,0,24,0,0,28
2002,Nepal,Goldhap,360,0,1382,0,2412,228,0,4382,384,0,1428,0,2628,273,0,4713
2002,Nepal,Beldangi 2 extension,446,0,1721,0,3041,222,0,5430,488,0,1776,0,3097,309,0,5670
2002,Nepal,Beldangi 2,915,0,3399,0,5832,567,0,10713,997,0,3521,0,5905,654,0,11077
2002,Nepal,Beldangi 1,865,0,2824,0,4589,347,0,8625,953,0,2895,0,4732,445,0,9025
2002,Oman,Muscat,0,0,1,0,1,0,0,2,0,0,1,0,21,1,0,23
2002,Pakistan,Quetta,3,0,11,0,9,0,0,23,6,0,19,0,16,0,0,41
2002,Pakistan,Peshawar,12,0,19,0,24,0,0,55,18,0,36,0,33,1,0,88
2002,Pakistan,Karachi,4,0,16,0,22,1,0,43,2,0,13,0,36,2,0,53
2002,Pakistan,Islamabad,23,0,60,0,113,2,0,198,29,0,93,0,205,4,0,331
2002,Panama,Veragua,0,0,0,0,2,0,0,2,0,0,0,0,2,0,0,2
2002,Panama,Puerto Obaldia,6,0,20,0,17,3,0,46,4,0,29,0,32,3,0,68
2002,Panama,Panama City,1,0,74,0,194,15,0,284,2,0,64,0,248,15,0,329
2002,Panama,Los Santos,0,0,0,0,3,0,0,3,0,0,0,0,2,0,0,2
2002,Panama,Jaque,18,0,56,0,58,3,0,135,20,0,60,0,64,5,0,149
2002,Panama,Herrera,0,0,0,0,2,1,0,3,0,0,2,0,0,0,0,2
2002,Panama,David,0,0,0,0,8,1,0,9,0,0,4,0,1,0,0,5
2002,Panama,Darien Centro,24,0,83,0,102,5,0,214,25,0,92,0,122,8,0,247
2002,Panama,Darien,0,0,6,0,10,1,0,17,2,0,14,0,9,0,0,25
2002,Panama,Colon,0,0,0,0,2,1,0,3,0,0,1,0,1,0,0,2
2002,Panama,Cocle,0,0,2,0,8,1,0,11,0,0,0,0,9,1,0,10
2002,Panama,Bocas del Toro,0,0,1,0,1,0,0,2,0,0,2,0,1,0,0,3
2002,Papua New Guinea,Transmittal camp,22,0,41,0,75,1,0,139,17,0,46,0,95,3,0,161
2002,Papua New Guinea,Port Moresby,0,0,0,0,0,0,12,12,0,0,0,0,0,0,0,0
2002,Papua New Guinea,East Awin,0,0,0,0,0,0,194,194,0,0,0,0,0,0,238,238
2002,Paraguay,Asuncion,0,0,5,0,6,1,0,12,0,0,1,0,12,0,0,13
2002,Qatar,Doha,0,0,4,0,7,1,0,12,0,0,7,0,47,3,0,57
2002,Rwanda,Kigali,203,0,715,0,685,21,0,1624,226,0,734,0,1036,17,0,2013
2002,Rwanda,Kibuye,1724,0,3112,0,2943,401,0,8180,1455,0,2937,0,2065,364,0,6821
2002,Rwanda,Gikongoro,57,0,78,0,99,4,0,238,65,0,104,0,117,8,0,294
2002,Rwanda,Byumba,1647,0,3127,0,2976,496,0,8246,1238,0,2315,0,1183,287,0,5023
2002,Saudi Arabia,Rafha ,275,0,836,0,616,58,0,1785,300,0,819,0,2260,48,0,3427
2002,Sudan,Wad Sherife,1645,0,6912,0,7591,582,0,16730,1643,0,7320,0,5710,639,0,15312
2002,Sudan,Wad El Hilea,513,0,1403,0,1136,166,0,3218,420,0,1513,0,2015,149,0,4097
2002,Sudan,Wad Awad,36,0,138,0,118,27,0,319,25,0,134,0,122,10,0,291
2002,Sudan,Um Sagata,500,0,425,0,280,110,0,1315,560,0,450,0,152,710,0,1872
2002,Sudan,Um Gargur,330,0,665,0,734,106,0,1835,269,0,677,0,787,61,0,1794
2002,Sudan,Um Ali,268,0,645,0,567,81,0,1561,221,0,618,0,719,74,0,1632
2002,Sudan,Tenedba,6,0,23,0,23,5,0,57,3,0,22,0,30,2,0,57
2002,Sudan,Suki,224,0,448,0,623,40,0,1335,109,0,335,0,753,76,0,1273
2002,Sudan,"Shagrabs 1, 2 & 3",1927,0,3143,0,3102,501,0,8673,1882,0,3996,0,6105,393,0,12376
2002,Sudan,Mafaza,77,0,203,0,229,16,0,525,90,0,232,0,261,32,0,615
2002,Sudan,Kilo 26,585,0,1968,0,1895,232,0,4680,546,0,1793,0,2259,147,0,4745
2002,Sudan,Karkora,472,0,1131,0,1094,168,0,2865,438,0,1023,0,1314,94,0,2869
2002,Sudan,Hawata,162,0,332,0,340,45,0,879,147,0,311,0,366,25,0,849
2002,Sudan,Girba,470,0,1820,0,2215,159,0,4664,526,0,2058,0,1919,245,0,4748
2002,Sudan,Fau 5,87,0,351,0,252,35,0,725,86,0,250,0,270,13,0,619
2002,Sudan,Asotriba,263,0,439,0,497,0,0,1199,244,0,474,0,435,0,0,1153
2002,Sudan,Abuda,311,0,914,0,950,92,0,2267,336,0,987,0,880,127,0,2330
2002,Sudan,Abu Rakhman,143,0,396,0,333,66,0,938,123,0,370,0,406,32,0,931
2002,Senegal,Podor,942,0,2265,0,1355,239,0,4801,628,0,1504,0,904,160,0,3196
2002,Senegal,Matam,949,0,2270,0,1358,240,0,4817,638,0,1514,0,905,160,0,3217
2002,Senegal,Dakar,14,0,99,0,375,8,0,496,25,0,96,0,756,107,0,984
2002,Senegal,Dagana,229,0,542,0,323,57,0,1151,153,0,361,0,216,38,0,768
2002,Senegal,Bakel,217,0,517,0,308,54,0,1096,145,0,344,0,206,36,0,731
2002,Singapore,Singapore,0,0,0,0,1,0,0,1,0,0,0,0,3,0,0,3
2002,Sierra Leone,Taiiama,759,0,1045,0,1688,170,0,3662,709,0,1181,0,1724,164,0,3778
2002,Sierra Leone,Largo,268,0,592,0,1059,94,0,2013,276,0,582,0,728,126,0,1712
2002,Sierra Leone,Kono,7,0,28,0,29,1,0,65,6,0,25,0,23,1,0,55
2002,Sierra Leone,Kenema,137,0,525,0,548,23,0,1233,114,0,479,0,434,23,0,1050
2002,Sierra Leone,Kailahun,25,0,95,0,99,4,0,223,21,0,87,0,78,4,0,190
2002,Sierra Leone,Jimmi Bagbo,603,0,1113,0,1365,217,0,3298,455,0,1030,0,1352,317,0,3154
2002,Sierra Leone,Jembe,599,0,738,0,1509,462,0,3308,624,0,585,0,1426,728,0,3363
2002,Sierra Leone,Gondama,198,0,1057,0,1816,264,0,3335,283,0,696,0,1777,258,0,3014
2002,Sierra Leone,Gerrihun,471,0,779,0,1539,566,0,3355,460,0,739,0,1576,510,0,3285
2002,Sierra Leone,Freetown,267,0,1010,0,1060,49,0,2386,224,0,918,0,844,46,0,2032
2002,Sierra Leone,Bo,66,0,252,0,263,11,0,592,55,0,230,0,208,9,0,502
2002,Sierra Leone,Bandajuma,444,0,730,0,863,629,0,2666,513,0,790,0,1128,726,0,3157
2002,El Salvador,San Salvador,0,0,1,0,10,0,0,11,3,0,5,0,9,0,0,17
2002,El Salvador,San Miguel,6,0,1,0,5,0,0,12,2,0,0,0,5,0,0,7
2002,El Salvador,Libertad,0,0,3,0,1,0,0,4,0,0,1,0,0,0,0,1
2002,El Salvador,La Union,2,0,1,0,4,0,0,7,7,0,4,0,7,5,0,23
2002,Somalia,Hargeisa,17,0,22,0,55,0,0,94,18,0,27,0,60,0,0,105
2002,Serbia and Kosovo (S/RES/1244 (1999)),Kosovo,247,0,599,0,1043,137,0,2026,270,0,675,0,882,122,0,1949
2002,Serbia and Kosovo (S/RES/1244 (1999)),Vojvodina,1643,0,14795,0,56549,20672,0,93659,1842,0,15390,0,54376,14554,0,86162
2002,Serbia and Kosovo (S/RES/1244 (1999)),Montenegro,1026,0,4901,0,12546,3677,0,22150,1108,0,5167,0,11466,2889,0,20630
2002,Serbia and Kosovo (S/RES/1244 (1999)),Central and Southern Serbia,3614,0,15221,0,41057,12530,0,72422,3914,0,15780,0,40553,9947,0,70194
2002,Serbia and Kosovo (S/RES/1244 (1999)),Belgrade area/West of Serbia,3214,0,20236,0,68931,23111,0,115492,3467,0,21476,0,63189,16447,0,104579
2002,Slovenia,Vrhnika,0,0,0,0,0,0,1,1,0,0,0,0,0,0,0,0
2002,Slovenia,Ptuj,0,0,0,0,0,0,1,1,0,0,0,0,0,0,0,0
2002,Slovenia,Postojna,0,0,0,0,0,0,20,20,0,0,0,0,0,0,13,13
2002,Slovenia,Novo Mesto,0,0,0,0,0,0,11,11,0,0,0,0,0,0,7,7
2002,Slovenia,Medvode,0,0,0,0,0,0,0,0,0,0,0,0,0,0,1,1
2002,Slovenia,Maribor,0,0,0,0,0,0,4,4,0,0,0,0,0,0,0,0
2002,Slovenia,Ljubljana,0,0,0,0,0,0,68,68,0,0,0,0,0,0,59,59
2002,Slovenia,Kranj,0,0,0,0,0,0,1,1,0,0,0,0,0,0,0,0
2002,Slovenia,Kozina,0,0,0,0,0,0,20,20,0,0,0,0,0,0,17,17
2002,Slovenia,Illirska Bistrica,0,0,0,0,0,0,6,6,0,0,0,0,0,0,11,11
2002,Slovenia,Hrastnik,0,0,0,0,0,0,0,0,0,0,0,0,0,0,1,1
2002,Slovenia,Grgar,0,0,0,0,0,0,1,1,0,0,0,0,0,0,0,0
2002,Slovenia,Crnomelj,0,0,0,0,0,0,3,3,0,0,0,0,0,0,4,4
2002,Slovenia,Celje,0,0,0,0,0,0,3,3,0,0,0,0,0,0,9,9
2002,Swaziland,Malindza,6,0,12,0,30,1,0,49,8,0,19,0,38,0,0,65
2002,Syrian Arab Rep.,El-Hol,11,0,14,0,27,1,0,53,8,0,11,0,29,1,0,49
2002,Syrian Arab Rep.,Damascus,122,0,455,0,689,38,584,1888,119,0,562,0,783,48,804,2316
2002,Chad,Adre/Abeche,121,0,251,0,254,2,0,628,108,0,310,0,403,6,0,827
2002,Togo,Sotouboua,912,0,1389,0,1201,24,0,3526,901,0,1108,0,733,20,0,2762
2002,Togo,Lome,57,0,173,0,322,6,0,558,52,0,162,0,434,4,0,652
2002,Togo,Dankpen,302,0,602,0,792,17,0,1713,277,0,257,0,295,27,0,856
2002,Togo,Bassar,274,0,612,0,547,9,0,1442,289,0,298,0,301,21,0,909
2002,Thailand,Um Pium (Pob Phra),907,0,2572,0,3647,268,0,7394,955,0,2797,0,3812,242,0,7806
2002,Thailand,Tham Hin,665,0,1688,0,1951,165,0,4469,675,0,1710,0,1845,166,0,4396
2002,Thailand,Pangkwai,823,0,1959,0,2914,166,0,5862,845,0,2054,0,3214,197,0,6310
2002,Thailand,Nu Po (Umphang),620,0,1483,0,1899,145,0,4147,562,0,1540,0,2038,116,0,4256
2002,Thailand,Napho,2,0,6,0,4,0,0,12,3,0,13,0,6,0,0,22
2002,Thailand,Nai Soi,325,0,652,0,1021,46,0,2044,302,0,663,0,1315,58,0,2338
2002,Thailand,Mae Surin,178,0,470,0,673,29,0,1350,214,0,469,0,901,50,0,1634
2002,Thailand,Mae Ra Ma Luang (Sob Moei),589,0,1501,0,2022,208,0,4320,626,0,1706,0,2269,205,0,4806
2002,Thailand,Mae La (Thasongyang),2113,0,5303,0,7760,559,0,15735,2210,0,5680,0,7961,544,0,16395
2002,Thailand,Mae Kong Kha (Mae Sariang),937,0,2329,0,3148,218,0,6632,1036,0,2544,0,3457,268,0,7305
2002,Thailand,Don Yang,276,0,683,0,847,44,0,1850,277,0,730,0,712,61,0,1780
2002,Thailand,Bangkok,61,0,172,0,417,21,0,671,71,0,202,0,790,17,0,1080
2002,Tajikistan,Khujand,12,0,65,0,69,3,9,158,14,0,50,0,70,3,78,215
2002,Tajikistan,Dushanbe,0,0,1,0,3,0,1700,1704,0,0,1,0,14,0,1441,1456
2002,Turkmenistan,Vekilbazar region,10,0,45,0,70,3,0,128,16,0,43,0,73,13,0,145
2002,Turkmenistan,Turkmenabad,7,0,35,0,31,0,0,73,19,0,58,0,49,0,0,126
2002,Turkmenistan,Serdarabat region,13,0,55,0,86,3,0,157,18,0,50,0,84,15,0,167
2002,Turkmenistan,Seidi,17,0,73,0,114,4,0,208,28,0,76,0,126,22,0,252
2002,Turkmenistan,Sayat region,4,0,17,0,28,1,0,50,5,0,14,0,23,4,0,46
2002,Turkmenistan,Sakarchaga region,4,0,16,0,25,1,0,46,9,0,23,0,39,7,0,78
2002,Turkmenistan,Oguzkhan region,175,0,767,0,1204,44,0,2190,280,0,763,0,1274,229,0,2546
2002,Turkmenistan,Niyzov region,168,0,737,0,1158,43,0,2106,239,0,651,0,1084,195,0,2169
2002,Turkmenistan,Mary,0,0,1,0,4,0,0,5,0,0,3,0,2,0,0,5
2002,Turkmenistan,Magdanly city,4,0,19,0,29,1,0,53,8,0,21,0,35,7,0,71
2002,Turkmenistan,Koitendag region,10,0,40,0,64,2,0,116,11,0,30,0,50,9,0,100
2002,Turkmenistan,Khojambaz region,11,0,49,0,78,3,0,141,22,0,61,0,100,18,0,201
2002,Turkmenistan,Khalach region,7,0,30,0,46,2,0,85,15,0,42,0,70,13,0,140
2002,Turkmenistan,Karabekavul region,2,0,10,0,16,1,0,29,4,0,10,0,16,3,0,33
2002,Turkmenistan,Gavers region,28,0,121,0,191,7,0,347,50,0,137,0,228,41,0,456
2002,Turkmenistan,Garashsyzlyl region,6,0,27,0,42,2,0,77,8,0,23,0,38,7,0,76
2002,Turkmenistan,Galkynysh region,12,0,53,0,84,3,0,152,18,0,50,0,84,16,0,168
2002,Turkmenistan,Atamourad region,23,0,101,0,159,6,0,289,34,0,93,0,154,28,0,309
2002,Turkmenistan,Ashgabat,11,0,54,0,94,12,0,171,14,0,55,0,100,13,3,185
2002,Timor-Leste,Dili,0,0,0,0,0,0,0,0,0,0,0,0,5,0,0,5
2002,Tunisia,Tunis,1,0,3,0,31,8,0,43,5,0,6,0,41,7,0,59
2002,Turkey,Yozgat,2,0,7,0,5,0,0,14,0,0,5,0,4,0,0,9
2002,Turkey,Van,14,0,34,0,67,4,0,119,12,0,42,0,158,3,0,215
2002,Turkey,Sivas,1,0,1,0,1,0,0,3,0,0,4,0,6,0,0,10
2002,Turkey,Nigde,3,0,12,0,38,2,0,55,3,0,17,0,44,0,0,64
2002,Turkey,Nevsehir,5,0,16,0,38,4,0,63,5,0,21,0,44,3,0,73
2002,Turkey,Kutahya,1,0,4,0,6,1,0,12,0,0,8,0,6,2,0,16
2002,Turkey,Konya,2,0,9,0,11,0,0,22,1,0,9,0,16,0,0,26
2002,Turkey,Kirsehir,3,0,6,0,19,0,0,28,2,0,9,0,29,0,0,40
2002,Turkey,Kirklareli,1,0,4,0,10,2,0,17,1,0,7,0,13,1,0,22
2002,Turkey,Kayseri,16,0,65,0,148,4,0,233,12,0,74,0,171,5,0,262
2002,Turkey,Kastamonu,0,0,1,0,10,0,0,11,1,0,6,0,17,0,0,24
2002,Turkey,Istanbul,10,0,45,0,156,21,0,232,14,0,64,0,145,13,0,236
2002,Turkey,Eskisehir,7,0,9,0,44,0,0,60,7,0,12,0,39,1,0,59
2002,Turkey,Cankiri,0,0,3,0,4,1,0,8,1,0,6,0,3,0,0,10
2002,Turkey,Burdur,2,0,3,0,7,0,0,12,4,0,2,0,48,0,0,54
2002,Turkey,Bilecik,1,0,2,0,12,0,0,15,2,0,10,0,17,0,0,29
2002,Turkey,Ankara,9,0,26,0,38,0,0,73,6,0,30,0,46,1,0,83
2002,Turkey,Amasya,2,0,5,0,19,0,0,26,2,0,9,0,32,1,0,44
2002,Turkey,Aksaray,4,0,11,0,27,0,0,42,1,0,9,0,30,3,0,43
2002,Turkey,Afyon,3,0,7,0,18,1,0,29,2,0,14,0,19,0,0,35
2002,United Rep. of Tanzania,Ulyankulu,0,0,0,0,0,0,23184,23184,0,0,0,0,0,0,18816,18816
2002,United Rep. of Tanzania,Nyarugusu (Kasulu),4834,0,10805,0,11943,853,0,28435,4918,0,10928,0,10654,819,0,27319
2002,United Rep. of Tanzania,Nduta (Kibondo),5899,0,8355,0,9831,492,0,24577,5882,0,8186,0,11000,512,0,25580
2002,United Rep. of Tanzania,Myovosi (Kasulu),3619,0,6667,0,8381,381,0,19048,3569,0,6939,0,8922,396,0,19826
2002,United Rep. of Tanzania,Mwisa (Ngara),0,0,0,0,7,0,0,7,0,0,0,0,182,0,0,182
2002,United Rep. of Tanzania,Mtendeli (Kibondo),6268,0,8881,0,10448,523,0,26120,6007,0,8619,0,10970,523,0,26119
2002,United Rep. of Tanzania,Mtabila-2 (Kasulu),4068,0,8135,0,8777,428,0,21408,4011,0,8467,0,9135,668,0,22281
2002,United Rep. of Tanzania,Mtabila-1 (Kasulu),1561,0,3469,0,3490,152,0,8672,1564,0,3476,0,3389,261,0,8690
2002,United Rep. of Tanzania,Mkuyu (Tanga),315,0,703,0,685,148,0,1851,410,0,722,0,411,99,0,1642
2002,United Rep. of Tanzania,Mkuyu (Handeni Tanga),0,0,0,0,0,0,31,31,0,0,0,0,0,0,133,133
2002,United Rep. of Tanzania,Mkugwa (Kibondo),235,0,304,0,421,20,0,980,235,0,317,0,460,10,0,1022
2002,United Rep. of Tanzania,Mishamo,0,0,0,0,0,0,24840,24840,0,0,0,0,0,0,20160,20160
2002,United Rep. of Tanzania,Mbuba (Ngara),8,0,17,0,18,5,0,48,15,0,21,0,20,9,0,65
2002,United Rep. of Tanzania,Lukole (Ngara),10350,0,19538,0,23370,1088,0,54346,10198,0,20880,0,24333,1130,0,56541
2002,United Rep. of Tanzania,Lugufu (Kigoma),7328,0,16379,0,18104,1294,0,43105,7041,0,17394,0,16152,828,0,41415
2002,United Rep. of Tanzania,Kitali Hill (Ngara),448,0,837,0,1127,22,0,2434,453,0,898,0,1293,27,0,2671
2002,United Rep. of Tanzania,Katumba,0,0,0,0,0,0,46920,46920,0,0,0,0,0,0,38080,38080
2002,United Rep. of Tanzania,Karago (Kibondo),4021,0,6398,0,7495,366,0,18280,4215,0,6322,0,6849,176,0,17562
2002,United Rep. of Tanzania,Kane Mbwa (Kibondo),2158,0,3190,0,3753,282,0,9383,2344,0,3222,0,3810,389,0,9765
2002,Uganda,Rhino Camp,1880,0,5520,0,4651,156,0,12207,1985,0,6366,0,4786,108,0,13245
2002,Uganda,Oruchinga,683,0,721,0,818,35,0,2257,700,0,804,0,798,43,0,2345
2002,Uganda,Nakivale,2234,0,2251,0,2452,74,0,7011,2506,0,2453,0,2710,90,0,7759
2002,Uganda,Moyo,2147,0,5263,0,5969,247,0,13626,2543,0,6108,0,5741,222,0,14614
2002,Uganda,Masindi,1367,0,2374,0,2863,287,0,6891,1349,0,2731,0,2619,251,0,6950
2002,Uganda,Kyaka 2,492,0,457,0,542,101,0,1592,425,0,490,0,528,124,0,1567
2002,Uganda,Kitgum,2959,0,2804,0,3058,213,0,9034,1004,0,3097,0,2058,189,0,6348
2002,Uganda,Kampala,39,0,119,0,166,5,0,329,47,0,129,0,193,4,0,373
2002,Uganda,Imvepi,829,0,2921,0,2727,105,0,6582,1044,0,3761,0,3035,82,0,7922
2002,Uganda,Hoima,1970,0,2607,0,2996,252,0,7825,2042,0,3120,0,3063,174,0,8399
2002,Uganda,Adjumani,4229,0,11330,0,13205,752,0,29516,4628,0,12653,0,13236,625,0,31142
2002,Ukraine,Odessa,17,0,33,0,58,6,0,114,6,0,52,0,427,3,0,488
2002,Ukraine,Kiev,30,0,186,0,182,15,0,413,32,0,166,0,461,17,0,676
2002,Uruguay,Montevideo,2,0,5,0,28,4,0,39,1,0,8,0,49,3,0,61
2002,Uzbekistan,Termez,16,0,103,0,82,4,0,205,10,0,88,0,125,8,0,231
2002,Uzbekistan,Tashkent,1667,0,1530,0,2169,489,0,5855,1449,0,1430,0,2150,421,0,5450
2002,Uzbekistan,Syrdarya,1658,0,967,0,1519,461,0,4605,1412,0,824,0,1295,392,0,3923
2002,Uzbekistan,Surkhandarya,1562,0,912,0,1433,434,0,4341,1331,0,776,0,1220,370,0,3697
2002,Uzbekistan,Samarkand,870,0,508,0,798,242,0,2418,742,0,433,0,680,205,0,2060
2002,Uzbekistan,Kashkadarya,784,0,458,0,719,218,0,2179,668,0,390,0,612,186,0,1856
2002,Uzbekistan,Fergana,887,0,518,0,813,247,0,2465,756,0,441,0,693,210,0,2100
2002,Venezuela (Bolivarian Republic of),Caracas,9,0,8,0,49,1,0,67,15,0,19,0,87,3,0,124
2002,Venezuela (Bolivarian Republic of),Villa de Rosario (Zulia),0,0,0,0,1,0,0,1,0,0,0,0,3,0,0,3
2002,Venezuela (Bolivarian Republic of),Urena (Tachira),3,0,13,0,8,1,0,25,4,0,8,0,11,2,0,25
2002,Venezuela (Bolivarian Republic of),Trujillo (Trujillo),1,0,2,0,3,0,0,6,0,0,1,0,3,0,0,4
2002,Venezuela (Bolivarian Republic of),Tovar (Merida),0,0,0,0,0,0,0,0,0,0,0,0,1,0,0,1
2002,Venezuela (Bolivarian Republic of),Socopo (Barinas),0,0,0,0,1,0,0,1,0,0,0,0,1,1,0,2
2002,Venezuela (Bolivarian Republic of),Santa Barbara (Zulia),1,0,3,0,2,0,0,6,2,0,1,0,2,0,0,5
2002,Venezuela (Bolivarian Republic of),Santa Ana (Tachira),1,0,7,0,9,0,0,17,0,0,5,0,9,0,0,14
2002,Venezuela (Bolivarian Republic of),San Cristobal (Tachira),5,0,18,0,28,3,0,54,7,0,22,0,34,3,0,66
2002,Venezuela (Bolivarian Republic of),San Carlos (Zulia),0,0,0,0,0,0,0,0,0,0,0,0,1,0,0,1
2002,Venezuela (Bolivarian Republic of),San Antonio (Tachira),2,0,4,0,10,0,0,16,4,0,3,0,14,1,0,22
2002,Venezuela (Bolivarian Republic of),Sabaneta (Tachira),0,0,1,0,1,0,0,2,0,0,1,0,1,0,0,2
2002,Venezuela (Bolivarian Republic of),Rubio (Tachira),2,0,5,0,6,0,0,13,4,0,7,0,9,0,0,20
2002,Venezuela (Bolivarian Republic of),Rio de Oro (Zulia),1,0,0,0,1,1,0,3,1,0,0,0,1,0,0,2
2002,Venezuela (Bolivarian Republic of),Puerto Infante (Apure),5,0,16,0,12,2,0,35,3,0,19,0,13,5,0,40
2002,Venezuela (Bolivarian Republic of),Palotal (Tachira),1,0,1,0,1,0,0,3,0,0,0,0,1,0,0,1
2002,Venezuela (Bolivarian Republic of),Merida (Merida),0,0,0,0,1,0,0,1,1,0,0,0,4,0,0,5
2002,Venezuela (Bolivarian Republic of),Maracaibo (Zulia),0,0,2,0,10,0,0,12,0,0,0,0,5,0,0,5
2002,Venezuela (Bolivarian Republic of),La Victoria (Apure),0,0,1,0,1,0,0,2,0,0,3,0,1,0,0,4
2002,Venezuela (Bolivarian Republic of),Guasdualito (Apure),9,0,13,0,22,0,0,44,7,0,13,0,23,0,0,43
2002,Venezuela (Bolivarian Republic of),El Vigia (Merida),0,0,4,0,3,1,0,8,0,0,2,0,4,0,0,6
2002,Venezuela (Bolivarian Republic of),El Pinal (Tachira),0,0,0,0,1,0,0,1,0,0,4,0,2,0,0,6
2002,Venezuela (Bolivarian Republic of),El Nula (Apure),19,0,37,0,59,6,0,121,20,0,55,0,67,8,0,150
2002,Venezuela (Bolivarian Republic of),El Cruce (Zulia),0,0,0,0,3,1,0,4,0,0,2,0,3,0,0,5
2002,Venezuela (Bolivarian Republic of),El Amparo (Apure),1,0,2,0,2,0,0,5,3,0,3,0,1,0,0,7
2002,Venezuela (Bolivarian Republic of),Ciudad Sucre (Apure),0,0,1,0,1,0,0,2,0,0,1,0,1,0,0,2
2002,Venezuela (Bolivarian Republic of),Barinas (Barinas),1,0,0,0,1,0,0,2,1,0,0,0,2,0,0,3
2002,Viet Nam,Binh Duong,0,0,0,0,0,0,1118,1118,0,0,0,0,0,0,963,963
2002,Yemen,Taiz,59,0,1622,0,2956,237,0,4874,64,0,1609,0,2820,203,0,4696
2002,Yemen,Shihir,5,0,40,0,51,6,0,102,4,0,44,0,51,2,0,101
2002,Yemen,Sana'a,202,0,4536,0,8977,718,0,14433,282,0,4871,0,8155,616,0,13924
2002,Yemen,Mukalla,36,0,497,0,807,77,0,1417,49,0,493,0,847,67,0,1456
2002,Yemen,Mahra,15,0,64,0,125,7,0,211,16,0,54,0,126,7,0,203
2002,Yemen,Hodeidah,6,0,176,0,294,37,0,513,3,0,175,0,245,16,0,439
2002,Yemen,Dhamar,0,0,17,0,31,2,0,50,1,0,16,0,28,1,0,46
2002,Yemen,Al-Kharaz,1179,0,1950,0,2187,55,0,5371,1157,0,2153,0,1567,45,0,4922
2002,Yemen,Al-Baida,2,0,57,0,86,7,0,152,1,0,46,0,92,2,0,141
2002,Yemen,Aden,290,0,2776,0,5389,371,0,8826,332,0,2843,0,6192,306,0,9673
2002,South Africa,Pretoria,24,0,139,0,291,0,0,454,32,0,200,0,458,0,0,690
2002,South Africa,Johannesburg,0,0,0,0,0,0,0,0,0,0,0,0,2,0,0,2
2002,South Africa,Durban,51,0,123,0,201,1,0,376,56,0,98,0,362,0,0,516
2002,South Africa,Cape Town,153,0,806,0,1383,1,0,2343,242,0,838,0,2166,10,0,3256
2002,Zambia,Ukwimi,218,0,403,0,382,27,0,1030,236,0,458,0,658,36,0,1388
2002,Zambia,Nangweshi,2145,0,5357,0,4475,195,0,12172,2284,0,5282,0,5432,345,0,13343
2002,Zambia,Mwange,2323,0,4167,0,4970,310,0,11770,2297,0,3975,0,4643,291,0,11206
2002,Zambia,Meheba,4434,0,8050,0,10278,1647,0,24409,4244,0,7909,0,9719,1498,0,23370
2002,Zambia,Mayukwayukwa,1824,0,4158,0,4707,747,0,11436,1659,0,3838,0,3776,776,0,10049
2002,Zambia,Kala,1851,0,3445,0,3823,210,0,9329,1808,0,3231,0,3735,182,0,8956
2002,Zimbabwe,Tongogara,94,0,131,0,223,0,0,448,112,0,293,0,705,0,0,1110
2003,Afghanistan,Various,92680,0,271223,0,386000,63921,165788,979612,102322,0,297765,0,616159,64568,209839,1290653
2003,Angola,Viana,433,0,1874,0,1526,40,0,3873,439,0,1839,0,880,35,0,3193
2003,Angola,Sungi,15,0,81,0,82,4,0,182,13,0,69,0,54,11,0,147
2003,Angola,Moxico,219,0,734,0,427,25,0,1405,226,0,711,0,139,15,0,1091
2003,Angola,Malange,53,0,153,0,237,4,0,447,40,0,177,0,135,10,0,362
2003,Angola,Lunda Sul,53,0,167,0,210,2,0,432,9,0,52,0,315,2,0,378
2003,Angola,Luanda,43,0,139,0,485,2,0,669,51,0,175,0,554,13,0,793
2003,Angola,Kwanza Sul,0,0,22,0,16,0,0,38,0,0,17,0,26,0,0,43
2003,Angola,Kwanza Norte,0,0,8,0,5,0,0,13,1,0,10,0,11,0,0,22
2003,Angola,Keutepwe,43,0,87,0,117,13,0,260,35,0,70,0,94,11,0,210
2003,Angola,Kamatende,93,0,186,0,162,18,0,459,94,0,187,0,82,8,0,371
2003,Albania,Tirana,6,0,3,0,16,0,0,25,1,0,6,0,15,0,0,22
2003,Albania,Peshkopi,0,0,0,0,1,0,0,1,0,0,0,0,0,0,0,0
2003,Albania,Lac,0,0,0,0,2,0,0,2,0,0,1,0,2,1,0,4
2003,Albania,Fier,0,0,2,0,0,0,0,2,0,0,1,0,0,0,0,1
2003,Albania,Elbasan,0,0,1,0,1,0,0,2,1,0,0,0,0,0,0,1
2003,Albania,Durres,0,0,0,0,0,0,0,0,0,0,0,0,1,0,0,1
2003,Albania,Babrru (Tirana),2,0,13,0,9,0,0,24,6,0,9,0,19,0,0,34
2003,Armenia,Yerevan,0,0,1,0,11,3,0,15,0,0,3,0,30,2,0,35
2003,Armenia,Vayots Dzor,0,0,0,0,0,0,2196,2196,0,0,0,0,0,0,1870,1870
2003,Armenia,Tavush,0,0,0,0,0,0,5507,5507,0,0,0,0,0,0,4691,4691
2003,Armenia,Syunik,0,0,0,0,0,0,7703,7703,0,0,0,0,0,0,6562,6562
2003,Armenia,Shirak,0,0,0,0,0,0,2085,2085,0,0,0,0,0,0,1776,1776
2003,Armenia,Lori,0,0,0,0,0,0,9103,9103,0,0,0,0,0,0,7755,7755
2003,Armenia,Kotayk,0,0,0,0,0,0,16637,16637,0,0,0,0,0,0,14172,14172
2003,Armenia,Gegharkunik,0,0,0,0,0,0,14494,14494,0,0,0,0,0,0,12346,12346
2003,Armenia,Armavir,0,0,0,0,0,0,13144,13144,0,0,0,0,0,0,11196,11196
2003,Armenia,Ararat,0,0,0,0,0,0,25807,25807,0,0,0,0,0,0,21983,21983
2003,Armenia,Aragatsotn,0,0,0,0,0,0,3925,3925,0,0,0,0,0,0,3344,3344
2003,Azerbaijan,Yevlah,0,0,0,0,0,0,6445,6445,0,0,0,0,0,0,5173,5173
2003,Azerbaijan,Tartar,0,0,0,0,0,0,7860,7860,0,0,0,0,0,0,7277,7277
2003,Azerbaijan,Sumgait,0,0,0,0,0,0,22527,22527,0,0,0,0,0,0,21102,21102
2003,Azerbaijan,Sabirabad,0,0,0,0,0,0,9593,9593,0,0,0,0,0,0,8281,8281
2003,Azerbaijan,Saatli,0,0,0,0,0,0,7464,7464,0,0,0,0,0,0,6162,6162
2003,Azerbaijan,Mingachevir,0,0,0,0,0,0,9899,9899,0,0,0,0,0,0,8559,8559
2003,Azerbaijan,Lachin,0,0,0,0,0,0,7149,7149,0,0,0,0,0,0,6869,6869
2003,Azerbaijan,Imishli,0,0,0,0,0,0,8652,8652,0,0,0,0,0,0,6807,6807
2003,Azerbaijan,Ganja,0,0,0,0,0,0,8818,8818,0,0,0,0,0,0,6510,6510
2003,Azerbaijan,Fizuli,0,0,0,0,0,0,26755,26755,0,0,0,0,0,0,23571,23571
2003,Azerbaijan,Bilasuvar,0,0,0,0,0,0,9919,9919,0,0,0,0,0,0,9243,9243
2003,Azerbaijan,Beylagan,0,0,0,0,0,0,8798,8798,0,0,0,0,0,0,7483,7483
2003,Azerbaijan,Barda,0,0,0,0,0,0,25325,25325,0,0,0,0,0,0,22674,22674
2003,Azerbaijan,Baku,408,0,1053,0,2251,135,81451,85298,415,0,1601,0,3206,62,73047,78331
2003,Azerbaijan,Ali-Bayramli,0,0,0,0,0,0,2378,2378,0,0,0,0,0,0,2344,2344
2003,Azerbaijan,Agdam,0,0,0,0,0,0,12430,12430,0,0,0,0,0,0,10535,10535
2003,Azerbaijan,Agcabedi,0,0,0,0,0,0,9520,9520,0,0,0,0,0,0,8736,8736
2003,Burundi,Gasorwe,685,0,457,0,959,102,0,2203,331,0,309,0,251,59,0,950
2003,Burundi,Cishemeye,1105,0,2892,0,1877,163,0,6037,736,0,1927,0,1251,109,0,4023
2003,Burundi,Cibitoke,39,0,81,0,97,2,0,219,41,0,49,0,86,2,0,178
2003,Burundi,Bujumbura,4693,0,6874,0,8691,608,0,20866,4522,0,5216,0,6716,569,4,17027
2003,Benin,Kpomasse,91,0,138,0,252,7,0,488,110,0,176,0,361,0,0,647
2003,Benin,Cotonou,5,0,18,0,98,0,0,121,14,0,31,0,470,0,0,515
2003,Bangladesh,Nayapara (Cox Bazaar),1147,0,2330,0,2322,133,0,5932,1296,0,2072,0,2187,119,0,5674
2003,Bangladesh,Kutapalong (Cox Bazaar),821,0,1531,0,1581,92,0,4025,824,0,1551,0,1550,91,0,4016
2003,Bangladesh,Dhaka,3,0,22,0,39,0,0,64,1,0,13,0,75,0,0,89
2003,Bahrain,Manama,0,0,0,0,0,0,0,0,0,0,0,0,1,0,0,1
2003,Belarus,Vitebsk Region,0,0,6,0,13,0,0,19,3,0,10,0,29,0,0,42
2003,Belarus,Mogilev Region,0,0,4,0,5,0,0,9,0,0,0,0,19,0,0,19
2003,Belarus,Minsk Region,4,0,29,0,37,4,0,74,5,0,20,0,46,3,0,74
2003,Belarus,Minsk,14,0,77,0,114,11,0,216,8,0,86,0,261,7,0,362
2003,Belarus,Grodno Region,1,0,0,0,2,0,0,3,0,0,0,0,3,0,0,3
2003,Belarus,Gomel Region,1,0,12,0,24,6,0,43,3,0,9,0,40,3,0,55
2003,Belarus,Brest Region,0,0,0,0,1,0,0,1,0,0,2,0,6,0,0,8
2003,Belize,Belize City,68,0,219,0,112,22,0,421,65,0,230,0,125,28,0,448
2003,Bolivia (Plurinational State of),"La Paz, Santa Cruz, Cochabamba, Beni",6,0,33,0,109,4,0,152,7,0,40,0,148,7,0,202
2003,Botswana,Gaborone,1,0,5,0,20,0,0,26,0,0,11,0,50,0,0,61
2003,Botswana,Dukwi,366,0,472,0,599,39,0,1476,325,0,551,0,1424,54,0,2354
2003,Central African Rep.,Molangue,376,0,492,0,518,22,0,1408,389,0,593,0,539,18,0,1539
2003,Central African Rep.,Mboki,3430,0,5256,0,7137,0,0,15823,3656,0,6988,0,9383,0,0,20027
2003,Central African Rep.,Kbando,16,0,35,0,29,0,0,80,23,0,34,0,34,0,0,91
2003,Central African Rep.,Boubou,38,0,132,0,149,0,0,319,54,0,178,0,166,0,0,398
2003,Central African Rep.,Bangui,421,0,731,0,1006,6,0,2164,427,0,865,0,1605,7,0,2904
2003,Chile,Santiago,5,0,26,0,115,6,0,152,10,0,58,0,292,3,0,363
2003,China,Yunnan,1442,0,6127,0,12492,1732,0,21793,2640,0,6312,0,12353,1380,0,22685
2003,China,Wenchang,0,0,0,0,0,0,0,0,0,0,0,0,2,0,0,2
2003,China,Shanghai,0,0,0,0,1,0,0,1,1,0,0,0,1,0,0,2
2003,China,Nanjing,2,0,0,0,1,0,0,3,0,0,0,0,4,0,0,4
2003,China,Jiangxi,48,0,58,0,498,162,0,766,58,0,80,0,524,137,0,799
2003,China,Hangzhou,0,0,0,0,0,0,0,0,0,0,0,0,1,0,0,1
2003,China,Hainan,815,0,3092,0,7773,2096,0,13776,1150,0,4018,0,9801,1990,0,16959
2003,China,Guangzhou,0,0,0,0,0,0,0,0,0,0,0,0,1,0,0,1
2003,China,Guangxi,2652,0,11361,0,31857,6940,0,52810,3432,0,12816,0,35095,6955,0,58298
2003,China,Guangdong,2185,0,7342,0,23614,6845,0,39986,2702,0,8939,0,25643,6431,0,43715
2003,China,Fujian,919,0,3637,0,8105,679,0,13340,1215,0,3907,0,8528,707,0,14357
2003,China,Beijing,3,0,3,0,10,0,0,16,7,0,7,0,68,0,0,82
2003,China,BEIHAI,0,0,0,0,0,0,0,0,0,0,0,0,1,0,0,1
2003,Côte d'Ivoire,Toulepleu,614,0,1425,0,2512,412,0,4963,618,0,1597,0,1633,339,0,4187
2003,Côte d'Ivoire,Tabou TC,365,0,645,0,809,42,0,1861,367,0,626,0,621,25,0,1639
2003,Côte d'Ivoire,Tabou,4219,0,7445,0,9347,475,0,21486,4241,0,7247,0,7165,298,0,18951
2003,Côte d'Ivoire,San Pedro,97,0,174,0,218,11,0,500,99,0,169,0,166,7,0,441
2003,Côte d'Ivoire,Nicla,373,0,888,0,1522,164,0,2947,352,0,874,0,1002,120,0,2348
2003,Côte d'Ivoire,Danane,33,0,125,0,149,11,0,318,30,0,111,0,133,9,0,283
2003,Côte d'Ivoire,Blolequin,136,0,316,0,557,91,0,1100,137,0,354,0,362,75,0,928
2003,Côte d'Ivoire,Bin Houye,477,0,1106,0,1950,320,0,3853,479,0,1239,0,1268,263,0,3249
2003,Côte d'Ivoire,Abidjan,318,0,1018,0,2068,78,0,3482,341,0,904,0,2130,60,0,3435
2003,Cameroon,Banyo,965,0,4030,0,3734,160,0,8889,1067,0,3807,0,2915,305,0,8094
2003,Dem. Rep. of the Congo,Zomfi,138,0,232,0,258,13,0,641,117,0,273,0,212,19,0,621
2003,Dem. Rep. of the Congo,Tshimbumbulu,446,0,849,0,1108,174,0,2577,443,0,789,0,988,129,0,2349
2003,Dem. Rep. of the Congo,Tshilonda (Kasai),29,0,26,0,52,1,0,108,28,0,34,0,85,1,0,148
2003,Dem. Rep. of the Congo,Tshifwameso,127,0,233,0,266,15,0,641,124,0,237,0,122,9,0,492
2003,Dem. Rep. of the Congo,Tshabobo,60,0,56,0,112,2,0,230,56,0,47,0,138,4,0,245
2003,Dem. Rep. of the Congo,Sadi-Zulu,363,0,678,0,713,41,0,1795,312,0,710,0,639,26,0,1687
2003,Dem. Rep. of the Congo,Nkondo,477,0,832,0,523,62,0,1894,463,0,811,0,933,97,0,2304
2003,Dem. Rep. of the Congo,Napassa,133,0,324,0,332,26,0,815,164,0,365,0,130,18,0,677
2003,Dem. Rep. of the Congo,Mole-Zongo,7,0,31,0,28,1,0,67,6,0,18,0,30,0,0,54
2003,Dem. Rep. of the Congo,Mbujimayi,1,0,3,0,5,0,0,9,1,0,6,0,13,0,0,20
2003,Dem. Rep. of the Congo,Lusuku,29,0,38,0,89,6,0,162,36,0,32,0,76,1,0,145
2003,Dem. Rep. of the Congo,Lubumbashi,37,0,66,0,101,10,0,214,41,0,67,0,98,3,0,209
2003,Dem. Rep. of the Congo,Kulindji,283,0,901,0,624,78,0,1886,278,0,839,0,164,34,0,1315
2003,Dem. Rep. of the Congo,Kisenge,472,0,915,0,1234,170,0,2791,465,0,887,0,1093,145,0,2590
2003,Dem. Rep. of the Congo,Kinshasa,160,0,469,0,871,60,0,1560,180,0,421,0,1069,137,0,1807
2003,Dem. Rep. of the Congo,Kinsalulu,221,0,504,0,495,38,0,1258,225,0,614,0,336,11,0,1186
2003,Dem. Rep. of the Congo,Kinsafu,155,0,584,0,402,31,0,1172,149,0,673,0,298,11,0,1131
2003,Dem. Rep. of the Congo,Kimpindi,89,0,218,0,197,25,0,529,90,0,252,0,117,9,0,468
2003,Dem. Rep. of the Congo,Kimfwakata,201,0,532,0,420,18,0,1171,207,0,505,0,283,12,0,1007
2003,Dem. Rep. of the Congo,Kimaza,98,0,151,0,183,3,0,435,110,0,166,0,324,10,0,610
2003,Dem. Rep. of the Congo,Kilueka,451,0,751,0,653,90,0,1945,427,0,896,0,540,106,0,1969
2003,Dem. Rep. of the Congo,Katsha,64,0,52,0,124,3,0,243,53,0,45,0,160,6,0,264
2003,Dem. Rep. of the Congo,Kahemba,1,0,1,0,1,0,0,3,1,0,1,0,1,0,0,3
2003,Dem. Rep. of the Congo,Goma (Bukavu),14,0,58,0,82,3,0,157,26,0,64,0,91,6,0,187
2003,Dem. Rep. of the Congo,Dungu (Kpezu),22,0,32,0,60,0,0,114,29,0,27,0,64,2,0,122
2003,Dem. Rep. of the Congo,Dungu (Kaka2),79,0,187,0,353,12,0,631,76,0,177,0,329,8,0,590
2003,Dem. Rep. of the Congo,Dungu (Kaka1),19,0,48,0,66,3,0,136,28,0,49,0,106,4,0,187
2003,Dem. Rep. of the Congo,Dungu (Centre),22,0,29,0,81,1,0,133,23,0,38,0,71,4,0,136
2003,Dem. Rep. of the Congo,Doruma (Mandofi),110,0,224,0,394,27,0,755,80,0,255,0,326,37,0,698
2003,Dem. Rep. of the Congo,Doruma (Centre),28,0,88,0,115,16,0,247,17,0,78,0,80,14,0,189
2003,Dem. Rep. of the Congo,Divuma,292,0,783,0,1053,139,0,2267,304,0,749,0,896,109,0,2058
2003,Dem. Rep. of the Congo,Boga,177,0,465,0,410,77,0,1129,146,0,342,0,355,44,0,887
2003,Dem. Rep. of the Congo,Biringi (Biringi),33,0,30,0,67,5,0,135,39,0,48,0,77,3,0,167
2003,Dem. Rep. of the Congo,Biringi (Ayamba),40,0,64,0,83,6,0,193,24,0,63,0,98,1,0,186
2003,Dem. Rep. of the Congo,Bas-Fleuve,79,0,339,0,327,53,0,798,81,0,325,0,321,24,0,751
2003,Dem. Rep. of the Congo,Aba (Rudu2),393,0,569,0,997,69,0,2028,386,0,729,0,911,106,0,2132
2003,Dem. Rep. of the Congo,Aba (Rudu1),205,0,277,0,477,71,0,1030,178,0,337,0,437,52,0,1004
2003,Congo,Pointe-Noire,34,0,84,0,160,7,0,285,39,0,96,0,224,23,0,382
2003,Congo,Ndjoundou/Liranga,417,0,754,0,732,46,0,1949,432,0,774,0,596,45,0,1847
2003,Congo,Loukolela,821,0,565,0,941,39,0,2366,644,0,534,0,1284,28,0,2490
2003,Congo,Kondi Mbaka,47,0,95,0,189,12,0,343,58,0,141,0,232,18,0,449
2003,Congo,Komi,23,0,48,0,95,7,0,173,29,0,70,0,118,9,0,226
2003,Congo,Kintele,32,0,165,0,359,2,0,558,82,0,287,0,486,58,0,913
2003,Congo,Kimongo/Malolo II,54,0,211,0,89,7,0,361,45,0,189,0,103,2,0,339
2003,Congo,Impfondo,5693,0,10315,0,9177,730,0,25915,5630,0,10482,0,7898,562,0,24572
2003,Congo,Brazzaville,219,0,888,0,1282,5,0,2394,287,0,917,0,1856,93,0,3153
2003,Congo,Betou,1898,0,4285,0,4746,243,0,11172,1890,0,4315,0,4712,306,252,11475
2003,Colombia,San Andrés,0,0,2,0,10,1,0,13,0,0,1,0,12,1,0,14
2003,Colombia,Leticia,0,0,0,0,0,1,0,1,0,0,0,0,0,0,0,0
2003,Colombia,Duitama,0,0,1,0,1,1,0,3,0,0,1,0,1,0,0,2
2003,Colombia,Cali,0,0,0,0,1,0,0,1,0,0,1,0,1,0,0,2
2003,Colombia,Buenaventura,0,0,3,0,1,0,0,4,2,0,2,0,2,0,0,6
2003,Colombia,Bogotá,2,0,6,0,31,17,0,56,2,0,10,0,63,17,0,92
2003,Colombia,Armenia,1,0,0,0,1,0,0,2,0,0,2,0,1,0,0,3
2003,Costa Rica,Costa Rica,186,0,1077,0,4724,132,0,6119,172,0,1131,0,5941,145,0,7389
2003,Cuba,Havana,0,0,7,0,16,0,0,23,2,0,10,0,24,0,0,36
2003,Cuba,Guantanamo,0,0,0,0,0,0,0,0,0,0,0,0,1,0,0,1
2003,Czech Rep.,Kasava,43,0,94,0,82,3,0,222,39,0,83,0,61,9,0,192
2003,Algeria,Alger,0,0,0,0,7,0,0,7,1,0,0,0,20,0,0,21
2003,Egypt,Cairo,906,0,1943,0,4218,210,0,7277,1061,0,2189,0,8073,149,0,11472
2003,Eritrea,Emkulu,249,0,521,0,649,22,0,1441,296,0,568,0,929,27,0,1820
2003,Eritrea,Elit,40,0,68,0,82,4,0,194,47,0,92,0,282,7,0,428
2003,Eritrea,Asmara,17,0,26,0,42,0,0,85,11,0,16,0,66,0,0,93
2003,Eritrea,Afabet,0,0,0,0,0,0,0,0,0,0,0,0,29,0,0,29
2003,Estonia,Tallin,0,0,0,0,1,0,0,1,0,0,0,0,9,0,0,9
2003,Estonia,Jõhvi,0,0,0,0,0,0,0,0,0,0,0,0,4,0,0,4
2003,Estonia,Illuka,0,0,0,0,0,0,0,0,0,0,0,0,1,0,0,1
2003,Ethiopia,Yarenja (Bamboudi),331,0,791,0,1021,33,0,2176,329,0,822,0,931,58,0,2140
2003,Ethiopia,Sherkole (Assosa),2347,0,2585,0,3619,47,0,8598,2353,0,3372,0,3890,77,0,9692
2003,Ethiopia,Mogadishu,0,0,0,0,0,0,0,0,0,0,0,0,3,0,0,3
2003,Ethiopia,Kebribeyah (Jijiga),208,0,2819,0,2681,177,0,5885,202,0,2933,0,2378,231,0,5744
2003,Ethiopia,Kampala,49,0,94,0,199,6,0,348,50,0,117,0,309,9,0,485
2003,Ethiopia,Hartisheik (Jijiga),77,0,561,0,546,48,0,1232,86,0,640,0,485,58,0,1269
2003,Ethiopia,Fugnido (Gambella),3918,0,4864,0,6209,202,0,15193,4221,0,6575,0,5410,130,0,16336
2003,Ethiopia,Dimma (Gambella),2164,0,1778,0,2943,111,0,6996,2166,0,3318,0,6116,96,0,11696
2003,Ethiopia,Bonga (Gambella),2622,0,3328,0,3312,96,0,9358,2722,0,3554,0,2332,79,0,8687
2003,Ethiopia,Aisha (Jijiga),611,0,2906,0,3172,329,0,7018,617,0,3280,0,2687,366,0,6950
2003,Ethiopia,Addis Ababa,38,0,80,0,130,6,0,254,26,0,69,0,139,6,0,240
2003,Ethiopia, Shimelba (Shire/Shiraro) ,433,0,671,0,906,280,0,2290,479,0,796,0,2843,346,0,4464
2003,Gabon,Voungou-Pont,7,0,10,0,18,3,0,38,5,0,11,0,18,2,0,36
2003,Gabon,Tchibanga,149,0,409,0,565,14,0,1137,156,0,380,0,696,10,0,1242
2003,Gabon,Rinanzala,29,0,31,0,58,6,0,124,20,0,57,0,51,2,0,130
2003,Gabon,Rébé,3,0,2,0,3,0,0,8,0,0,2,0,0,0,0,2
2003,Gabon,Port-Gentil,7,0,20,0,33,2,0,62,3,0,22,0,142,9,0,176
2003,Gabon,Pana/Dienga,0,0,1,0,3,1,0,5,2,0,3,0,7,1,0,13
2003,Gabon,Okondja,0,0,3,0,2,0,0,5,1,0,0,0,8,1,0,10
2003,Gabon,Nzinga,5,0,20,0,25,4,0,54,8,0,22,0,10,1,0,41
2003,Gabon,Ngouoni,5,0,7,0,13,0,0,25,5,0,7,0,46,1,0,59
2003,Gabon,Ndendé,37,0,107,0,185,11,0,340,49,0,90,0,178,3,0,320
2003,Gabon,Mounana,22,0,37,0,59,3,0,121,16,0,24,0,88,4,0,132
2003,Gabon,Moulengui,25,0,77,0,93,14,0,209,38,0,88,0,64,10,0,200
2003,Gabon,Mouila,41,0,76,0,153,5,0,275,32,0,71,0,201,0,0,304
2003,Gabon,Moanda,188,0,579,0,758,36,0,1561,197,0,493,0,899,27,0,1616
2003,Gabon,Mitzic,0,0,0,0,0,0,0,0,0,0,0,0,2,0,0,2
2003,Gabon,Mékambo,0,0,0,0,0,0,0,0,0,0,0,0,1,0,0,1
2003,Gabon,Mayumba,8,0,14,0,41,2,0,65,7,0,17,0,67,0,0,91
2003,Gabon,Makokou,1,0,4,0,1,0,0,6,0,0,0,0,3,0,0,3
2003,Gabon,Mabanda,10,0,22,0,32,1,0,65,8,0,25,0,36,3,0,72
2003,Gabon,Libreville,195,0,694,0,1138,33,0,2060,196,0,634,0,2096,81,0,3007
2003,Gabon,Lékindou,5,0,19,0,23,1,0,48,8,0,17,0,66,0,0,91
2003,Gabon,Léconi,0,0,0,0,0,0,0,0,0,0,0,0,3,0,0,3
2003,Gabon,Lébamba,6,0,13,0,19,0,0,38,12,0,15,0,26,2,0,55
2003,Gabon,Lastourville,17,0,21,0,43,1,0,82,6,0,29,0,40,1,0,76
2003,Gabon,Lambaréné,0,0,5,0,10,0,0,15,4,0,6,0,23,1,0,34
2003,Gabon,Koumou-Doussala,1,0,4,0,6,1,0,12,3,0,4,0,10,0,0,17
2003,Gabon,Koula-Moutou,12,0,40,0,41,1,0,94,20,0,38,0,140,5,0,203
2003,Gabon,Gamba,7,0,18,0,73,0,0,98,10,0,14,0,110,1,0,135
2003,Gabon,Franceville,206,0,499,0,802,22,0,1529,219,0,421,0,1430,30,0,2100
2003,Gabon,Doussala,2,0,3,0,5,0,0,10,4,0,2,0,6,1,0,13
2003,Gabon,Dilemba,26,0,71,0,83,11,0,191,23,0,60,0,88,10,0,181
2003,Gabon,Boumango,23,0,44,0,49,9,0,125,8,0,40,0,41,8,0,97
2003,Gabon,Boué,0,0,0,0,0,0,0,0,0,0,0,0,1,0,0,1
2003,Gabon,Bongoville,0,0,0,0,0,0,0,0,0,0,0,0,1,0,0,1
2003,Gabon,Banda Mamba,4,0,8,0,18,2,0,32,5,0,12,0,20,2,0,39
2003,Gabon,Bakoumba,24,0,37,0,43,4,0,108,18,0,28,0,29,2,0,77
2003,Gabon,Akiéni,0,0,0,0,0,0,0,0,0,0,0,0,1,0,0,1
2003,Georgia,Tbilisi,2365,0,10192,0,31903,8590,0,53050,2621,0,10216,0,24087,5163,0,42087
2003,Georgia,South Ossetia,0,0,0,0,0,0,252,252,0,0,0,0,0,0,242,242
2003,Georgia,Samegrelo,1846,0,11037,0,27758,10678,0,51319,1999,0,10870,0,22197,6736,0,41802
2003,Georgia,Rustavi,101,0,523,0,1357,324,0,2305,115,0,467,0,1002,203,0,1787
2003,Georgia,Poti,151,0,742,0,2477,715,0,4085,192,0,856,0,2021,475,0,3544
2003,Georgia,Kvemo Kartli,129,0,1048,0,2123,467,0,3767,146,0,964,0,1619,298,0,3027
2003,Georgia,Kutaisi,355,0,1566,0,4651,1410,0,7982,369,0,1488,0,3504,836,0,6197
2003,Georgia,Khashuri,0,0,1,0,1,0,0,2,0,0,1,0,1,0,0,2
2003,Georgia,Khalatsani,14,0,26,0,34,1,0,75,17,0,28,0,27,2,0,74
2003,Georgia,Kartli,273,0,1234,0,3172,800,0,5479,372,0,1288,0,2486,555,0,4701
2003,Georgia,Jokolo,84,0,205,0,252,6,0,547,123,0,219,0,152,10,0,504
2003,Georgia,Imereti,370,0,1756,0,4849,1691,0,8666,356,0,1842,0,3819,1054,0,7071
2003,Georgia,Duisi,194,0,462,0,572,38,0,1266,222,0,498,0,489,32,0,1241
2003,Georgia,Batumi,46,0,207,0,891,276,0,1420,46,0,250,0,646,140,0,1082
2003,Georgia,Akhmeta,8,0,12,0,13,2,0,35,3,0,10,0,11,1,0,25
2003,Ghana,Krisan,117,0,296,0,487,18,0,918,108,0,283,0,705,9,0,1105
2003,Ghana,Buduburam,2045,0,7500,0,11331,529,0,21405,1990,0,6619,0,11583,256,0,20448
2003,Ghana,BOLE,8,0,11,0,29,2,0,50,11,0,25,0,20,0,0,56
2003,Ghana,Accra,154,0,489,0,908,20,0,1571,189,0,533,0,1739,20,0,2481
2003,Guinea,Yomou,530,0,1342,0,1173,118,0,3163,592,0,1131,0,1413,231,0,3367
2003,Guinea,Telikoro,788,0,1782,0,2320,336,0,5226,801,0,1779,0,1365,144,0,4089
2003,Guinea,Nzerekore ville,385,0,3318,0,3224,318,0,7245,1550,0,4044,0,2397,610,0,8601
2003,Guinea,Nzerekore Peripherie,267,0,634,0,620,26,0,1547,421,0,1298,0,1187,85,0,2991
2003,Guinea,Nonah,958,0,1434,0,1268,25,0,3685,860,0,1541,0,953,34,0,3388
2003,Guinea,Lola,494,0,847,0,1247,104,0,2692,990,0,1671,0,1801,239,0,4701
2003,Guinea,Laine,4149,0,5835,0,6366,698,0,17048,3870,0,5675,0,4988,537,0,15070
2003,Guinea,Kountaya,1319,0,3010,0,3802,499,0,8630,1398,0,3075,0,3010,346,0,7829
2003,Guinea,Kouankan,3346,0,5735,0,7592,2798,0,19471,3248,0,5235,0,2515,1853,0,12851
2003,Guinea,Kola,658,0,1369,0,1323,65,0,3415,647,0,1488,0,897,50,0,3082
2003,Guinea,Conakry,0,0,0,0,0,0,2731,2731,0,0,0,0,0,0,2623,2623
2003,Guinea,Boreah,618,0,1378,0,1732,238,0,3966,656,0,1471,0,1416,172,0,3715
2003,Guinea,Beyla,879,0,2931,0,1574,294,0,5678,1867,0,4297,0,2213,553,0,8930
2003,Gambia,Sibanor,32,0,23,0,200,28,0,283,25,0,27,0,144,38,0,234
2003,Gambia,Kalagi,0,0,1,0,5,1,0,7,0,0,0,0,6,1,0,7
2003,Gambia,Basse,60,0,157,0,257,12,0,486,71,0,166,0,324,4,0,565
2003,Gambia,Banjul,177,0,234,0,670,514,0,1595,1971,0,1812,0,324,62,0,4169
2003,Gambia,Bambali,8,0,22,0,26,1,0,57,6,0,19,0,38,0,0,63
2003,Guinea-Bissau,San Domingo,200,0,436,0,872,137,0,1645,184,0,488,0,585,161,0,1418
2003,Guinea-Bissau,Jolmete,35,0,94,0,93,11,0,233,31,0,143,0,100,10,0,284
2003,Guinea-Bissau,Ingore,255,0,742,0,912,81,0,1990,296,0,729,0,622,100,0,1747
2003,Guinea-Bissau,Bissau,17,0,24,0,54,0,0,95,19,0,32,0,167,0,0,218
2003,Guatemala,Guatemala City,0,0,1,0,326,35,0,362,1,0,4,0,315,35,0,355
2003,"China, Hong Kong SAR",Hong Kong,9,0,4,0,45,0,0,58,9,0,7,0,211,3,0,230
2003,Honduras,Trujillo,0,0,0,0,0,0,0,0,0,0,0,0,6,0,0,6
2003,Honduras,Tegucigalpa and San Pedro,0,0,0,0,0,0,0,0,0,0,0,0,6,1,0,7
2003,Honduras,Sula,0,0,1,0,3,0,0,4,0,0,0,0,4,0,0,4
2003,Honduras,La Ceiba,0,0,0,0,0,0,0,0,0,0,0,0,2,0,0,2
2003,Croatia,Sasna Greda,0,0,2,0,5,0,0,7,1,0,1,0,13,0,0,15
2003,Croatia,Jezevo,0,0,0,0,3,0,0,3,0,0,0,0,29,0,0,29
2003,Indonesia,Tanjung Pinang,0,0,0,0,0,0,0,0,0,0,0,0,2,0,0,2
2003,Indonesia,Mataram,0,0,0,0,3,0,0,3,0,0,3,0,2,0,0,5
2003,Indonesia,Jakarta,10,0,35,0,58,5,0,108,15,0,46,0,119,3,0,183
2003,India,New Delhi,196,0,1836,0,3599,328,0,5959,214,0,1941,0,3043,336,0,5534
2003,Iran (Islamic Rep. of),Zanjan,6,0,36,0,42,4,0,88,6,0,38,0,64,4,0,112
2003,Iran (Islamic Rep. of),Sistan-Baluchistan,212,0,848,0,901,53,0,2014,265,0,954,0,1961,106,0,3286
2003,Iran (Islamic Rep. of),Semnan,116,0,464,0,493,29,0,1102,145,0,522,0,1073,58,0,1798
2003,Iran (Islamic Rep. of),Markazi,140,0,560,0,595,35,0,1330,175,0,630,0,1295,70,0,2170
2003,Iran (Islamic Rep. of),Kermanshah,56,0,339,0,395,38,0,828,56,0,358,0,602,38,0,1054
2003,Iran (Islamic Rep. of),Kerman,509,0,2037,0,2164,127,0,4837,637,0,2292,0,4710,255,0,7894
2003,Iran (Islamic Rep. of),Fars,174,0,1044,0,1218,116,0,2552,174,0,1102,0,1856,116,0,3248
2003,Iran (Islamic Rep. of),Bushehr,86,0,345,0,367,22,0,820,108,0,388,0,798,43,0,1337
2003,Iraq,Wassit,29,0,106,0,127,15,0,277,26,0,99,0,117,10,0,252
2003,Iraq,Tameem,0,0,1,0,2,0,0,3,1,0,1,0,3,0,0,5
2003,Iraq,Sulaymaniyah,17,0,220,0,417,31,0,685,24,0,262,0,404,41,0,731
2003,Iraq,Salah al-Din,1,0,8,0,14,1,0,24,1,0,11,0,12,0,0,24
2003,Iraq,Qadissiya,5,0,4,0,16,0,0,25,1,0,5,0,10,2,0,18
2003,Iraq,Ninewa,362,0,1961,0,2207,224,0,4754,426,0,2055,0,1915,197,0,4593
2003,Iraq,Missan,2,0,12,0,5,1,0,20,0,0,1,0,6,0,0,7
2003,Iraq,Kerbala,0,0,4,0,8,0,0,12,0,0,1,0,2,3,0,6
2003,Iraq,Erbil,23,0,211,0,307,18,0,559,18,0,168,0,420,22,0,628
2003,Iraq,Diyala,6,0,31,0,47,4,0,88,11,0,23,0,34,5,0,73
2003,Iraq,Dahuk,111,0,779,0,831,58,0,1779,127,0,846,0,790,56,0,1819
2003,Iraq,Basrah,0,0,2,0,4,0,0,6,0,0,1,0,7,0,0,8
2003,Iraq,Baghdad,899,0,3287,0,6245,810,0,11241,938,0,3442,0,6403,816,0,11599
2003,Iraq,Babylon,1,0,6,0,18,1,0,26,2,0,7,0,19,4,0,32
2003,Iraq,Anbar,284,0,1509,0,1638,157,0,3588,297,0,1647,0,1669,226,0,3839
2003,Jordan,Amman,170,0,930,0,1744,87,0,2931,186,0,1033,0,3675,111,0,5005
2003,Kazakhstan,Almaty,0,0,2,0,6,0,0,8,6,0,3,0,22,0,0,31
2003,Kenya,Nairobi,716,0,2534,0,3715,179,0,7144,676,0,2803,0,5703,119,0,9301
2003,Kenya,Kakuma,5782,0,13153,0,16669,639,0,36243,6692,0,18826,0,27132,485,0,53135
2003,Kenya,Ifo/Dadaab,3531,0,8038,0,12524,580,0,24673,3792,0,9365,0,12475,705,0,26337
2003,Kenya,Hagadera (Dadaab),3501,0,8511,0,12140,625,0,24777,3686,0,9335,0,11915,756,0,25692
2003,Kenya,Dagahaley (Dadaab),2660,0,5462,0,7861,356,0,16339,2744,0,6238,0,7414,502,0,16898
2003,Kyrgyzstan,Osh,0,0,0,0,0,0,180,180,0,0,0,0,0,0,214,214
2003,Kyrgyzstan,Issyk-Kul,0,0,0,0,0,0,5,5,0,0,0,0,0,0,7,7
2003,Kyrgyzstan,Djalal-Abad region,0,0,0,0,0,0,22,22,0,0,0,0,0,0,27,27
2003,Kyrgyzstan,Chui region,0,0,0,0,0,0,1793,1793,0,0,0,0,0,0,2141,2141
2003,Kyrgyzstan,Bishkek City,0,0,0,0,0,0,699,699,0,0,0,0,0,0,892,892
2003,Kyrgyzstan,Batken,0,0,0,0,0,0,112,112,0,0,0,0,0,0,134,134
2003,Cambodia,Phnom Penh,4,0,7,0,25,0,0,36,8,0,9,0,66,3,0,86
2003,Rep. of Korea,Seoul,2,0,5,0,27,0,0,34,2,0,1,0,127,0,0,130
2003,Kuwait,Kuwait City,2842,0,19306,0,26900,1774,0,50822,3295,0,19941,0,27151,1499,0,51886
2003,Liberia,VOA,915,0,1576,0,2173,241,0,4905,954,0,1615,0,1540,171,0,4280
2003,Liberia,Samukai,270,0,622,0,782,87,0,1761,265,0,655,0,615,68,0,1603
2003,Liberia,Montserrado County,1,0,5,0,6,0,0,12,0,0,9,0,35,0,0,44
2003,Liberia,Banjor,138,0,248,0,295,33,0,714,111,0,269,0,268,30,0,678
2003,Libya,Tripoli,568,0,1476,0,2578,176,0,4798,703,0,2046,0,4286,122,0,7157
2003,Sri Lanka,Vavuniya,1514,0,5987,0,13370,1537,0,22408,1563,0,6247,0,12524,1589,0,21923
2003,Sri Lanka,Trincomalee,693,0,2756,0,6226,727,0,10402,715,0,2878,0,5828,750,0,10171
2003,Sri Lanka,Ratnapura,4,0,19,0,45,5,0,73,5,0,21,0,44,6,0,76
2003,Sri Lanka,Puttalam,1860,0,6884,0,13676,1314,0,23734,1903,0,7106,0,12931,1373,0,23313
2003,Sri Lanka,Polonnaruwa,106,0,424,0,962,113,0,1605,110,0,444,0,902,118,0,1574
2003,Sri Lanka,Mullaitivu,2015,0,8074,0,18406,2176,0,30671,2085,0,8439,0,17217,2245,0,29986
2003,Sri Lanka,Matara,39,0,162,0,383,47,0,631,42,0,171,0,358,49,0,620
2003,Sri Lanka,Matale,87,0,360,0,850,104,0,1401,92,0,379,0,793,108,0,1372
2003,Sri Lanka,Mannar,1106,0,4419,0,10029,1178,0,16732,1143,0,4617,0,9385,1216,0,16361
2003,Sri Lanka,Kurunegala,111,0,433,0,959,109,0,1612,113,0,452,0,902,115,0,1582
2003,Sri Lanka,Kilinochchi,1485,0,5863,0,13069,1501,0,21918,1531,0,6114,0,12244,1550,0,21439
2003,Sri Lanka,Kegalle,1,0,5,0,13,1,0,20,2,0,6,0,14,2,0,24
2003,Sri Lanka,Kandy,3,0,16,0,38,4,0,61,5,0,18,0,37,5,0,65
2003,Sri Lanka,Kalutara,27,0,112,0,264,32,0,435,29,0,118,0,247,34,0,428
2003,Sri Lanka,Jaffna,2075,0,8285,0,18781,2203,0,31344,2145,0,8655,0,17575,2275,0,30650
2003,Sri Lanka,Hambantota,3,0,14,0,33,4,0,54,4,0,15,0,30,5,0,54
2003,Sri Lanka,Gampaha,76,0,310,0,733,90,0,1209,79,0,326,0,682,93,0,1180
2003,Sri Lanka,Galle,18,0,75,0,178,21,0,292,20,0,80,0,166,23,0,289
2003,Sri Lanka,Colombo,117,0,468,0,1059,125,0,1769,122,0,486,0,1002,130,0,1740
2003,Sri Lanka,Batticaloa,875,0,3585,0,8451,1040,0,13951,908,0,3759,0,7886,1072,0,13625
2003,Sri Lanka,Badulla,8,0,33,0,78,9,0,128,9,0,35,0,73,10,0,127
2003,Sri Lanka,Anuradhapura,725,0,2827,0,6154,684,0,10390,747,0,2942,0,5776,709,0,10174
2003,Sri Lanka,Ampara,271,0,1109,0,2613,322,0,4315,281,0,1162,0,2438,331,0,4212
2003,Latvia,Salaspils,0,0,0,0,0,0,0,0,0,0,0,0,1,0,0,1
2003,Latvia,Riga,0,0,0,0,0,0,0,0,0,0,0,0,3,0,0,3
2003,Latvia,Mucenieki,0,0,1,0,1,0,0,2,0,0,2,0,1,0,0,3
2003,Latvia,Jurmala,0,0,1,0,1,0,0,2,0,0,0,0,2,0,0,2
2003,Morocco,Tetouan,0,0,5,0,2,0,0,7,0,0,0,0,2,0,0,2
2003,Morocco,Tanger,0,0,0,0,5,1,0,6,0,0,0,0,14,0,0,14
2003,Morocco,Settat,0,0,0,0,0,0,0,0,0,0,0,0,2,0,0,2
2003,Morocco,Salé,0,0,1,0,1,0,0,2,1,0,1,0,4,2,0,8
2003,Morocco,Safi,0,0,0,0,0,0,0,0,0,0,0,0,1,0,0,1
2003,Morocco,Rabat,1,0,16,0,218,3,0,238,1,0,14,0,333,2,0,350
2003,Morocco,Oujda,0,0,0,0,1,0,0,1,0,0,0,0,1,0,0,1
2003,Morocco,Mohamadia,0,0,2,0,2,0,0,4,0,0,2,0,4,0,0,6
2003,Morocco,Meknes,0,0,0,0,0,0,0,0,0,0,0,0,2,0,0,2
2003,Morocco,Marrakech,0,0,0,0,5,0,0,5,1,0,0,0,19,1,0,21
2003,Morocco,Larache,0,0,0,0,200,241,0,441,0,0,29,0,534,120,0,683
2003,Morocco,Fès,0,0,0,0,0,0,0,0,0,0,0,0,1,0,0,1
2003,Morocco,Casablanca,3,0,2,0,214,3,0,222,2,0,5,0,253,5,0,265
2003,Morocco,Benimellal,0,0,0,0,0,0,0,0,0,0,0,0,2,0,0,2
2003,Morocco,Agadir,0,0,0,0,2,0,0,2,0,0,0,0,12,0,0,12
2003,Rep. of Moldova,Chisinau,8,0,18,0,36,1,0,63,12,0,21,0,146,0,0,179
2003,Mexico,Qintana Roo,0,0,0,0,14,4,0,18,0,0,0,0,12,3,0,15
2003,Mexico,Mexico City,3,0,238,0,949,126,0,1316,7,0,245,0,1271,96,0,1619
2003,Mexico,Chiapas,0,0,0,0,771,213,0,984,0,0,0,0,1258,212,0,1470
2003,Mexico,Campeche,0,0,0,0,152,42,0,194,0,0,0,0,212,12,0,224
2003,The former Yugoslav Republic of Macedonia,Skopje,0,0,0,0,0,0,0,0,0,0,0,0,1,0,0,1
2003,The former Yugoslav Republic of Macedonia,Gazi Baba,1,0,1,0,1,1,0,4,1,0,1,0,1,1,0,4
2003,Mali,Zegoua,5,0,24,0,30,12,0,71,27,0,23,0,105,16,0,171
2003,Mali,Sikasso,2,0,6,0,5,0,0,13,2,0,5,0,23,0,0,30
2003,Mali,Loulouni,8,0,23,0,44,0,0,75,15,0,24,0,35,0,0,74
2003,Mali,Koutiala,0,0,1,0,1,0,0,2,3,0,2,0,0,0,0,5
2003,Mali,Kayes,817,0,1156,0,571,90,0,2634,344,0,1838,0,1206,126,0,3514
2003,Mali,Kadiolo,3,0,1,0,0,0,0,4,0,0,8,0,2,1,0,11
2003,Mali,Faragouaran,11,0,22,0,29,0,0,62,13,0,25,0,32,0,0,70
2003,Mali,Bamako,138,0,496,0,876,37,0,1547,189,0,418,0,1730,101,0,2438
2003,Mauritania,Nouakchott,21,0,32,0,140,9,0,202,14,0,31,0,218,10,0,273
2003,Malawi,Lilongwe,306,0,571,0,491,7,0,1375,295,0,535,0,551,16,0,1397
2003,Malawi,Dzaleka/Luwani,961,0,1697,0,1916,20,0,4594,914,0,1781,0,1953,38,0,4686
2003,Malaysia,Kuala Lumpur,215,0,374,0,1024,26,0,1639,256,0,461,0,5046,22,0,5785
2003,Namibia,Osire,1287,0,2572,0,2259,151,0,6269,1270,0,2955,0,2791,101,0,7117
2003,Niger,Niamey,16,0,24,0,43,0,0,83,13,0,25,0,82,0,0,120
2003,Niger,Goure,10,0,27,0,25,4,0,66,10,0,27,0,32,3,0,72
2003,Nigeria,Oru Camp,208,0,431,0,2347,23,0,3009,174,0,382,0,2526,24,0,3106
2003,Nigeria,Lagos,47,0,113,0,317,10,0,487,41,0,120,0,515,14,0,690
2003,Nicaragua,Managua,0,0,0,0,143,0,0,143,0,0,0,0,137,30,0,167
2003,Nepal,Timai,423,0,1693,0,2484,272,0,4872,418,0,1739,0,2591,325,0,5073
2003,Nepal,Sanischare,886,0,3806,0,4806,465,0,9963,974,0,3891,0,4982,565,0,10412
2003,Nepal,Khudunabari,486,0,2284,0,3327,324,0,6421,501,0,2232,0,3352,431,0,6516
2003,Nepal,Kathmandu,0,0,3,0,9,1,0,13,0,0,3,0,34,0,0,37
2003,Nepal,Goldhap,341,0,1441,0,2390,250,0,4422,372,0,1504,0,2615,297,0,4788
2003,Nepal,Beldangi 2 extension,409,0,1848,0,2963,289,0,5509,468,0,1933,0,2987,358,0,5746
2003,Nepal,Beldangi 1,818,0,2961,0,4499,466,0,8744,838,0,3086,0,4641,579,0,9144
2003,Nepal,Beladangi 2,809,0,3624,0,5800,627,0,10860,872,0,3730,0,5847,731,0,11180
2003,Oman,Muscat,0,0,1,0,1,0,0,2,0,0,1,0,20,1,0,22
2003,Pakistan,Quetta,2,0,12,0,7,0,0,21,5,0,15,0,14,0,0,34
2003,Pakistan,Peshawar,6,0,12,0,11,0,0,29,5,0,12,0,17,0,0,34
2003,Pakistan,Kotkai,1013,0,2659,0,2786,253,0,6711,1013,0,2659,0,2026,253,0,5951
2003,Pakistan,Karachi,3,0,12,0,11,0,0,26,1,0,4,0,35,0,0,40
2003,Pakistan,Islamabad,20,0,17,0,103,38,0,178,17,0,84,0,158,0,2,261
2003,Panama,Veraguas,0,0,0,0,2,0,0,2,0,0,0,0,2,0,0,2
2003,Panama,Puerto Obaldia,6,0,20,0,17,3,0,46,4,0,29,0,32,3,0,68
2003,Panama,Los Santos,0,0,0,0,3,0,0,3,0,0,0,0,3,0,0,3
2003,Panama,Jaque,12,0,43,0,56,5,0,116,19,0,88,0,113,6,0,226
2003,Panama,Herrera,0,0,0,0,2,1,0,3,0,0,2,0,0,0,0,2
2003,Panama,David,0,0,0,0,8,1,0,9,0,0,4,0,1,0,0,5
2003,Panama,Darien Centro,18,0,56,0,58,3,0,135,20,0,60,0,63,5,0,148
2003,Panama,Colon,0,0,0,0,2,1,0,3,0,0,1,0,1,0,0,2
2003,Panama,Cocle,0,0,2,0,7,1,0,10,0,0,0,0,7,1,0,8
2003,Panama,Bocas del Toro,0,0,1,0,1,0,0,2,0,0,2,0,1,0,0,3
2003,Papua New Guinea,Vanimo,22,0,41,0,75,1,0,139,17,0,46,0,95,3,0,161
2003,Papua New Guinea,Pom,0,0,0,0,0,0,2,2,0,0,0,0,0,0,0,0
2003,Papua New Guinea,Manus,0,0,0,0,0,0,1,1,0,0,0,0,0,0,0,0
2003,Papua New Guinea,East Awin,146,0,428,0,573,52,0,1199,155,0,498,0,597,42,0,1292
2003,Papua New Guinea,Daru,0,0,0,0,0,0,3,3,0,0,0,0,0,0,0,0
2003,Papua New Guinea,Border area,0,0,0,0,0,0,2400,2400,0,0,0,0,0,0,2600,2600
2003,Paraguay,Asuncion,0,0,5,0,8,1,0,14,0,0,1,0,17,0,0,18
2003,Qatar,Doha,2,0,10,0,12,2,0,26,2,0,11,0,54,3,0,70
2003,Rwanda,Kigali,453,0,912,0,1032,55,0,2452,464,0,1011,0,1333,54,0,2862
2003,Rwanda,Kibuye,1443,0,3738,0,3269,341,0,8791,1432,0,3386,0,2017,323,0,7158
2003,Rwanda,Gikongoro,71,0,126,0,147,5,0,349,72,0,155,0,158,14,0,399
2003,Rwanda,Gihembe,1894,0,4126,0,3271,383,0,9674,1692,0,4044,0,1914,288,0,7938
2003,Saudi Arabia,Riyadh,1,0,3,0,4,0,0,8,4,0,6,0,15,1,0,26
2003,Saudi Arabia,Rafha,27,0,126,0,117,9,0,279,45,0,117,0,359,13,0,534
2003,Saudi Arabia,Makkah,0,0,0,0,0,0,0,0,0,0,0,0,1,0,0,1
2003,Saudi Arabia,Madina,0,0,0,0,1,0,0,1,0,0,0,0,0,0,0,0
2003,Saudi Arabia,Khobar,0,0,1,0,4,1,0,6,0,0,1,0,5,1,0,7
2003,Saudi Arabia,Jeddah,4,0,10,0,12,1,0,27,2,0,8,0,29,0,0,39
2003,Sudan,Wad Sherife,1519,0,6396,0,7050,536,0,15501,1520,0,6783,0,5295,594,0,14192
2003,Sudan,Wad El Hilea,270,0,739,0,597,87,0,1693,222,0,797,0,1062,78,0,2159
2003,Sudan,Um Sagata,970,0,827,0,541,218,0,2556,1099,0,879,0,300,1381,0,3659
2003,Sudan,Um Gargur,679,0,1380,0,1522,219,0,3800,558,0,1399,0,1628,121,0,3706
2003,Sudan,Um Ali,93,0,223,0,196,28,0,540,76,0,214,0,249,25,0,564
2003,Sudan,Suki,202,0,405,0,563,37,0,1207,100,0,306,0,685,70,0,1161
2003,Sudan,"Shagrabs 1, 2 & 3",1895,0,3092,0,3052,493,0,8532,1851,0,3932,0,6005,385,0,12173
2003,Sudan,Kilo 26,544,0,1830,0,1762,216,0,4352,508,0,1667,0,2101,137,0,4413
2003,Sudan,Karkora,294,0,696,0,671,103,0,1764,270,0,630,0,810,57,0,1767
2003,Sudan,Hawata,124,0,257,0,263,35,0,679,114,0,239,0,284,20,0,657
2003,Sudan,Girba,398,0,1568,0,1908,139,0,4013,448,0,1771,0,1650,214,0,4083
2003,Sudan,Fau 5,80,0,332,0,240,41,0,693,81,0,237,0,255,12,0,585
2003,Sudan,Asotriba,297,0,253,0,166,77,0,793,332,0,265,0,90,420,0,1107
2003,Sudan,Abuda,176,0,519,0,540,53,0,1288,192,0,561,0,501,73,0,1327
2003,Sudan,Abu Rakham,139,0,389,0,329,64,0,921,120,0,363,0,398,30,0,911
2003,Senegal,Podor,942,0,2265,0,1355,239,0,4801,628,0,1504,0,904,160,0,3196
2003,Senegal,Matam,949,0,2270,0,1358,240,0,4817,638,0,1514,0,905,160,0,3217
2003,Senegal,Dakar,79,0,249,0,809,15,0,1152,91,0,296,0,1670,5,0,2062
2003,Senegal,Dagana,229,0,542,0,323,57,0,1151,153,0,361,0,216,38,0,768
2003,Senegal,Bakel,217,0,517,0,308,54,0,1096,145,0,344,0,206,36,0,731
2003,Singapore,Singapore,0,0,0,0,3,0,0,3,0,0,0,0,0,0,0,0
2003,Sierra Leone,Tobanda,794,0,1170,0,1923,293,0,4180,764,0,1041,0,1458,0,208,3471
2003,Sierra Leone,Taiiama,715,0,988,0,1533,170,0,3406,663,0,1082,0,1571,0,175,3491
2003,Sierra Leone,Largo,718,0,1058,0,1776,227,0,3779,705,0,737,0,1634,0,128,3204
2003,Sierra Leone,Jui/ FRT,0,0,0,0,2,0,0,2,0,0,0,0,0,0,0,0
2003,Sierra Leone,Jimmi Bagbo,556,0,1051,0,1267,216,0,3090,443,0,974,0,1270,0,266,2953
2003,Sierra Leone,Jembe,654,0,800,0,1648,543,0,3645,669,0,669,0,1561,0,818,3717
2003,Sierra Leone,Gondama,490,0,1336,0,2049,579,0,4454,588,0,967,0,2017,0,630,4202
2003,Sierra Leone,Gerrihun,481,0,791,0,1582,585,0,3439,478,0,751,0,1605,0,580,3414
2003,Sierra Leone,Freetown,0,0,0,0,0,0,0,0,0,0,0,0,2,0,0,2
2003,Sierra Leone,Bandajuma,405,0,644,0,763,572,0,2384,449,0,702,0,1011,0,647,2809
2003,El Salvador,San Salvador,1,0,1,0,7,0,0,9,4,0,4,0,5,0,0,13
2003,El Salvador,"La Union, San Miguel, Libertad",0,0,0,0,0,0,107,107,0,0,0,0,0,0,123,123
2003,Somalia,Hargeisa,42,0,32,0,105,0,0,179,38,0,39,0,111,1,0,189
2003,Serbia and Kosovo (S/RES/1244 (1999)),Vojvodina,1008,0,13134,0,46074,19290,0,79506,1104,0,13778,0,43964,13172,0,72018
2003,Serbia and Kosovo (S/RES/1244 (1999)),Montenegro,793,0,4033,0,9158,2650,0,16634,861,0,4339,0,7645,1964,0,14809
2003,Serbia and Kosovo (S/RES/1244 (1999)),Kosovo,103,0,248,0,452,82,0,885,110,0,278,0,400,124,0,912
2003,Serbia and Kosovo (S/RES/1244 (1999)),Central and Southern Serbia,2007,0,15081,0,39969,12773,0,69830,2159,0,15778,0,39730,10097,0,67764
2003,Serbia and Kosovo (S/RES/1244 (1999)),Belgrade area and West of Serbia,1667,0,18848,0,59559,21681,0,101755,1917,0,19987,0,55204,15059,0,92167
2003,Slovenia,Vrhnika,0,0,0,0,0,0,1,1,0,0,0,0,0,0,0,0
2003,Slovenia,Ptuj,0,0,0,0,0,0,1,1,0,0,0,0,0,0,0,0
2003,Slovenia,Postojna,5,0,16,0,59,16,0,96,5,0,15,0,51,14,0,85
2003,Slovenia,N.mesto,1,0,15,0,23,5,0,44,2,0,14,0,41,2,0,59
2003,Slovenia,Medvode,0,0,0,0,0,0,0,0,0,0,0,0,0,0,1,1
2003,Slovenia,Maribor,0,0,1,0,10,3,2,16,0,0,18,0,33,7,0,58
2003,Slovenia,Ljubljana,10,0,50,0,170,50,29,309,8,0,47,0,163,35,41,294
2003,Slovenia,Kranj,0,0,0,0,0,0,1,1,0,0,0,0,0,0,0,0
2003,Slovenia,Kozina,0,0,1,0,9,10,0,20,0,0,3,0,7,4,0,14
2003,Slovenia,I.Bistric,3,0,8,0,29,7,0,47,2,0,10,0,20,4,0,36
2003,Slovenia,Hrastnik,0,0,0,0,0,0,0,0,0,0,0,0,0,0,1,1
2003,Slovenia,Grgar,0,0,0,0,0,0,1,1,0,0,0,0,0,0,0,0
2003,Slovenia,Crnomelj,0,0,3,0,12,1,0,16,0,0,6,0,12,4,0,22
2003,Slovenia,Celje,2,0,8,0,49,5,0,64,6,0,12,0,58,6,0,82
2003,Swaziland,Malindza,6,0,6,0,21,1,0,34,6,0,11,0,35,0,0,52
2003,Syrian Arab Rep.,Damascus,161,0,598,0,943,39,0,1741,155,0,706,0,1022,57,0,1940
2003,Chad,South Sites,0,0,0,0,0,0,18150,18150,0,0,0,0,0,0,14850,14850
2003,Chad,Ndjamena,0,0,0,0,0,0,1486,1486,0,0,0,0,0,0,2879,2879
2003,Chad,East Sites,0,0,0,0,0,0,62700,62700,0,0,0,0,0,0,47300,47300
2003,Togo,Sotouboua,912,0,1389,0,1201,24,0,3526,901,0,1108,0,733,20,0,2762
2003,Togo,Lome,79,0,192,0,389,7,0,667,79,0,195,0,583,5,0,862
2003,Togo,Dankpen,302,0,602,0,792,17,0,1713,277,0,257,0,295,27,0,856
2003,Togo,Bassar,274,0,612,0,547,9,0,1442,289,0,298,0,301,21,0,909
2003,Thailand,Um Pium (Pob Phra),962,0,2598,0,3743,277,0,7580,1019,0,2762,0,3911,239,0,7931
2003,Thailand,Tham Hin,579,0,1690,0,2061,186,0,4516,562,0,1687,0,1962,184,0,4395
2003,Thailand,Pangkwai,943,0,2808,0,4225,256,0,8232,1018,0,2809,0,4891,313,0,9031
2003,Thailand,Nu Po (Umphang),684,0,1473,0,1942,151,0,4250,640,0,1505,0,2075,127,0,4347
2003,Thailand,Napho,2,0,6,0,5,0,0,13,2,0,13,0,7,0,0,22
2003,Thailand,Mae Surin,126,0,472,0,727,35,0,1360,150,0,458,0,973,64,0,1645
2003,Thailand,Mae Ra Ma Luang (Sob Moei),405,0,1632,0,2219,225,0,4481,456,0,1796,0,2504,228,0,4984
2003,Thailand,Mae La (Thasongyang),2240,0,5302,0,8018,584,0,16144,2384,0,5667,0,8132,588,0,16771
2003,Thailand,Mae Kong Kha (Mae Sariang),899,0,2980,0,4072,293,0,8244,951,0,3348,0,4531,344,0,9174
2003,Thailand,Don Yang,227,0,681,0,888,50,0,1846,213,0,748,0,756,63,0,1780
2003,Thailand,Bangkok,110,0,241,0,576,21,0,948,103,0,278,0,957,21,0,1359
2003,Tajikistan,Khujand,0,0,0,0,0,0,100,100,0,0,0,0,10,0,128,138
2003,Tajikistan,Dushanbe,0,0,0,0,0,0,1717,1717,0,0,0,0,7,0,1359,1366
2003,Turkmenistan,Vekilbazar region,10,0,45,0,70,3,0,128,16,0,44,0,73,13,0,146
2003,Turkmenistan,Turkmenabad,6,0,33,0,29,0,0,68,13,0,51,0,38,0,0,102
2003,Turkmenistan,Serdarabat region,13,0,55,0,86,3,0,157,18,0,50,0,84,15,0,167
2003,Turkmenistan,Seidy Region,17,0,73,0,114,4,0,208,28,0,76,0,126,23,0,253
2003,Turkmenistan,Sayat region,4,0,18,0,28,1,0,51,5,0,14,0,23,4,0,46
2003,Turkmenistan,Sakarchaga region,4,0,16,0,25,1,0,46,9,0,23,0,39,7,0,78
2003,Turkmenistan,Oguzkhan region,174,0,762,0,1199,44,0,2179,277,0,756,0,1260,227,0,2520
2003,Turkmenistan,Mary,0,0,1,0,4,1,0,6,0,0,3,0,2,0,0,5
2003,Turkmenistan,Magdanly city,4,0,19,0,29,1,0,53,8,0,21,0,36,6,0,71
2003,Turkmenistan,Koitendag region,9,0,41,0,64,2,0,116,11,0,30,0,50,9,0,100
2003,Turkmenistan,Khojambaz region,11,0,49,0,78,3,0,141,22,0,60,0,101,18,0,201
2003,Turkmenistan,Khalach region,7,0,30,0,47,2,0,86,15,0,42,0,70,13,0,140
2003,Turkmenistan,Karabekavul region,2,0,10,0,16,1,0,29,4,0,10,0,17,3,0,34
2003,Turkmenistan,Gavers region,28,0,121,0,191,7,0,347,50,0,137,0,228,41,0,456
2003,Turkmenistan,Garashsyzlyl region,6,0,27,0,42,2,0,77,8,0,23,0,38,7,0,76
2003,Turkmenistan,Galkynysh region,12,0,53,0,84,3,0,152,18,0,50,0,84,15,0,167
2003,Turkmenistan,Beyik Turkmenbashy region,165,0,721,0,1132,41,0,2059,234,0,638,0,1064,192,0,2128
2003,Turkmenistan,Atamourad region,23,0,101,0,159,6,0,289,34,0,93,0,155,28,0,310
2003,Turkmenistan,Ashgabat,8,0,52,0,92,9,0,161,12,0,49,0,95,10,0,166
2003,Timor-Leste,Dili,0,0,0,0,1,0,0,1,0,0,0,0,14,0,0,14
2003,Tunisia,Tunis,1,0,3,0,30,8,0,42,5,0,4,0,41,7,0,57
2003,Turkey,Yozgat,0,0,3,0,3,0,0,6,0,0,6,0,8,0,0,14
2003,Turkey,Van,55,0,146,0,483,15,0,699,47,0,218,0,786,17,0,1068
2003,Turkey,Tokat,1,0,3,0,3,0,0,7,0,0,0,0,0,0,0,0
2003,Turkey,Sivas,0,0,0,0,0,0,0,0,1,0,3,0,6,0,0,10
2003,Turkey,Nigde,1,0,11,0,43,1,0,56,3,0,11,0,48,0,0,62
2003,Turkey,Nevsehir,4,0,24,0,66,3,0,97,7,0,23,0,78,3,0,111
2003,Turkey,Kutahya,0,0,0,0,0,0,0,0,0,0,1,0,5,1,0,7
2003,Turkey,Konya,2,0,4,0,14,0,0,20,4,0,9,0,24,0,0,37
2003,Turkey,Kirsehir,2,0,10,0,29,1,0,42,3,0,12,0,34,0,0,49
2003,Turkey,Kayseri,19,0,92,0,277,13,0,401,24,0,129,0,334,13,0,500
2003,Turkey,Kastamonu,1,0,0,0,6,0,0,7,1,0,1,0,9,0,0,11
2003,Turkey,Istanbul,33,0,136,0,357,37,0,563,45,0,202,0,417,36,0,700
2003,Turkey,Isparta,2,0,5,0,14,0,0,21,2,0,7,0,20,0,0,29
2003,Turkey,Hakkari,0,0,3,0,6,0,0,9,0,0,3,0,8,0,0,11
2003,Turkey,Eskisehir,8,0,8,0,36,2,0,54,4,0,21,0,53,1,0,79
2003,Turkey,Corum,1,0,4,0,10,0,0,15,0,0,9,0,8,0,0,17
2003,Turkey,Cankiri,1,0,8,0,20,0,0,29,3,0,10,0,23,0,0,36
2003,Turkey,Burdur,1,0,1,0,3,0,0,5,0,0,1,0,5,0,0,6
2003,Turkey,Bilecik,1,0,2,0,4,0,0,7,0,0,2,0,3,0,0,5
2003,Turkey,Ankara,9,0,59,0,102,3,0,173,19,0,67,0,118,3,0,207
2003,Turkey,Amasya,1,0,8,0,19,1,0,29,1,0,7,0,26,0,0,34
2003,Turkey,Aksaray,1,0,5,0,15,0,0,21,1,0,8,0,19,2,0,30
2003,Turkey,Agri,0,0,5,0,8,0,0,13,2,0,6,0,12,0,0,20
2003,Turkey,Afyon,1,0,6,0,15,0,0,22,3,0,6,0,21,0,0,30
2003,United Rep. of Tanzania,Nyarugusu,5182,0,11304,0,12495,892,0,29873,5145,0,11433,0,11146,857,0,28581
2003,United Rep. of Tanzania,Nduta,5910,0,6923,0,7807,408,0,21048,5890,0,6833,0,8725,424,0,21872
2003,United Rep. of Tanzania,Myovosi,3730,0,6828,0,8583,390,0,19531,3655,0,7106,0,9137,406,0,20304
2003,United Rep. of Tanzania,Mwisa,0,0,0,0,7,0,0,7,0,0,0,0,1,0,0,1
2003,United Rep. of Tanzania,Mtendeli,6569,0,6474,0,7616,381,0,21040,6379,0,6283,0,7015,381,0,20058
2003,United Rep. of Tanzania,Mtabila 2,4139,0,8276,0,8930,435,0,21780,4094,0,8614,0,9294,680,0,22682
2003,United Rep. of Tanzania,Mtabila 1,1616,0,3563,0,3584,156,0,8919,1606,0,3570,0,3480,268,0,8924
2003,United Rep. of Tanzania,Mkuyu,330,0,639,0,651,141,0,1761,430,0,654,0,391,94,0,1569
2003,United Rep. of Tanzania,Mkugwa,340,0,311,0,430,21,0,1102,140,0,324,0,470,11,0,945
2003,United Rep. of Tanzania,Mbuba,8,0,23,0,22,7,0,60,11,0,18,0,23,10,0,62
2003,United Rep. of Tanzania,Lukole,11299,0,16315,0,17986,906,0,46506,10968,0,17452,0,18785,943,0,48148
2003,United Rep. of Tanzania,Lugufu,8452,0,17652,0,19511,1395,0,47010,7588,0,18746,0,17407,892,0,44633
2003,United Rep. of Tanzania,Karago,4880,0,3338,0,3652,188,0,12058,5263,0,3238,0,3570,90,0,12161
2003,United Rep. of Tanzania,Kane Mbwa,2159,0,3192,0,3736,282,0,9369,2346,0,3224,0,3813,383,0,9766
2003,Uganda,Rhinocamp,2205,0,5530,0,4666,156,0,12557,2316,0,6379,0,4809,107,0,13611
2003,Uganda,Oruchinga,700,0,640,0,727,34,0,2101,710,0,707,0,704,40,0,2161
2003,Uganda,Okollo,854,0,1203,0,1416,93,0,3566,750,0,1480,0,1059,68,0,3357
2003,Uganda,Nakivale,2517,0,2258,0,2437,75,0,7287,2761,0,2470,0,2697,89,0,8017
2003,Uganda,Moyo,2592,0,5807,0,6646,253,0,15298,3051,0,6813,0,6121,228,0,16213
2003,Uganda,Masindi,1622,0,2573,0,2855,276,0,7326,1585,0,2733,0,2624,240,0,7182
2003,Uganda,Kyaka 2,858,0,988,0,1182,58,0,3086,825,0,1008,0,1181,75,0,3089
2003,Uganda,Imvepi,1252,0,3520,0,3371,127,0,8270,1522,0,5017,0,3972,101,0,10612
2003,Uganda,Ikafe,691,0,1486,0,1491,93,0,3761,737,0,1894,0,1364,62,0,4057
2003,Uganda,Hoima,2329,0,2654,0,3048,250,0,8281,2376,0,3198,0,3195,170,0,8939
2003,Uganda,Adjumani,4809,0,11340,0,13209,752,0,30110,5238,0,12665,0,13248,625,0,31776
2003,Ukraine,Kyiv,10,0,42,0,121,10,0,183,13,0,64,0,693,11,0,781
2003,Uruguay,Montevideo,0,0,5,0,23,4,0,32,0,0,9,0,55,4,0,68
2003,Uzbekistan,Termez,13,0,67,0,59,3,0,142,13,0,62,0,112,5,0,192
2003,Uzbekistan,Tashkent,1690,0,1481,0,2118,504,0,5793,1464,0,1386,0,2098,429,0,5377
2003,Uzbekistan,Syrdarya,1658,0,967,0,1519,461,0,4605,1412,0,824,0,1295,392,0,3923
2003,Uzbekistan,Surkhandarya,1562,0,912,0,1433,434,0,4341,1331,0,776,0,1220,370,0,3697
2003,Uzbekistan,Samarkand,871,0,513,0,806,243,0,2433,743,0,435,0,687,205,0,2070
2003,Uzbekistan,Kashkadarya,784,0,458,0,719,218,0,2179,668,0,390,0,612,186,0,1856
2003,Uzbekistan,Fergana,887,0,518,0,813,247,0,2465,756,0,441,0,693,210,0,2100
2003,Venezuela (Bolivarian Republic of),Villa del Rosario (Zulia),0,0,0,0,2,0,0,2,0,0,1,0,4,0,0,5
2003,Venezuela (Bolivarian Republic of),Ureña (Táchira),11,0,44,0,44,13,0,112,14,0,31,0,45,6,0,96
2003,Venezuela (Bolivarian Republic of),Trujillo (Trujillo),1,0,2,0,3,0,0,6,0,0,1,0,3,0,0,4
2003,Venezuela (Bolivarian Republic of),Tovar (Mérida),0,0,0,0,0,0,0,0,0,0,0,0,1,0,0,1
2003,Venezuela (Bolivarian Republic of),Táriba (Táchira),0,0,0,0,2,1,0,3,0,0,1,0,1,0,0,2
2003,Venezuela (Bolivarian Republic of),Socopo (Barinas),0,0,0,0,1,0,0,1,0,0,0,0,1,1,0,2
2003,Venezuela (Bolivarian Republic of),Santa Barbara (Zulia),1,0,3,0,2,0,0,6,2,0,1,0,2,0,0,5
2003,Venezuela (Bolivarian Republic of),Santa Ana (Táchira),1,0,10,0,11,0,0,22,1,0,5,0,10,0,0,16
2003,Venezuela (Bolivarian Republic of),San Josecito (Táchira),0,0,4,0,4,0,0,8,1,0,2,0,2,0,0,5
2003,Venezuela (Bolivarian Republic of),San José (Zulia),0,0,0,0,0,0,0,0,0,0,0,0,1,0,0,1
2003,Venezuela (Bolivarian Republic of),San Cristóbal (Táchira),5,0,31,0,37,5,0,78,8,0,32,0,52,3,0,95
2003,Venezuela (Bolivarian Republic of),San Carlos (Zulia),0,0,0,0,1,0,0,1,0,0,0,0,0,0,0,0
2003,Venezuela (Bolivarian Republic of),San Antonio (Táchira),4,0,10,0,19,2,0,35,4,0,11,0,24,2,0,41
2003,Venezuela (Bolivarian Republic of),Sabaneta (Táchira),0,0,1,0,1,0,0,2,0,0,1,0,1,0,0,2
2003,Venezuela (Bolivarian Republic of),Sabana Larga (Táchira),3,0,4,0,3,0,0,10,2,0,9,0,1,2,0,14
2003,Venezuela (Bolivarian Republic of),Rubio (Táchira),2,0,5,0,6,0,0,13,3,0,8,0,9,0,0,20
2003,Venezuela (Bolivarian Republic of),Río Socuavó (Zulia),3,0,4,0,2,0,0,9,5,0,7,0,2,0,0,14
2003,Venezuela (Bolivarian Republic of),Río de Oro (Zulia),0,0,1,0,1,1,0,3,1,0,0,0,0,1,0,2
2003,Venezuela (Bolivarian Republic of),Pto. Ordaz (Bolivar),0,0,0,0,0,0,0,0,0,0,0,0,1,0,0,1
2003,Venezuela (Bolivarian Republic of),Playa Galinero (Táchira),0,0,5,0,3,0,0,8,0,0,2,0,1,0,0,3
2003,Venezuela (Bolivarian Republic of),Palotal (Táchira),1,0,1,0,1,0,0,3,0,0,0,0,1,0,0,1
2003,Venezuela (Bolivarian Republic of),Mérida (Mérida),0,0,0,0,1,0,0,1,1,0,1,0,3,0,0,5
2003,Venezuela (Bolivarian Republic of),Maracaibo (Zulia),0,0,2,0,12,0,0,14,0,0,0,0,6,0,0,6
2003,Venezuela (Bolivarian Republic of),Machiques (Zulia),3,0,3,0,3,0,0,9,1,0,4,0,6,0,0,11
2003,Venezuela (Bolivarian Republic of),Los Robles (Zulia),2,0,3,0,2,0,0,7,2,0,3,0,4,1,0,10
2003,Venezuela (Bolivarian Republic of),La Victoria (Apure),0,0,1,0,1,0,0,2,0,0,3,0,1,0,0,4
2003,Venezuela (Bolivarian Republic of),La Fría (Táchira),0,0,3,0,2,0,0,5,0,0,1,0,0,0,0,1
2003,Venezuela (Bolivarian Republic of),Guasdualito (Apure),22,0,58,0,82,2,0,164,13,0,46,0,73,3,0,135
2003,Venezuela (Bolivarian Republic of),Elorza (Apure),0,0,3,0,1,0,0,4,1,0,0,0,0,0,0,1
2003,Venezuela (Bolivarian Republic of),El Vigía (Mérida),0,0,4,0,3,1,0,8,0,0,2,0,4,0,0,6
2003,Venezuela (Bolivarian Republic of),El Piñal (Táchira),0,0,2,0,2,0,0,4,1,0,3,0,3,0,0,7
2003,Venezuela (Bolivarian Republic of),El Nula (Apure),24,0,84,0,104,10,0,222,26,0,119,0,95,14,0,254
2003,Venezuela (Bolivarian Republic of),El Dorado (Bolivar),0,0,0,0,0,0,0,0,0,0,0,0,1,0,0,1
2003,Venezuela (Bolivarian Republic of),El Cruce (Zulia),7,0,19,0,24,2,0,52,10,0,13,0,17,2,0,42
2003,Venezuela (Bolivarian Republic of),El Corozo (Táchira),0,0,0,0,1,0,0,1,2,0,0,0,1,0,0,3
2003,Venezuela (Bolivarian Republic of),El Amparo (Apure),1,0,2,0,3,1,0,7,2,0,6,0,4,1,0,13
2003,Venezuela (Bolivarian Republic of),Ciudad Sucre (Apure),0,0,1,0,2,0,0,3,0,0,2,0,0,0,0,2
2003,Venezuela (Bolivarian Republic of),Chivo (Zulia),0,0,0,0,2,0,0,2,0,0,0,0,0,1,0,1
2003,Venezuela (Bolivarian Republic of),Caracas,14,0,21,0,96,3,0,134,26,0,32,0,166,5,0,229
2003,Venezuela (Bolivarian Republic of),Capitanejo (Barinas),0,0,0,0,1,0,0,1,0,0,0,0,1,0,0,1
2003,Venezuela (Bolivarian Republic of),Capacho (Táchira),0,0,1,0,1,0,0,2,0,0,2,0,2,0,0,4
2003,Venezuela (Bolivarian Republic of),Barquisimeto (Lara),0,0,0,0,2,1,0,3,0,0,0,0,0,2,0,2
2003,Venezuela (Bolivarian Republic of),Barinas (Barinas),1,0,1,0,0,2,0,4,0,0,0,0,2,0,0,2
2003,Venezuela (Bolivarian Republic of),Pto. Infante-Macanillal (Apure),10,0,32,0,34,2,0,78,9,0,33,0,40,4,0,86
2003,Venezuela (Bolivarian Republic of),Mesa de Seboruco (Táchira),3,0,10,0,13,1,0,27,6,0,15,0,15,2,0,38
2003,Venezuela (Bolivarian Republic of),Los Ángeles del Tokuko (Zulia),1,0,2,0,5,0,0,8,0,0,4,0,7,2,0,13
2003,Viet Nam,Thu Duc (Ho Chi Minh City),0,0,0,0,0,0,39,39,0,0,0,0,0,0,39,39
2003,Viet Nam,Cu Chi (Ho Chi Minh City),0,0,0,0,0,0,129,129,0,0,0,0,0,0,104,104
2003,Viet Nam,B Phuoc,0,0,0,0,0,0,130,130,0,0,0,0,0,0,131,131
2003,Viet Nam,B Duong,0,0,0,0,0,0,930,930,0,0,0,0,0,0,858,858
2003,Yemen,Taiz,59,0,358,0,690,185,0,1292,56,0,680,0,650,180,0,1566
2003,Yemen,Shabwa,15,0,57,0,151,6,0,229,12,0,44,0,171,2,0,229
2003,Yemen,Sana'a/Aden,54,0,147,0,221,27,11,460,82,0,157,0,243,27,0,509
2003,Yemen,Sana'a,424,0,3444,0,5447,712,0,10027,357,0,3346,0,5009,599,0,9311
2003,Yemen,Sada'a,2,0,16,0,25,4,0,47,3,0,30,0,55,5,0,93
2003,Yemen,Rida'a,29,0,35,0,56,5,0,125,25,0,65,0,62,5,0,157
2003,Yemen,Mukalla,41,0,162,0,165,33,0,401,39,0,152,0,66,34,0,291
2003,Yemen,Mahra,32,0,123,0,157,7,0,319,32,0,140,0,182,7,0,361
2003,Yemen,Hodeidah,20,0,81,0,109,24,0,234,19,0,110,0,104,19,0,252
2003,Yemen,Dhamar,18,0,37,0,78,2,0,135,17,0,32,0,47,4,0,100
2003,Yemen,AL-Kharaz,1070,0,2126,0,2347,57,0,5600,1072,0,2345,0,1849,47,0,5313
2003,Yemen,Al-Baida,8,0,67,0,86,7,0,168,14,0,46,0,92,2,0,154
2003,Yemen,Aden,295,0,2679,0,3119,371,0,6464,334,0,2745,0,3423,305,0,6807
2003,South Africa,"Johannesburg, Pretoria, Durban, Cape Town Port Elizabeth",2546,0,8222,0,12825,14,0,23607,6417,0,32511,0,48053,55,0,87036
2003,Zambia,Ukwimi,271,0,407,0,453,9,0,1140,294,0,484,0,572,17,0,1367
2003,Zambia,Nangweshi,2782,0,5328,0,4624,225,0,12959,2648,0,5089,0,5450,383,0,13570
2003,Zambia,Mwange,4255,0,4174,0,4339,989,0,13757,4030,0,3698,0,3626,933,0,12287
2003,Zambia,Meheba,3031,0,5669,0,5426,1024,0,15150,2512,0,5333,0,5730,1009,0,14584
2003,Zambia,Mayukwayuka,2521,0,3423,0,4300,704,0,10948,2269,0,3124,0,3599,748,0,9740
2003,Zambia,Kala,2471,0,4240,0,4848,214,0,11773,2549,0,4223,0,5276,189,0,12237
2003,Zimbabwe,Tongogara,108,0,177,0,316,0,0,601,136,0,343,0,765,0,0,1244
2003,Zimbabwe,Harare,42,0,41,0,97,0,0,180,31,0,41,0,304,0,0,376
2004,Afghanistan,Various,127786,0,401884,0,564645,84486,1679202,2858003,135341,0,434058,0,666423,79086,1871629,3186537
2004,Angola,Zaire,0,0,0,0,0,0,2658,2658,0,0,0,0,0,0,2454,2454
2004,Angola,Viana,433,0,1874,0,1526,40,0,3873,439,0,1839,0,880,35,0,3193
2004,Angola,Uige,0,0,0,0,0,0,2658,2658,0,0,0,0,0,0,2454,2454
2004,Angola,Sungi,15,0,81,0,82,4,0,182,13,0,69,0,54,11,0,147
2004,Angola,Moxico,219,0,734,0,427,25,30894,32299,226,0,711,0,139,15,28517,29608
2004,Angola,Malange,53,0,153,0,237,4,596,1043,40,0,177,0,135,10,550,912
2004,Angola,Lunda Sul,53,0,167,0,210,2,0,432,9,0,52,0,315,2,0,378
2004,Angola,Lunda Norte,10,0,17,0,201,12,838,1078,14,0,28,0,192,7,773,1014
2004,Angola,Luanda,39,0,136,0,432,2,1828,2437,51,0,173,0,646,13,1687,2570
2004,Angola,Kwanza Sul,0,0,22,0,16,0,0,38,0,0,17,0,26,0,0,43
2004,Angola,Kwanza Norte,0,0,8,0,5,0,0,13,1,0,10,0,11,0,0,22
2004,Angola,Kuando Kubango,0,0,0,0,0,0,6832,6832,0,0,0,0,0,0,6308,6308
2004,Angola,Keutepwe,43,0,87,0,117,13,0,260,35,0,70,0,94,11,0,210
2004,Angola,Kamatende,93,0,186,0,162,18,0,459,94,0,187,0,82,8,0,371
2004,Angola,Cabinda,0,0,0,0,0,0,617,617,0,0,0,0,0,0,569,569
2004,Albania,Tirana,3,0,7,0,9,0,0,19,4,0,6,0,16,0,0,26
2004,Albania,Peshkopi,0,0,0,0,1,0,0,1,0,0,0,0,0,0,0,0
2004,Albania,Lac,0,0,0,0,2,0,0,2,0,0,0,0,4,0,0,4
2004,Albania,Fier,0,0,2,0,0,0,0,2,0,0,1,0,0,0,0,1
2004,Albania,Babrru (Tirana),1,0,4,0,4,0,0,9,1,0,6,0,16,0,0,23
2004,Armenia,Yerevan,2,0,19,0,61,15,0,97,5,0,19,0,71,9,1,105
2004,Armenia,Vayots Dzor,0,0,0,0,0,0,2123,2123,0,0,0,0,0,0,1808,1808
2004,Armenia,Tavush,0,0,0,0,0,0,5444,5444,0,0,0,0,0,0,4637,4637
2004,Armenia,Syunik,0,0,0,0,0,0,7535,7535,0,0,0,0,0,0,6418,6418
2004,Armenia,Shirak,0,0,0,0,0,0,2066,2066,0,0,0,0,0,0,1759,1759
2004,Armenia,Lori,0,0,0,0,0,0,9017,9017,0,0,0,0,0,0,7681,7681
2004,Armenia,Kotayk,0,0,0,0,0,0,16381,16381,0,0,0,0,0,0,13955,13955
2004,Armenia,Gegharkunik,0,0,0,0,0,0,14311,14311,0,0,0,0,0,0,12190,12190
2004,Armenia,Armavir,0,0,0,0,0,0,13057,13057,0,0,0,0,0,0,11123,11123
2004,Armenia,Ararat,0,0,0,0,0,0,25408,25408,0,0,0,0,0,0,21643,21643
2004,Armenia,Aragatsotn,0,0,0,0,0,0,3871,3871,0,0,0,0,0,0,3297,3297
2004,Azerbaijan,Yevlah,0,0,0,0,0,0,6432,6432,0,0,0,0,0,0,5214,5214
2004,Azerbaijan,Tartar,0,0,0,0,0,0,8059,8059,0,0,0,0,0,0,7457,7457
2004,Azerbaijan,Sumgait,0,0,0,0,0,0,22752,22752,0,0,0,0,0,0,21332,21332
2004,Azerbaijan,Sabirabad,0,0,0,0,0,0,9293,9293,0,0,0,0,0,0,7986,7986
2004,Azerbaijan,Saatli,0,0,0,0,0,0,6177,6177,0,0,0,0,0,0,4912,4912
2004,Azerbaijan,Naftalan,0,0,0,0,0,0,1513,1513,0,0,0,0,0,0,1455,1455
2004,Azerbaijan,Mingachevir,0,0,0,0,0,0,10215,10215,0,0,0,0,0,0,8821,8821
2004,Azerbaijan,Lachin,0,0,0,0,0,0,7140,7140,0,0,0,0,0,0,6869,6869
2004,Azerbaijan,Imishli,0,0,0,0,0,0,7592,7592,0,0,0,0,0,0,5746,5746
2004,Azerbaijan,Ganja,0,0,0,0,0,0,8910,8910,0,0,0,0,0,0,6648,6648
2004,Azerbaijan,Fizuli,0,0,0,0,0,0,27769,27769,0,0,0,0,0,0,26579,26579
2004,Azerbaijan,Bilasuvar,0,0,0,0,0,0,6582,6582,0,0,0,0,0,0,6032,6032
2004,Azerbaijan,Beylagan,0,0,0,0,0,0,8754,8754,0,0,0,0,0,0,7453,7453
2004,Azerbaijan,Barda,0,0,0,0,0,0,25313,25313,0,0,0,0,0,0,22671,22671
2004,Azerbaijan,Baku,281,0,1527,0,2910,88,84606,89412,346,0,1531,0,2830,57,76951,81715
2004,Azerbaijan,Ali-Bayramli,0,0,0,0,0,0,2392,2392,0,0,0,0,0,0,2059,2059
2004,Azerbaijan,Agdam,0,0,0,0,0,0,13650,13650,0,0,0,0,0,0,11625,11625
2004,Azerbaijan,Agcabedi,0,0,0,0,0,0,9604,9604,0,0,0,0,0,0,8827,8827
2004,Burundi,Gihinga,124,0,422,0,342,15,0,903,99,0,416,0,332,18,0,865
2004,Burundi,Gasorwe,979,0,1274,0,1455,179,0,3887,748,0,1002,0,1208,198,0,3156
2004,Burundi,Cibitoke,0,0,0,0,0,0,198,198,0,0,0,0,0,0,168,168
2004,Burundi,Bujumbura,1,0,3,0,5,0,27792,27801,2,0,2,0,5,0,23674,23683
2004,Benin,Kpomasse,95,0,118,0,216,5,0,434,108,0,135,0,318,0,0,561
2004,Benin,Cotonou,24,0,75,0,220,0,0,319,32,0,85,0,617,0,0,734
2004,Bangladesh,Nayapara (Cox Bazaar),1131,0,2420,0,2427,148,0,6126,1268,0,2222,0,2279,131,0,5900
2004,Bangladesh,Kutapalong (Cox Bazaar),777,0,1618,0,1641,100,0,4136,806,0,1608,0,1618,97,0,4129
2004,Bangladesh,Dhaka,4,0,27,0,42,1,0,74,2,0,21,0,87,1,0,111
2004,Bahrain,Manama,0,0,0,0,2,0,0,2,0,0,1,0,3,0,0,4
2004,Belarus,Vitebsk Region,0,0,7,0,17,0,0,24,2,0,13,0,24,1,0,40
2004,Belarus,Mogilev Region,0,0,5,0,6,0,0,11,0,0,0,0,23,0,0,23
2004,Belarus,Minsk Region,3,0,29,0,40,4,0,76,3,0,23,0,51,2,0,79
2004,Belarus,Minsk,12,0,72,0,134,10,0,228,3,0,86,0,277,7,0,373
2004,Belarus,Grodno Region,1,0,2,0,9,2,0,14,0,0,1,0,16,0,0,17
2004,Belarus,Gomel Region,1,0,13,0,23,8,0,45,3,0,10,0,41,4,0,58
2004,Belarus,Brest Region,0,0,0,0,1,0,0,1,0,0,2,0,6,0,0,8
2004,Belize,Belize City,63,0,180,0,85,19,0,347,63,0,207,0,125,20,0,415
2004,Bolivia (Plurinational State of),Tarija,0,0,5,0,9,0,0,14,1,0,4,0,16,0,0,21
2004,Bolivia (Plurinational State of),Santa Cruz,7,0,40,0,150,4,0,201,7,0,64,0,177,7,0,255
2004,Bolivia (Plurinational State of),La Paz,0,0,0,0,6,0,0,6,0,0,2,0,9,0,0,11
2004,Bolivia (Plurinational State of),Cochabamba,0,0,2,0,6,0,0,8,0,0,3,0,9,0,0,12
2004,Bolivia (Plurinational State of),Beni,1,0,2,0,2,0,0,5,1,0,4,0,8,0,0,13
2004,Botswana,Gaborone,1,0,5,0,18,0,0,24,0,0,11,0,25,0,0,36
2004,Botswana,Dukwi,378,0,469,0,594,39,0,1480,349,0,541,0,1389,54,0,2333
2004,Central African Rep.,Molangue,75,0,181,0,170,3,0,429,68,0,213,0,289,1,0,571
2004,Central African Rep.,Mboki,1379,0,3075,0,4913,199,0,9566,1379,0,3154,0,4921,225,0,9679
2004,Central African Rep.,Kbando,15,0,32,0,26,0,0,73,22,0,32,0,32,0,0,86
2004,Central African Rep.,Boubou,52,0,225,0,302,0,0,579,85,0,271,0,342,0,0,698
2004,Central African Rep.,Bangui,474,0,930,0,1259,8,0,2671,555,0,1005,0,1839,17,0,3416
2004,Chile,Santiago,7,0,37,0,148,6,0,198,11,0,63,0,379,3,0,456
2004,China,Wenchang,0,0,0,0,0,0,0,0,0,0,0,0,2,0,0,2
2004,China,Shanghai,0,0,0,0,0,0,0,0,0,0,0,0,2,0,0,2
2004,China,Nanjing,1,0,1,0,1,0,0,3,0,0,0,0,2,0,0,2
2004,China,Hangzhou,0,0,0,0,0,0,0,0,0,0,0,0,1,0,0,1
2004,China,Guangzhou,0,0,0,0,0,0,0,0,0,0,0,0,1,0,0,1
2004,China,Beijing,3,0,10,0,14,0,0,27,4,0,13,0,79,0,0,96
2004,China,Beihai,0,0,0,0,0,0,0,0,0,0,0,0,0,1,0,1
2004,Côte d'Ivoire,Z-Hounien,201,0,382,0,338,129,0,1050,129,0,383,0,360,143,0,1015
2004,Côte d'Ivoire,Toulepleu,268,0,341,0,359,183,0,1151,178,0,340,0,345,182,0,1045
2004,Côte d'Ivoire,Tabou Tc,370,0,650,0,855,47,0,1922,372,0,626,0,636,30,0,1664
2004,Côte d'Ivoire,Tabou,4622,0,7847,0,9752,878,0,23099,4644,0,7646,0,7565,701,0,20556
2004,Côte d'Ivoire,San Pedro,92,0,133,0,299,42,0,566,98,0,153,0,200,38,0,489
2004,Côte d'Ivoire,Nicla,564,0,1308,0,1760,129,0,3761,532,0,1221,0,1520,127,0,3400
2004,Côte d'Ivoire,Danane,129,0,222,0,245,107,0,703,126,0,207,0,229,105,0,667
2004,Côte d'Ivoire,Blolequin,136,0,316,0,557,91,0,1100,137,0,354,0,362,75,0,928
2004,Côte d'Ivoire,Bin Houye,195,0,322,0,376,164,0,1057,176,0,239,0,277,163,0,855
2004,Côte d'Ivoire,Abidjan,223,0,957,0,2140,93,967,4380,276,0,1014,0,2284,74,858,4506
2004,Cameroon,Banyo,1042,0,3909,0,3742,153,0,8846,1156,0,3633,0,2773,278,0,7840
2004,Dem. Rep. of the Congo,Zomfi,2,0,3,0,4,1,0,10,2,0,4,0,6,1,0,13
2004,Dem. Rep. of the Congo,Tshimbumbulu,21,0,43,0,63,14,0,141,28,0,36,0,53,15,0,132
2004,Dem. Rep. of the Congo,Tshilonda (Kasai),26,0,17,0,46,0,0,89,27,0,31,0,77,0,0,135
2004,Dem. Rep. of the Congo,Tshifwameso,177,0,429,0,413,19,0,1038,169,0,437,0,172,12,0,790
2004,Dem. Rep. of the Congo,Tshabobo,60,0,56,0,112,2,0,230,56,0,47,0,138,4,0,245
2004,Dem. Rep. of the Congo,Sadi-Zulu,97,0,159,0,194,21,0,471,81,0,165,0,173,16,0,435
2004,Dem. Rep. of the Congo,Nkondo,94,0,143,0,185,15,0,437,93,0,170,0,103,1,0,367
2004,Dem. Rep. of the Congo,Napassa,97,0,272,0,271,15,0,655,125,0,305,0,119,16,0,565
2004,Dem. Rep. of the Congo,Mbujimayi,1,0,3,0,5,0,0,9,1,0,6,0,13,0,0,20
2004,Dem. Rep. of the Congo,Lusuku,29,0,38,0,89,6,0,162,36,0,32,0,76,1,0,145
2004,Dem. Rep. of the Congo,Lubumbashi,32,0,54,0,90,8,0,184,38,0,58,0,95,3,0,194
2004,Dem. Rep. of the Congo,Kulindji,247,0,858,0,644,70,0,1819,227,0,820,0,161,30,0,1238
2004,Dem. Rep. of the Congo,Kisenge,79,0,160,0,188,22,0,449,70,0,165,0,155,17,0,407
2004,Dem. Rep. of the Congo,Kinshasa,123,0,371,0,691,52,0,1237,147,0,333,0,897,119,0,1496
2004,Dem. Rep. of the Congo,Kinsalulu,177,0,461,0,448,33,0,1119,192,0,584,0,306,12,0,1094
2004,Dem. Rep. of the Congo,Kinsafu,106,0,317,0,253,16,0,692,97,0,349,0,187,8,0,641
2004,Dem. Rep. of the Congo,Kimpindi,82,0,210,0,197,22,0,511,77,0,252,0,119,7,0,455
2004,Dem. Rep. of the Congo,Kimfwakata,165,0,485,0,373,15,0,1038,172,0,466,0,262,9,0,909
2004,Dem. Rep. of the Congo,Kimaza,59,0,97,0,101,1,0,258,79,0,109,0,246,8,0,442
2004,Dem. Rep. of the Congo,Kilueka,178,0,297,0,377,41,0,893,179,0,359,0,299,22,0,859
2004,Dem. Rep. of the Congo,Katsha,60,0,50,0,119,1,0,230,50,0,45,0,156,6,0,257
2004,Dem. Rep. of the Congo,Goma/Bukavu,23,0,57,0,86,4,0,170,39,0,69,0,91,5,0,204
2004,Dem. Rep. of the Congo,Dungu (Kpezu),27,0,34,0,57,0,0,118,32,0,28,0,65,2,0,127
2004,Dem. Rep. of the Congo,Dungu (Kaka2),94,0,181,0,350,1,0,626,84,0,178,0,324,8,0,594
2004,Dem. Rep. of the Congo,Dungu (Kaka1),18,0,48,0,64,3,0,133,33,0,49,0,99,4,0,185
2004,Dem. Rep. of the Congo,Dungu (Centre),23,0,29,0,80,1,0,133,23,0,37,0,69,4,0,133
2004,Dem. Rep. of the Congo,Doruma (Mandofi),165,0,389,0,579,37,0,1170,145,0,445,0,454,53,0,1097
2004,Dem. Rep. of the Congo,Doruma (Centre),40,0,110,0,123,18,0,291,30,0,141,0,140,27,0,338
2004,Dem. Rep. of the Congo,Divuma,98,0,189,0,222,20,0,529,80,0,160,0,188,23,0,451
2004,Dem. Rep. of the Congo,Boga,177,0,465,0,410,77,0,1129,146,0,342,0,355,44,0,887
2004,Dem. Rep. of the Congo,Biringi (Biringi),23,0,31,0,68,5,0,127,36,0,46,0,75,3,0,160
2004,Dem. Rep. of the Congo,Biringi (Ayamba),17,0,77,0,75,6,0,175,20,0,87,0,64,3,0,174
2004,Dem. Rep. of the Congo,Bas-Fleuve,107,0,280,0,307,15,0,709,116,0,219,0,345,36,0,716
2004,Dem. Rep. of the Congo,Aba (Rudu2),456,0,561,0,990,65,0,2072,427,0,724,0,908,104,0,2163
2004,Dem. Rep. of the Congo,Aba (Rudu1),239,0,281,0,477,68,0,1065,202,0,334,0,442,53,0,1031
2004,Congo,Tchitanzi,7,0,19,0,17,5,0,48,11,0,22,0,29,4,0,66
2004,Congo,Tchiamba-Nzassi,24,0,53,0,47,3,0,127,22,0,44,0,49,2,0,117
2004,Congo,Pointe-Noire,30,0,80,0,157,9,0,276,40,0,99,0,236,16,0,391
2004,Congo,Oyo,12,0,8,0,20,0,0,40,6,0,14,0,41,0,0,61
2004,Congo,Ollombo,0,0,1,0,1,0,0,2,0,0,3,0,2,0,0,5
2004,Congo,Ngo,12,0,12,0,23,1,0,48,15,0,11,0,38,0,0,64
2004,Congo,Ndjoundou/Liranga,426,0,802,0,837,50,0,2115,402,0,780,0,696,51,0,1929
2004,Congo,Mpouya,2,0,0,0,1,0,0,3,0,0,0,0,1,0,0,1
2004,Congo,Loukolela,342,0,450,0,689,34,0,1515,376,0,476,0,901,27,0,1780
2004,Congo,Kondi Mbaka,85,0,212,0,366,26,0,689,147,0,348,0,422,31,0,948
2004,Congo,Komi,20,0,39,0,121,3,0,183,54,0,123,0,214,7,0,398
2004,Congo,Kintele,32,0,181,0,208,2,0,423,47,0,269,0,333,16,0,665
2004,Congo,Kimongo/Malolo II,54,0,211,0,89,7,0,361,45,0,189,0,103,2,0,339
2004,Congo,Impfondo,3383,0,6790,0,6730,689,0,17592,3212,0,7061,0,5714,521,0,16508
2004,Congo,Gamboma,1,0,1,0,3,0,0,5,0,0,2,0,7,0,0,9
2004,Congo,Djambala,7,0,4,0,9,0,0,20,7,0,5,0,16,0,0,28
2004,Congo,Brazzaville,147,0,656,0,1022,5,0,1830,335,0,971,0,959,57,0,2322
2004,Congo,Betou,1460,0,3414,0,3746,319,0,8939,1551,0,3382,0,3520,232,0,8685
2004,Colombia,San andrés,0,0,0,0,3,0,0,3,0,0,0,0,1,4,0,5
2004,Colombia,Duitama,0,0,0,0,2,0,0,2,0,0,1,0,0,0,0,1
2004,Colombia,Cúcuta,1,0,0,0,1,0,0,2,0,0,1,0,1,0,0,2
2004,Colombia,Buenaventura,0,0,2,0,1,0,0,3,0,0,2,0,6,0,0,8
2004,Colombia,Bogotá,3,0,8,0,30,11,0,52,2,0,6,0,65,21,0,94
2004,Costa Rica,Puntar,0,0,12,0,86,0,0,98,0,0,0,0,159,0,0,159
2004,Costa Rica,Limon,0,0,0,0,0,0,0,0,12,0,12,0,123,12,0,159
2004,Costa Rica,Guanac,0,0,12,0,37,0,0,49,0,0,37,0,61,0,0,98
2004,Costa Rica,Gam,133,0,1268,0,2981,145,0,4527,98,0,965,0,4088,172,0,5323
2004,Cuba,Havana,0,0,2,0,12,0,0,14,1,0,6,0,22,0,0,29
2004,Cuba,Guantánamo,0,0,0,0,0,0,0,0,0,0,0,0,1,0,0,1
2004,Cuba,Cienfuegos,0,0,0,0,1,0,0,1,0,0,0,0,0,0,0,0
2004,Czech Rep.,Zbysov,0,0,0,0,0,0,23,23,0,0,0,0,0,0,38,38
2004,Czech Rep.,Zastavka u Brna,0,0,0,0,0,0,23,23,0,0,0,0,0,0,37,37
2004,Czech Rep.,Vysni Lhoty,0,0,0,0,0,0,65,65,0,0,0,0,0,0,107,107
2004,Czech Rep.,Straz p. Ralskem,0,0,0,0,0,0,27,27,0,0,0,0,0,0,44,44
2004,Czech Rep.,Sec,0,0,0,0,0,0,15,15,0,0,0,0,0,0,25,25
2004,Czech Rep.,Praha Ruzyne Airport,0,0,0,0,0,0,5,5,0,0,0,0,0,0,8,8
2004,Czech Rep.,Kostelec nad Orlici,0,0,0,0,0,0,30,30,0,0,0,0,0,0,48,48
2004,Czech Rep.,Kasava,42,0,61,0,46,8,17,174,27,0,48,0,42,2,27,146
2004,Czech Rep.,Havirov,0,0,0,0,0,0,19,19,0,0,0,0,0,0,30,30
2004,Czech Rep.,Cerveny Ujezd,0,0,0,0,0,0,35,35,0,0,0,0,0,0,56,56
2004,Czech Rep.,Bruntal,0,0,0,0,0,0,17,17,0,0,0,0,0,0,29,29
2004,Czech Rep.,Bela Jezova,0,0,0,0,0,0,28,28,0,0,0,0,0,0,45,45
2004,Algeria,Alger,0,0,1,0,10,0,0,11,2,0,4,0,26,0,0,32
2004,Egypt,Cairo,1431,0,2707,0,6204,144,0,10486,1689,0,3039,0,13753,128,0,18609
2004,Eritrea,Massawa,0,0,0,0,0,0,0,0,0,0,0,0,5,0,0,5
2004,Eritrea,Emkulu,293,0,553,0,690,24,0,1560,346,0,622,0,968,27,0,1963
2004,Eritrea,Elit,36,0,98,0,92,4,0,230,53,0,114,0,306,11,0,484
2004,Eritrea,Asmara,36,0,56,0,116,1,0,209,36,0,59,0,141,2,0,238
2004,Eritrea,Afabet,0,0,0,0,0,0,0,0,0,0,0,0,29,0,0,29
2004,Estonia,Tallinn,0,0,0,0,2,0,0,2,1,0,0,0,8,0,0,9
2004,Estonia,L-Virumaa,0,0,0,0,0,0,0,0,0,0,0,0,1,0,0,1
2004,Estonia,Kohtla-Järve,0,0,0,0,0,0,0,0,0,0,0,0,1,0,0,1
2004,Estonia,Jõhvi,0,0,0,0,0,0,0,0,0,0,0,0,3,0,0,3
2004,Estonia,Illuka,0,0,0,0,0,0,0,0,0,0,0,0,1,0,0,1
2004,Ethiopia,Yarenja (Bamboudi),456,0,814,0,963,60,0,2293,449,0,956,0,801,89,0,2295
2004,Ethiopia,Shimelba (Shire/Shiraro),397,0,750,0,1253,139,0,2539,406,0,833,0,3112,174,0,4525
2004,Ethiopia,Sherkole (Assosa),1762,0,2533,0,3246,97,0,7638,1834,0,3169,0,3195,93,0,8291
2004,Ethiopia,Kebribeyah (Jijiga),8,0,2198,0,2965,103,0,5274,6,0,2115,0,2743,179,0,5043
2004,Ethiopia,Fugnido (Gambella),4140,0,4860,0,6203,202,0,15405,4453,0,6580,0,5408,130,0,16571
2004,Ethiopia,Dimma (Gambella),2473,0,1772,0,2934,111,0,7290,2456,0,3308,0,6106,91,0,11961
2004,Ethiopia,Bonga (Gambella),3023,0,3308,0,3281,94,0,9706,3162,0,3521,0,2306,78,0,9067
2004,Ethiopia,Aisha (JIjiga),8,0,1454,0,1392,62,0,2916,9,0,1666,0,1232,95,0,3002
2004,Ethiopia,Addis Ababa,42,0,64,0,142,4,590,842,30,0,61,0,163,4,1071,1329
2004,Gabon,Tchibanga,107,0,385,0,534,15,0,1041,112,0,358,0,660,13,0,1143
2004,Gabon,Rinanzala,0,0,0,0,0,0,0,0,0,0,0,0,1,0,0,1
2004,Gabon,Rébé,1,0,4,0,3,0,0,8,0,0,2,0,0,0,0,2
2004,Gabon,Port-Gentil,7,0,20,0,33,2,0,62,3,0,22,0,142,9,0,176
2004,Gabon,Pana/Dienga,0,0,2,0,8,2,0,12,4,0,5,0,29,3,0,41
2004,Gabon,Okondja,1,0,1,0,2,0,0,4,1,0,1,0,9,2,0,13
2004,Gabon,Ngouoni,5,0,7,0,14,0,0,26,2,0,6,0,46,1,0,55
2004,Gabon,Ndendé,32,0,108,0,180,12,0,332,47,0,95,0,175,3,0,320
2004,Gabon,Mounana,20,0,43,0,65,4,0,132,11,0,32,0,92,5,0,140
2004,Gabon,Moulengui,76,0,220,0,280,39,0,615,68,0,248,0,257,41,0,614
2004,Gabon,Mouila,31,0,90,0,157,5,0,283,26,0,92,0,206,0,0,324
2004,Gabon,Moanda,108,0,504,0,659,33,0,1304,109,0,426,0,821,29,0,1385
2004,Gabon,Mitzic,0,0,0,0,0,0,0,0,0,0,0,0,2,0,0,2
2004,Gabon,Mékambo,0,0,0,0,0,0,0,0,0,0,0,0,1,0,0,1
2004,Gabon,Mayumba,8,0,16,0,40,2,0,66,6,0,16,0,67,0,0,89
2004,Gabon,Makokou,0,0,0,0,0,0,0,0,0,0,0,0,4,0,0,4
2004,Gabon,Mabanda,22,0,62,0,85,9,0,178,39,0,63,0,79,7,0,188
2004,Gabon,Libreville,206,0,669,0,1104,33,0,2012,207,0,724,0,2178,80,0,3189
2004,Gabon,Lékindou,3,0,16,0,27,2,0,48,6,0,19,0,16,2,0,43
2004,Gabon,Lébamba,2,0,15,0,20,1,0,38,10,0,15,0,28,2,0,55
2004,Gabon,Lastourville,28,0,38,0,86,2,0,154,9,0,56,0,78,2,0,145
2004,Gabon,Lambaréné,0,0,5,0,10,0,0,15,4,0,6,0,23,1,0,34
2004,Gabon,Koumou-Doussala,0,0,1,0,4,0,0,5,3,0,2,0,4,1,0,10
2004,Gabon,Koula-Moutou,11,0,45,0,52,1,0,109,14,0,49,0,154,7,0,224
2004,Gabon,Gamba,7,0,18,0,73,0,0,98,10,0,14,0,110,1,0,135
2004,Gabon,Franceville,136,0,425,0,741,23,0,1325,140,0,389,0,1432,36,0,1997
2004,Gabon,Doussala,2,0,4,0,5,0,0,11,4,0,4,0,6,1,0,15
2004,Gabon,Boumango,21,0,46,0,49,11,0,127,7,0,38,0,43,8,0,96
2004,Gabon,Boué,0,0,0,0,0,0,0,0,0,0,0,0,1,0,0,1
2004,Gabon,Bakoumba,18,0,39,0,43,4,0,104,13,0,29,0,29,2,0,73
2004,Gabon,Akiéni,0,0,0,0,0,0,0,0,0,0,0,0,2,0,0,2
2004,Georgia,Tbilisi,1,0,6,0,10,0,0,17,0,0,1,0,15,0,0,16
2004,Georgia,Khalatsani,12,0,15,0,17,0,0,44,9,0,17,0,20,2,0,48
2004,Georgia,Jokolo,54,0,158,0,186,6,0,404,72,0,171,0,111,7,0,361
2004,Georgia,Duisi,111,0,291,0,386,16,0,804,136,0,316,0,334,16,0,802
2004,Georgia,Akhmeta,3,0,12,0,10,2,0,27,1,0,8,0,9,2,0,20
2004,Ghana,Krisan,131,0,248,0,397,15,0,791,129,0,235,0,663,8,0,1035
2004,Ghana,Buduburam,2188,0,7209,0,11286,493,0,21176,2205,0,6409,0,11792,231,0,20637
2004,Ghana,Bole,0,0,0,0,0,0,0,0,0,0,0,0,1,0,0,1
2004,Ghana,Accra,168,0,508,0,981,20,0,1677,208,0,558,0,1960,20,0,2746
2004,Guinea,Yomou,530,0,1342,0,1173,118,0,3163,592,0,1131,0,1413,231,0,3367
2004,Guinea,Telikoro,408,0,1826,0,1232,270,0,3736,401,0,957,0,1227,95,0,2680
2004,Guinea,Nzerekore Ville,385,0,3318,0,3224,318,0,7245,1550,0,4044,0,2397,610,0,8601
2004,Guinea,Nzerekore Peripherie,267,0,634,0,620,26,0,1547,421,0,1298,0,1187,85,0,2991
2004,Guinea,Nonah,405,0,1159,0,908,76,0,2548,329,0,1137,0,641,43,0,2150
2004,Guinea,Lola,494,0,847,0,1247,104,0,2692,990,0,1671,0,1801,239,0,4701
2004,Guinea,Laine,1877,0,5798,0,5993,462,0,14130,1857,0,5726,0,4506,263,0,12352
2004,Guinea,Kountaya,595,0,2738,0,2031,368,0,5732,637,0,1898,0,2075,203,0,4813
2004,Guinea,Kouankan,2130,0,5539,0,5401,810,0,13880,2074,0,5977,0,2630,417,0,11098
2004,Guinea,Kola,442,0,1512,0,1422,81,0,3457,467,0,1591,0,969,79,0,3106
2004,Guinea,Conakry,198,0,2792,0,2172,36,0,5198,225,0,3611,0,2981,47,0,6864
2004,Guinea,Boreah,242,0,1184,0,877,142,0,2445,305,0,1171,0,881,108,0,2465
2004,Guinea,Beyla,879,0,2931,0,1574,294,0,5678,1867,0,4297,0,2213,553,0,8930
2004,Gambia,Banjul,0,0,0,0,0,0,3765,3765,0,0,0,0,0,0,4078,4078
2004,Gambia,Bambali,0,0,0,0,0,0,61,61,0,0,0,0,0,0,41,41
2004,Guinea-Bissau,Jolmete,52,0,112,0,113,9,0,286,55,0,109,0,93,13,0,270
2004,Guinea-Bissau,Border Area,633,0,1368,0,1380,104,2400,5885,664,0,1326,0,1130,156,2600,5876
2004,Guinea-Bissau,Bissau,32,0,73,0,76,4,0,185,33,0,70,0,64,8,0,175
2004,Guatemala,Guatemala City,0,0,1,0,304,34,0,339,1,0,3,0,283,34,0,321
2004,"China, Hong Kong SAR",Hong Kong,2,0,0,0,16,0,0,18,0,0,2,0,33,1,0,36
2004,Honduras,Trujillo,0,0,0,0,0,0,0,0,0,0,0,0,28,0,0,28
2004,Honduras,Tegucigalpa and San Pedro,0,0,1,0,2,0,0,3,0,0,0,0,10,0,0,10
2004,Honduras,La Ceiba,0,0,0,0,0,0,0,0,0,0,0,0,2,0,0,2
2004,Croatia,Sasna Greda,0,0,3,0,4,0,0,7,1,0,1,0,5,0,0,7
2004,Croatia,Jezevo,0,0,0,0,0,0,0,0,0,0,0,0,15,0,0,15
2004,Indonesia,Tanjung Pinang,0,0,0,0,0,0,0,0,0,0,0,0,2,0,0,2
2004,Indonesia,Jakarta,5,0,23,0,43,1,0,72,6,0,28,0,117,2,0,153
2004,India,New Delhi,188,0,1637,0,3656,326,0,5807,236,0,1781,0,2922,325,0,5264
2004,Iran (Islamic Rep. of),Zanjan,10,0,39,0,41,2,0,92,12,0,43,0,89,5,0,149
2004,Iran (Islamic Rep. of),West-Azerbaijan,84,0,338,0,359,21,0,802,106,0,380,0,781,42,0,1309
2004,Iran (Islamic Rep. of),Tehran,0,0,5,0,2,1,0,8,0,0,1,0,12,2,0,15
2004,Iran (Islamic Rep. of),Sistan-Baluchistan,195,0,780,0,829,49,0,1853,244,0,878,0,1805,98,0,3025
2004,Iran (Islamic Rep. of),Semnan,109,0,435,0,462,27,0,1033,136,0,490,0,1006,54,0,1686
2004,Iran (Islamic Rep. of),Mashad,0,0,0,0,6,0,0,6,0,0,0,0,19,0,0,19
2004,Iran (Islamic Rep. of),Markazi,153,0,611,0,649,38,0,1451,191,0,687,0,1413,76,0,2367
2004,Iran (Islamic Rep. of),Lorestan,37,0,149,0,159,9,0,354,47,0,168,0,346,19,0,580
2004,Iran (Islamic Rep. of),Kurdestan,16,0,66,0,70,4,0,156,21,0,74,0,152,8,0,255
2004,Iran (Islamic Rep. of),Khuzestan,28,0,111,0,118,7,0,264,35,0,125,0,256,14,0,430
2004,Iran (Islamic Rep. of),Khorasan,198,0,791,0,840,49,0,1878,247,0,890,0,1829,99,0,3065
2004,Iran (Islamic Rep. of),Kermanshah,10,0,40,0,43,3,0,96,13,0,45,0,93,5,0,156
2004,Iran (Islamic Rep. of),Kerman,510,0,2040,0,2167,127,0,4844,637,0,2295,0,4717,255,0,7904
2004,Iran (Islamic Rep. of),Fars,113,0,452,0,480,28,0,1073,141,0,509,0,1046,57,0,1753
2004,Iran (Islamic Rep. of),Bushehr,95,0,378,0,402,24,0,899,118,0,426,0,875,47,0,1466
2004,Iraq,Wassit,1,0,6,0,6,0,0,13,1,0,4,0,5,1,0,11
2004,Iraq,Tameem,0,0,1,0,2,0,0,3,1,0,1,0,3,0,0,5
2004,Iraq,Sulaymaniyah,63,0,444,0,698,65,0,1270,60,0,536,0,689,79,0,1364
2004,Iraq,Salah al-Din,1,0,8,0,14,1,0,24,1,0,11,0,12,0,0,24
2004,Iraq,Qadissiya,4,0,2,0,12,0,0,18,1,0,3,0,10,2,0,16
2004,Iraq,Ninewa,469,0,1963,0,2206,225,0,4863,533,0,2057,0,1915,197,0,4702
2004,Iraq,Missan,0,0,2,0,0,0,0,2,0,0,1,0,1,0,0,2
2004,Iraq,Kerbala,0,0,4,0,8,0,0,12,0,0,1,0,2,3,0,6
2004,Iraq,Erbil,23,0,211,0,309,18,0,561,18,0,167,0,424,22,0,631
2004,Iraq,Diyala,6,0,29,0,49,4,0,88,11,0,22,0,35,5,0,73
2004,Iraq,Dahuk,111,0,779,0,831,58,0,1779,127,0,846,0,790,56,0,1819
2004,Iraq,Basrah,0,0,2,0,4,0,0,6,0,0,1,0,7,0,0,8
2004,Iraq,Baghdad,842,0,3280,0,6225,815,0,11162,865,0,3428,0,6381,819,0,11493
2004,Iraq,Babylon,1,0,6,0,18,1,0,26,2,0,7,0,19,4,0,32
2004,Iraq,Anbar,15,0,33,0,43,5,0,96,6,0,31,0,43,5,0,85
2004,Jordan,Amman,332,0,1418,0,2762,170,0,4682,348,0,1595,0,6745,183,0,8871
2004,Kazakhstan,Almaty,47,0,76,0,161,16,0,300,58,0,92,0,266,7,0,423
2004,Kenya,Nairobi,607,0,4452,0,2025,34,0,7118,669,0,7596,0,1986,145,0,10396
2004,Kenya,Kakuma,5954,0,12721,0,16240,675,0,35590,6672,0,18520,0,26362,539,0,52093
2004,Kenya,Ifo (Dadaab),3538,0,8084,0,13057,612,0,25291,3815,0,9346,0,12983,753,0,26897
2004,Kenya,Hagadera (Dadaab),3446,0,8673,0,12725,665,0,25509,3781,0,9273,0,12566,799,0,26419
2004,Kenya,Dagahaley (Dadaab),2590,0,5652,0,8345,383,0,16970,2725,0,6302,0,7979,526,0,17532
2004,Kenya,Dadaab,360,0,838,0,1275,61,0,2534,383,0,928,0,1269,77,0,2657
2004,Kyrgyzstan,Osh region,15,0,15,0,57,6,0,93,18,0,18,0,72,7,0,115
2004,Kyrgyzstan,Issyk-Kul region,0,0,1,0,3,0,0,4,1,0,0,0,2,0,0,3
2004,Kyrgyzstan,Djalal-Abad region,3,0,3,0,12,2,0,20,3,0,3,0,11,2,0,19
2004,Kyrgyzstan,Chui Region,215,0,215,0,828,86,0,1344,253,0,253,0,972,101,0,1579
2004,Kyrgyzstan,Bishkek,56,0,60,0,330,16,0,462,58,0,69,0,382,19,0,528
2004,Kyrgyzstan,Batken,3,0,4,0,11,1,0,19,3,0,4,0,14,2,0,23
2004,Cambodia,Phnom Penh,0,0,7,0,17,0,0,24,6,0,8,0,50,2,0,66
2004,Rep. of Korea,Seoul,0,0,0,0,93,0,0,93,1,0,1,0,196,0,0,198
2004,Kuwait,Kuwait City,2855,0,19302,0,26866,1772,0,50795,3299,0,19936,0,27147,1499,0,51881
2004,Liberia,VOA,95,0,289,0,342,22,0,748,131,0,291,0,439,19,0,880
2004,Liberia,Samukai,51,0,119,0,167,4,0,341,49,0,120,0,182,7,0,358
2004,Liberia,Saclepea,44,0,116,0,97,23,0,280,59,0,74,0,85,32,0,250
2004,Liberia,Montserrado County,4,0,7,0,13,0,0,24,7,0,6,0,38,0,0,51
2004,Liberia,Little Wlebo,1,0,11,0,12,4,0,28,4,0,9,0,24,2,0,39
2004,Liberia,Banjor,20,0,58,0,86,1,0,165,35,0,58,0,127,3,0,223
2004,Libya,Tripoli,559,0,1532,0,2726,176,0,4993,705,0,2077,0,4471,120,0,7373
2004,Sri Lanka,Vavuniya,1360,0,5379,0,12002,1379,0,20120,1405,0,5612,0,11246,1427,0,19690
2004,Sri Lanka,Trincomalee,646,0,2598,0,5950,707,0,9901,670,0,2717,0,5565,730,0,9682
2004,Sri Lanka,Ratnapura,4,0,18,0,42,5,0,69,5,0,19,0,40,5,0,69
2004,Sri Lanka,Puttalam,2302,0,8744,0,18237,1901,0,31184,2363,0,9066,0,17173,1977,0,30579
2004,Sri Lanka,Polonnaruwa,92,0,372,0,858,102,0,1424,95,0,389,0,801,106,0,1391
2004,Sri Lanka,Mullaitivu,1887,0,7671,0,17870,2167,0,29595,1959,0,8037,0,16691,2237,0,28924
2004,Sri Lanka,Matara,39,0,161,0,379,47,0,626,41,0,169,0,354,48,0,612
2004,Sri Lanka,Matale,87,0,357,0,841,103,0,1388,90,0,374,0,784,107,0,1355
2004,Sri Lanka,Mannar,997,0,4013,0,9208,1096,0,15314,1034,0,4198,0,8610,1132,0,14974
2004,Sri Lanka,Kurunegala,105,0,418,0,941,109,0,1573,109,0,437,0,883,113,0,1542
2004,Sri Lanka,Kilinochchi,934,0,3674,0,8130,924,0,13662,964,0,3831,0,7620,956,0,13371
2004,Sri Lanka,Kegalle,1,0,5,0,13,2,0,21,1,0,6,0,11,2,0,20
2004,Sri Lanka,Kandy,0,0,2,0,4,1,0,7,0,0,2,0,4,0,0,6
2004,Sri Lanka,Kalutara,27,0,109,0,258,32,0,426,28,0,115,0,240,33,0,416
2004,Sri Lanka,Jaffna,2117,0,8487,0,19364,2289,0,32257,2192,0,8874,0,18113,2365,0,31544
2004,Sri Lanka,Hambantota,3,0,14,0,33,4,0,54,4,0,15,0,31,4,0,54
2004,Sri Lanka,Gampaha,65,0,265,0,625,77,0,1032,67,0,278,0,583,79,0,1007
2004,Sri Lanka,Galle,18,0,74,0,174,21,0,287,19,0,78,0,163,22,0,282
2004,Sri Lanka,Colombo,98,0,377,0,847,98,0,1420,97,0,391,0,806,103,0,1397
2004,Sri Lanka,Batticaloa,649,0,2658,0,6267,771,0,10345,674,0,2788,0,5849,795,0,10106
2004,Sri Lanka,Badulla,8,0,31,0,73,9,0,121,8,0,33,0,68,9,0,118
2004,Sri Lanka,Anuradhapura,386,0,1480,0,3137,335,0,5338,397,0,1537,0,2954,348,0,5236
2004,Sri Lanka,Ampara,125,0,513,0,1209,149,0,1996,130,0,538,0,1129,153,0,1950
2004,Latvia,Salaspils,0,0,0,0,0,0,0,0,0,0,0,0,1,0,0,1
2004,Latvia,Riga,0,0,0,0,0,0,0,0,0,0,0,0,3,0,0,3
2004,Latvia,Jurmala,0,0,1,0,1,0,0,2,0,0,0,0,1,0,0,1
2004,Morocco,Tetouan,0,0,5,0,2,0,0,7,0,0,0,0,2,0,0,2
2004,Morocco,Tanger,0,0,0,0,5,1,0,6,0,0,0,0,14,0,0,14
2004,Morocco,Settat,0,0,0,0,0,0,0,0,0,0,0,0,2,0,0,2
2004,Morocco,Salé,0,0,1,0,1,0,0,2,1,0,1,0,4,2,0,8
2004,Morocco,Safi,0,0,0,0,0,0,0,0,0,0,0,0,1,0,0,1
2004,Morocco,Rabat,1,0,16,0,218,3,0,238,1,0,14,0,333,2,0,350
2004,Morocco,Oujda,0,0,0,0,1,0,0,1,0,0,0,0,1,0,0,1
2004,Morocco,Mohamadia,0,0,2,0,2,0,0,4,0,0,2,0,4,0,0,6
2004,Morocco,Meknes,0,0,0,0,0,0,0,0,0,0,0,0,2,0,0,2
2004,Morocco,Marrakech ,0,0,0,0,5,0,0,5,1,0,0,0,19,1,0,21
2004,Morocco,Larache,0,0,0,0,200,241,0,441,0,0,29,0,534,120,0,683
2004,Morocco,Fès,0,0,0,0,0,0,0,0,0,0,0,0,1,0,0,1
2004,Morocco,Casablanca,3,0,2,0,214,3,0,222,2,0,5,0,253,5,0,265
2004,Morocco,Benimellal,0,0,0,0,0,0,0,0,0,0,0,0,2,0,0,2
2004,Morocco,Agadir,0,0,0,0,2,0,0,2,0,0,0,0,12,0,0,12
2004,Rep. of Moldova,Chisinau,6,0,16,0,26,2,0,50,7,0,21,0,161,2,0,191
2004,Mexico,Mexico City,6,0,141,0,863,119,0,1129,4,0,193,0,1577,107,0,1881
2004,The former Yugoslav Republic of Macedonia,Veles,0,0,2,0,1,1,0,4,0,0,4,0,1,0,0,5
2004,The former Yugoslav Republic of Macedonia,Valandovo,0,0,4,0,3,0,0,7,2,0,2,0,3,1,0,8
2004,The former Yugoslav Republic of Macedonia,Tetovo,3,0,14,0,12,2,0,31,4,0,20,0,12,1,0,37
2004,The former Yugoslav Republic of Macedonia,Sveti Nikole,0,0,0,0,0,1,0,1,0,0,0,0,0,0,0,0
2004,The former Yugoslav Republic of Macedonia,Strumica,0,0,0,0,2,0,0,2,0,0,0,0,0,0,0,0
2004,The former Yugoslav Republic of Macedonia,Stip,0,0,0,0,0,0,0,0,0,0,0,0,1,0,0,1
2004,The former Yugoslav Republic of Macedonia,Skopje,176,0,365,0,471,36,0,1048,173,0,353,0,453,28,0,1007
2004,The former Yugoslav Republic of Macedonia,Prilep,0,0,0,0,1,0,0,1,0,0,0,0,4,0,0,4
2004,The former Yugoslav Republic of Macedonia,Ohrid,0,0,0,0,0,0,0,0,0,0,0,0,2,0,0,2
2004,The former Yugoslav Republic of Macedonia,Kumanovo,3,0,12,0,13,0,0,28,1,0,17,0,9,1,0,28
2004,The former Yugoslav Republic of Macedonia,Krusevo,0,0,0,0,0,0,0,0,0,0,0,0,1,0,0,1
2004,The former Yugoslav Republic of Macedonia,Kicevo,0,0,0,0,2,0,0,2,0,0,0,0,0,0,0,0
2004,The former Yugoslav Republic of Macedonia,Kavadarci,0,0,0,0,1,0,0,1,0,0,0,0,0,0,0,0
2004,The former Yugoslav Republic of Macedonia,Gostivar,1,0,0,0,4,0,0,5,0,0,0,0,0,0,0,0
2004,The former Yugoslav Republic of Macedonia,Gevgelija,0,0,0,0,4,0,0,4,0,0,0,0,2,0,0,2
2004,The former Yugoslav Republic of Macedonia,Gazi Baba,1,0,1,0,3,1,0,6,0,0,1,0,4,0,0,5
2004,The former Yugoslav Republic of Macedonia,Debar,1,0,0,0,0,0,0,1,0,0,0,0,0,0,0,0
2004,The former Yugoslav Republic of Macedonia,Berovo,0,0,0,0,1,0,0,1,0,0,0,0,0,0,0,0
2004,Mali,Zegoua,13,0,36,0,40,8,0,97,11,0,42,0,85,7,0,145
2004,Mali,Sikasso,10,0,24,0,40,0,0,74,13,0,19,0,90,0,0,122
2004,Mali,Loulouni,10,0,22,0,40,0,0,72,16,0,23,0,39,0,0,78
2004,Mali,Koutiala,0,0,1,0,1,0,0,2,3,0,2,0,0,0,0,5
2004,Mali,Kayes,819,0,1166,0,571,90,0,2646,349,0,1848,0,1216,126,0,3539
2004,Mali,Kadiolo,3,0,1,0,0,0,0,4,0,0,8,0,2,1,0,11
2004,Mali,Faragouaran,15,0,26,0,22,0,0,63,13,0,26,0,35,0,0,74
2004,Mali,Bamako,206,0,620,0,1131,37,0,1994,258,0,576,0,2533,48,0,3415
2004,Mozambique,Maratane,545,0,669,0,781,11,0,2006,542,0,761,0,1187,9,0,2499
2004,Mauritania,Nouakchott,14,0,29,0,141,9,0,193,16,0,32,0,224,8,0,280
2004,Malawi,Luwani,29,0,166,0,244,13,0,452,39,0,166,0,333,15,0,553
2004,Malawi,Lilongwe,35,0,82,0,224,1,0,342,45,0,145,0,331,1,0,522
2004,Malawi,Dzaleka,175,0,861,0,1288,51,0,2375,332,0,1060,0,1312,67,0,2771
2004,Malaysia,Kuala Lumpur,1068,0,1189,0,5474,69,0,7800,1080,0,1493,0,24579,181,0,27333
2004,Namibia,Osire,751,0,1450,0,1461,90,0,3752,741,0,1648,0,2299,57,0,4745
2004,Niger,Niamey,22,0,29,0,51,0,0,102,13,0,28,0,103,0,0,144
2004,Niger,Goure,11,0,27,0,25,4,0,67,10,0,27,0,32,3,0,72
2004,Nigeria,Oru Camp,185,0,348,0,1995,4,0,2532,146,0,248,0,2397,18,0,2809
2004,Nigeria,Lagos,53,0,114,0,289,8,0,464,44,0,112,0,445,27,0,628
2004,Nicaragua,Rivas,0,0,0,0,0,0,0,0,0,0,0,0,2,0,0,2
2004,Nicaragua,Puerto Cabezas,0,0,0,0,0,0,0,0,0,0,0,0,1,0,0,1
2004,Nicaragua,Managua,0,0,1,0,8,0,0,9,0,0,1,0,24,3,0,28
2004,Nicaragua,Leon,0,0,0,0,59,0,0,59,0,0,0,0,9,6,0,15
2004,Nicaragua,Corn Isla,0,0,0,0,0,0,0,0,0,0,0,0,1,0,0,1
2004,Nicaragua,Chinand,0,0,0,0,93,0,0,93,0,0,0,0,43,21,0,64
2004,Nicaragua,Carazo,0,0,0,0,13,0,0,13,0,0,0,0,4,0,0,4
2004,Nicaragua,Bluefields,0,0,0,0,0,0,0,0,0,0,0,0,4,0,0,4
2004,Nepal,Timai,450,0,1498,0,2733,272,0,4953,439,0,1582,0,2791,347,0,5159
2004,Nepal,Sanischare,880,0,3466,0,5227,476,20,10069,996,0,3548,0,5412,601,0,10557
2004,Nepal,Khudunabari,478,0,2130,0,3563,337,0,6508,496,0,1995,0,3631,470,0,6592
2004,Nepal,Kathmandu,9,0,12,0,34,2,0,57,21,0,12,0,131,0,0,164
2004,Nepal,Goldhap,331,0,1296,0,2598,261,0,4486,396,0,1316,0,2836,308,0,4856
2004,Nepal,Beldangi 2 Extension,421,0,1648,0,3219,297,0,5585,441,0,1752,0,3268,374,0,5835
2004,Nepal,Beldangi 2,753,0,3198,0,6342,647,0,10940,816,0,3311,0,6420,755,0,11302
2004,Nepal,Beldangi 1,799,0,2635,0,4914,490,0,8838,768,0,2785,0,5090,592,0,9235
2004,Oman,Muscat,0,0,3,0,3,0,0,6,0,0,2,0,22,1,0,25
2004,Pakistan,Quetta,2,0,7,0,6,0,0,15,4,0,12,0,15,0,0,31
2004,Pakistan,Punjab,1741,0,4190,0,3406,369,0,9706,1506,0,4025,0,3648,166,0,9345
2004,Pakistan,Peshawar,11,0,16,0,13,0,0,40,7,0,17,0,23,0,0,47
2004,Pakistan,North West Frontier Province,58015,0,154747,0,158641,15454,0,386857,58284,0,154381,0,116652,13702,0,343019
2004,Pakistan,Karachi,3,0,14,0,16,1,0,34,0,0,7,0,28,1,0,36
2004,Pakistan,Islamabad,27,0,68,0,206,3,0,304,28,0,116,0,906,11,0,1061
2004,Pakistan,Balochistan,19018,0,48139,0,40298,4457,0,111912,16862,0,44673,0,33747,3920,0,99202
2004,Panama,Veraguas,0,0,0,0,2,0,0,2,0,0,0,0,2,0,0,2
2004,Panama,Los Santos,0,0,0,0,3,0,0,3,0,0,0,0,3,0,0,3
2004,Panama,Herrera,0,0,0,0,2,1,0,3,0,0,2,0,0,0,0,2
2004,Panama,David,0,0,0,0,8,1,0,9,0,0,4,0,1,0,0,5
2004,Panama,Colon,0,0,0,0,2,1,0,3,0,0,1,0,1,0,0,2
2004,Panama,Cocle,0,0,2,0,7,1,0,10,0,0,0,0,7,1,0,8
2004,Panama,Bocas Del Toro,0,0,1,0,1,0,0,2,0,0,2,0,1,0,0,3
2004,Papua New Guinea,Port Moresby,0,0,1,0,4,0,0,5,0,0,0,0,0,0,0,0
2004,Papua New Guinea,East Awin,159,0,472,0,601,52,0,1284,167,0,547,0,635,44,0,1393
2004,Papua New Guinea,Daru,0,0,0,0,3,0,0,3,0,0,0,0,0,0,0,0
2004,Paraguay,Asuncion,0,0,6,0,11,1,0,18,0,0,3,0,25,1,0,29
2004,Qatar,Doha,0,0,3,0,6,0,0,9,1,0,8,0,50,2,0,61
2004,Russian Federation,Voronezh,2,0,4,0,10,0,0,16,1,0,4,0,11,0,0,16
2004,Russian Federation,Volgograad,2,0,16,0,14,0,0,32,1,0,9,0,40,0,0,50
2004,Russian Federation,Tatarstan,2,0,17,0,12,1,0,32,3,0,9,0,37,1,0,50
2004,Russian Federation,Stavropol,0,0,8,0,27,1,0,36,3,0,11,0,92,1,0,107
2004,Russian Federation,Saratov,0,0,0,0,0,0,0,0,0,0,0,0,1,0,0,1
2004,Russian Federation,Sachslin,0,0,3,0,3,0,0,6,0,0,0,0,3,0,0,3
2004,Russian Federation,Rostov-na Donu,9,0,19,0,33,0,0,61,11,0,25,0,86,0,0,122
2004,Russian Federation,Orenburg,0,0,1,0,3,0,0,4,0,0,0,0,1,0,0,1
2004,Russian Federation,Orel,2,0,7,0,5,0,0,14,0,0,5,0,12,0,0,17
2004,Russian Federation,North Ossetia Republic,6,0,12,0,81,35,0,134,4,0,19,0,53,19,0,95
2004,Russian Federation,Moscow Region,5,0,13,0,37,6,0,61,5,0,22,0,54,1,0,82
2004,Russian Federation,Moscow City,23,0,42,0,72,1,0,138,10,0,52,0,130,1,0,193
2004,Russian Federation,Lipeck,3,0,3,0,6,0,0,12,1,0,4,0,19,0,0,24
2004,Russian Federation,Leningradskaya Oblast,0,0,4,0,5,0,0,9,1,0,7,0,14,0,0,22
2004,Russian Federation,Krasnodar,8,0,21,0,31,1,0,61,14,0,15,0,30,1,0,60
2004,Russian Federation,Kaluga,0,0,0,0,0,0,0,0,0,0,0,0,2,0,0,2
2004,Russian Federation,Dagestan Republic,0,0,0,0,1,0,0,1,0,0,0,0,3,0,0,3
2004,Russian Federation,Belgorod,1,0,1,0,2,0,0,4,0,0,1,0,7,0,0,8
2004,Russian Federation,Bashkortostan,0,0,0,0,0,0,0,0,0,0,0,0,2,0,0,2
2004,Russian Federation,Arkhangelsk,0,0,0,0,0,0,0,0,0,0,0,0,1,0,0,1
2004,Russian Federation,Altay Region,0,0,0,0,3,1,0,4,0,0,2,0,10,1,0,13
2004,Russian Federation,Altay ,0,0,0,0,0,0,0,0,0,0,0,0,4,0,0,4
2004,Russian Federation,Adyguea,1,0,3,0,0,0,0,4,0,0,0,0,2,0,0,2
2004,Russian Federation,St.-Peterburg (Region and city),23,0,47,0,57,2,0,129,19,0,46,0,276,3,0,344
2004,Rwanda,Nyamure (Butare),234,0,519,0,650,38,0,1441,265,0,590,0,541,9,0,1405
2004,Rwanda,Nkamira (Gisenyi),274,0,560,0,565,19,0,1418,249,0,479,0,234,11,0,973
2004,Rwanda,Kiziba (Kibuye),1661,0,4055,0,3630,391,0,9737,1678,0,3700,0,2263,355,0,7996
2004,Rwanda,Kigeme (Gikongoro),61,0,122,0,132,5,0,320,71,0,132,0,126,10,0,339
2004,Rwanda,Kigali,484,0,981,0,1103,55,0,2623,496,0,1047,0,1360,54,0,2957
2004,Rwanda,Gihembe (Byumba),2340,0,4561,0,3621,420,0,10942,2141,0,4481,0,2120,320,0,9062
2004,Rwanda,Cyangugu,325,0,1028,0,801,26,0,2180,352,0,1055,0,657,12,0,2076
2004,Saudi Arabia,Riyadh,5,0,21,0,15,0,0,41,7,0,22,0,21,1,0,51
2004,Saudi Arabia,Rafha,17,0,57,0,49,2,0,125,17,0,61,0,233,4,0,315
2004,Saudi Arabia,Makkah,0,0,0,0,0,0,0,0,0,0,0,0,1,0,0,1
2004,Saudi Arabia,Madina,0,0,0,0,1,0,0,1,0,0,0,0,0,0,0,0
2004,Saudi Arabia,Khobar,0,0,2,0,3,0,0,5,0,0,2,0,4,0,0,6
2004,Saudi Arabia,Jeddah,6,0,17,0,20,1,0,44,7,0,14,0,53,0,0,74
2004,Saudi Arabia,Gizan,0,0,0,0,1,0,0,1,0,0,0,0,51,0,0,51
2004,Sudan,Wad Sherife,2118,0,5686,0,6051,566,0,14421,2078,0,6209,0,6576,544,0,15407
2004,Sudan,Wad El Hilea,51,0,24,0,1502,20,0,1597,75,0,100,0,2170,90,0,2435
2004,Sudan,Um Sagata,0,0,0,0,0,0,1604,1604,0,0,0,0,0,0,1809,1809
2004,Sudan,Um Gargur,629,0,1434,0,1539,146,0,3748,608,0,1569,0,1667,124,0,3968
2004,Sudan,Um Ali,41,0,18,0,460,10,0,529,39,0,20,0,457,15,0,531
2004,Sudan,"Shagrabs 1, 2 & 3",1349,0,3945,0,4187,345,0,9826,1319,0,4322,0,4528,361,0,10530
2004,Sudan,Salmin,0,0,0,0,0,0,1317,1317,0,0,0,0,0,0,1485,1485
2004,Sudan,Kilo 7,12,0,20,0,308,10,0,350,13,0,18,0,260,9,0,300
2004,Sudan,Kilo 26,646,0,1681,0,1909,149,0,4385,653,0,1925,0,3922,147,0,6647
2004,Sudan,Khartoum,0,0,0,0,0,0,762,762,0,0,0,0,0,0,1143,1143
2004,Sudan,Karkora,0,0,0,0,0,0,1660,1660,0,0,0,0,0,0,1871,1871
2004,Sudan,Hawata,0,0,0,0,0,0,628,628,0,0,0,0,0,0,708,708
2004,Sudan,Girba,591,0,1546,0,1638,144,0,3919,593,0,1689,0,1783,133,0,4198
2004,Sudan,Fau 5,22,0,30,0,250,40,0,342,36,0,27,0,800,25,0,888
2004,Sudan,Fath El Rahman,15,0,12,0,268,8,0,303,17,0,14,0,262,7,0,300
2004,Sudan,Awad El Sid,30,0,24,0,456,11,0,521,29,0,27,0,450,10,0,516
2004,Sudan,Asotriba,0,0,0,0,0,0,893,893,0,0,0,0,0,0,1007,1007
2004,Sudan,Abuda,245,0,562,0,293,257,0,1357,262,0,470,0,352,387,0,1471
2004,Sudan,Abu Rakham,0,0,0,0,0,0,746,746,0,0,0,0,0,0,840,840
2004,Senegal,Podor,942,0,2265,0,1355,239,0,4801,628,0,1504,0,904,160,0,3196
2004,Senegal,Matam,949,0,2270,0,1358,240,0,4817,638,0,1514,0,905,160,0,3217
2004,Senegal,Dakar,22,0,96,0,881,23,0,1022,46,0,193,0,2137,40,0,2416
2004,Senegal,Dagana,229,0,542,0,323,57,0,1151,153,0,361,0,216,38,0,768
2004,Senegal,Bakel,217,0,517,0,308,54,0,1096,145,0,344,0,207,36,0,732
2004,Singapore,Singapore,0,0,0,0,1,0,0,1,0,0,0,0,3,0,0,3
2004,Sierra Leone,Western Area,0,0,0,0,0,0,1006,1006,0,0,0,0,0,0,834,834
2004,Sierra Leone,Tonkolili,0,0,0,0,0,0,67,67,0,0,0,0,0,0,55,55
2004,Sierra Leone,Tobanda,854,0,1217,0,1927,186,0,4184,759,0,1143,0,1428,142,0,3472
2004,Sierra Leone,Taiiama,529,0,1147,0,1089,96,0,2861,573,0,1173,0,1105,91,0,2942
2004,Sierra Leone,Pujehun,0,0,0,0,0,0,7290,7290,0,0,0,0,0,0,6038,6038
2004,Sierra Leone,Port Loko,0,0,0,0,0,0,154,154,0,0,0,0,0,0,127,127
2004,Sierra Leone,Moyamba,0,0,0,0,0,0,66,66,0,0,0,0,0,0,54,54
2004,Sierra Leone,Largo,641,0,1193,0,1720,198,0,3752,658,0,1214,0,1294,138,0,3304
2004,Sierra Leone,Kono,0,0,0,0,0,0,5285,5285,0,0,0,0,0,0,4377,4377
2004,Sierra Leone,Koinadugu,0,0,0,0,0,0,66,66,0,0,0,0,0,0,54,54
2004,Sierra Leone,Kenema,157,0,860,0,867,57,1338,3279,147,0,837,0,753,74,1108,2919
2004,Sierra Leone,Kambia,0,0,0,0,0,0,603,603,0,0,0,0,0,0,499,499
2004,Sierra Leone,Kailahun,0,0,0,0,0,0,14933,14933,0,0,0,0,0,0,12366,12366
2004,Sierra Leone,Jimmi Bagbo,503,0,1097,0,1093,76,0,2769,568,0,1206,0,986,86,0,2846
2004,Sierra Leone,Jembe,530,0,1260,0,1283,156,0,3229,545,0,1355,0,1343,115,0,3358
2004,Sierra Leone,Gondama,690,0,1433,0,1742,119,0,3984,757,0,1435,0,1663,113,0,3968
2004,Sierra Leone,Gerrihun,510,0,1015,0,1223,128,0,2876,520,0,998,0,1277,109,0,2904
2004,Sierra Leone,Freetown,217,0,1032,0,2058,74,0,3381,224,0,981,0,1849,46,0,3100
2004,Sierra Leone,Bonthe,0,0,0,0,0,0,30,30,0,0,0,0,0,0,25,25
2004,Sierra Leone,Bombali,0,0,0,0,0,0,240,240,0,0,0,0,0,0,198,198
2004,Sierra Leone,Bo,37,0,140,0,161,2,659,999,39,0,142,0,114,6,546,847
2004,Sierra Leone,Bandajuma,427,0,798,0,973,92,0,2290,426,0,873,0,931,98,0,2328
2004,El Salvador,San Salvador,0,0,1,0,2,0,0,3,0,0,2,0,2,0,0,4
2004,El Salvador,"La Union, San Miguel, Libertad",0,0,0,0,107,0,0,107,0,0,0,0,122,0,0,122
2004,Somalia,Hargeisa,35,0,37,0,101,0,0,173,39,0,40,0,104,1,0,184
2004,Serbia and Kosovo (S/RES/1244 (1999)),Kosovo,60,0,144,0,307,61,50500,51072,61,0,152,0,253,73,54504,55043
2004,Serbia and Kosovo (S/RES/1244 (1999)),Serbia (Excluding Kosovo),2771,0,44699,0,145201,54512,0,247183,3043,0,47155,0,138845,39021,0,228064
2004,Serbia and Kosovo (S/RES/1244 (1999)),Montenegro,688,0,3175,0,7904,2185,0,13952,789,0,3463,0,6723,1566,0,12541
2004,Slovenia,Postojna,0,0,0,0,0,0,16,16,0,0,0,0,0,0,25,25
2004,Slovenia,Novo Mesto,0,0,0,0,0,0,57,57,0,0,0,0,0,0,41,41
2004,Slovenia,Maribor,0,0,0,0,0,0,17,17,0,0,0,0,0,0,13,13
2004,Slovenia,Ljubljana,0,0,0,0,0,0,143,143,0,0,0,0,0,0,266,266
2004,Slovenia,Celje,0,0,0,0,0,0,32,32,0,0,0,0,0,0,17,17
2004,Swaziland,Malindza,6,0,6,0,21,1,0,34,6,0,11,0,35,0,0,52
2004,Syrian Arab Rep.,Damascus,621,0,2192,0,4379,277,0,7469,611,0,2496,0,6343,320,0,9770
2004,Chad,Yaroungou,2031,0,2883,0,3267,100,0,8281,1897,0,2602,0,3016,61,0,7576
2004,Chad,Treguine,1242,0,2871,0,3174,259,0,7546,1280,0,3137,0,1721,244,0,6382
2004,Chad,Toloum,2020,0,3754,0,3515,672,0,9961,1884,0,3682,0,1677,458,0,7701
2004,Chad,Oure-Cassoni,3203,0,5554,0,5455,751,0,14963,2889,0,3798,0,1633,321,0,8641
2004,Chad,Mile,1988,0,3344,0,3576,392,0,9300,1751,0,2595,0,1090,246,0,5682
2004,Chad,Kounougou,1663,0,2666,0,2985,98,0,7412,1567,0,2269,0,1319,94,0,5249
2004,Chad,Iridimi,2009,0,3797,0,3241,678,0,9725,1352,0,3101,0,1830,275,0,6558
2004,Chad,Goz-Amir,1842,0,3615,0,4248,495,0,10200,2091,0,3650,0,2742,414,0,8897
2004,Chad,Farchana,2049,0,3782,0,4346,488,0,10665,1950,0,3647,0,2389,416,0,8402
2004,Chad,Djabal,2002,0,3367,0,3651,431,0,9451,1800,0,3301,0,2302,373,0,7776
2004,Chad,Bredjing,2850,0,5848,0,6599,730,0,16027,2748,0,6092,0,3954,454,0,13248
2004,Chad,Amboko,1602,0,2714,0,2759,119,0,7194,1551,0,2565,0,2268,248,0,6632
2004,Chad,Am Nabak,2582,0,3273,0,3742,385,0,9982,2243,0,2373,0,1294,291,0,6201
2004,Togo,Lome,89,0,224,0,460,8,0,781,86,0,250,0,682,5,0,1023
2004,Thailand,Um Pium (Pob Phra),938,0,2650,0,3888,297,0,7773,971,0,2824,0,4053,274,0,8122
2004,Thailand,Tham Hin,632,0,1571,0,1852,164,0,4219,636,0,1542,0,1607,164,0,3949
2004,Thailand,Pangkwai,1082,0,2803,0,4221,256,0,8362,1162,0,2805,0,4871,300,0,9138
2004,Thailand,Nu Po (Umphang),627,0,1548,0,1999,164,0,4338,645,0,1541,0,2126,146,0,4458
2004,Thailand,Mae Surin,185,0,471,0,707,29,0,1392,206,0,457,0,935,53,0,1651
2004,Thailand,Mae Ra Ma Luang (Sob Moei),565,0,1643,0,2214,223,0,4645,600,0,1794,0,2499,225,0,5118
2004,Thailand,Mae La Oon,892,0,2939,0,4016,288,0,8135,945,0,3306,0,4487,336,0,9074
2004,Thailand,Mae La (Thasongyang),2123,0,5637,0,8291,656,0,16707,2287,0,5935,0,8469,648,0,17339
2004,Thailand,Don Yang,246,0,653,0,804,56,0,1759,228,0,681,0,616,57,0,1582
2004,Thailand,Bangkok,195,0,519,0,1105,43,0,1862,211,0,530,0,1778,46,0,2565
2004,Turkmenistan,Vekilbazar Region,10,0,45,0,70,3,0,128,16,0,44,0,73,13,0,146
2004,Turkmenistan,Turkmenabad,6,0,33,0,29,0,0,68,13,0,51,0,38,0,0,102
2004,Turkmenistan,Serdarabat Region,13,0,55,0,86,3,0,157,18,0,50,0,84,15,0,167
2004,Turkmenistan,Seidy Region,17,0,73,0,114,4,0,208,21,0,58,0,96,17,0,192
2004,Turkmenistan,Sayat Region,4,0,18,0,28,1,0,51,5,0,14,0,23,4,0,46
2004,Turkmenistan,Sakarchaga Region,4,0,16,0,25,1,0,46,9,0,23,0,39,7,0,78
2004,Turkmenistan,Oguzkhan Region,169,0,740,0,1162,42,0,2113,271,0,739,0,1233,222,0,2465
2004,Turkmenistan,Mary,0,0,0,0,1,0,0,1,0,0,1,0,2,0,0,3
2004,Turkmenistan,Magdanly City,4,0,19,0,29,1,0,53,8,0,21,0,36,6,0,71
2004,Turkmenistan,Koitendag Region,9,0,41,0,64,2,0,116,11,0,30,0,50,9,0,100
2004,Turkmenistan,Khojambaz Region,11,0,49,0,78,3,0,141,22,0,60,0,101,18,0,201
2004,Turkmenistan,Khalach Region,7,0,30,0,47,2,0,86,15,0,42,0,70,13,0,140
2004,Turkmenistan,Karabekavul Region,2,0,10,0,16,1,0,29,4,0,10,0,17,3,0,34
2004,Turkmenistan,Gavers Region,28,0,121,0,191,7,0,347,50,0,137,0,228,41,0,456
2004,Turkmenistan,Garashsyzlyl Region,6,0,27,0,42,2,0,77,8,0,23,0,38,7,0,76
2004,Turkmenistan,Galkynysh Region,10,0,42,0,66,2,0,120,14,0,39,0,65,12,0,130
2004,Turkmenistan,Beyik Turkmenbashy Region,165,0,721,0,1132,41,0,2059,234,0,638,0,1064,192,0,2128
2004,Turkmenistan,Atamourad Region,23,0,101,0,159,6,0,289,34,0,93,0,155,28,0,310
2004,Turkmenistan,Ashgabat,10,0,52,0,89,9,0,160,12,0,51,0,93,10,0,166
2004,Tunisia,Tunis,1,0,4,0,26,7,0,38,4,0,5,0,56,7,0,72
2004,Turkey,Yozgat Camp,0,0,1,0,4,0,0,5,0,0,1,0,3,0,0,4
2004,Turkey,Yozgat,4,0,14,0,16,0,0,34,2,0,7,0,24,0,0,33
2004,Turkey,Van,10,0,42,0,116,3,0,171,22,0,52,0,318,0,0,392
2004,Turkey,Sivas,1,0,4,0,6,1,0,12,1,0,3,0,5,0,0,9
2004,Turkey,Sirnak,0,0,0,0,0,0,0,0,0,0,0,0,3,0,0,3
2004,Turkey,Silopi,0,0,0,0,0,0,0,0,0,0,0,0,1,0,0,1
2004,Turkey,Nigde,1,0,9,0,30,1,0,41,7,0,15,0,34,1,0,57
2004,Turkey,Nevsehir,15,0,33,0,81,7,0,136,9,0,31,0,114,4,0,158
2004,Turkey,Kutahya,7,0,3,0,27,0,0,37,4,0,14,0,33,1,0,52
2004,Turkey,Konya,4,0,25,0,45,1,0,75,16,0,24,0,80,2,0,122
2004,Turkey,Kocaeli,0,0,0,0,1,0,0,1,0,0,0,0,1,0,0,1
2004,Turkey,Kirsehir,3,0,24,0,31,0,0,58,5,0,18,0,60,0,0,83
2004,Turkey,Kirikkale,0,0,1,0,6,0,0,7,2,0,0,0,5,0,0,7
2004,Turkey,Kayseri,15,0,59,0,237,10,0,321,18,0,76,0,235,13,0,342
2004,Turkey,Kastamonu,5,0,11,0,28,1,0,45,5,0,16,0,45,0,0,66
2004,Turkey,Karaman,6,0,11,0,21,1,0,39,4,0,8,0,45,0,0,57
2004,Turkey,Izmit,0,0,0,0,0,0,0,0,0,0,0,0,1,0,0,1
2004,Turkey,Izmir,0,0,0,0,1,0,0,1,0,0,0,0,3,0,0,3
2004,Turkey,Istanbul,73,0,241,0,635,48,0,997,106,0,326,0,804,44,0,1280
2004,Turkey,Isparta,3,0,15,0,29,0,0,47,8,0,11,0,61,1,0,81
2004,Turkey,Hatay,0,0,0,0,0,0,0,0,0,0,0,0,4,0,0,4
2004,Turkey,Hakkari,2,0,4,0,5,0,0,11,0,0,2,0,8,0,0,10
2004,Turkey,Eskisehir,4,0,25,0,51,1,0,81,5,0,31,0,79,3,0,118
2004,Turkey,Edirne,0,0,0,0,0,0,0,0,0,0,0,0,1,0,0,1
2004,Turkey,Corum,1,0,4,0,7,0,0,12,0,0,8,0,9,0,0,17
2004,Turkey,Cankiri,2,0,11,0,23,0,0,36,7,0,14,0,34,0,0,55
2004,Turkey,Bursa,0,0,1,0,1,0,0,2,0,0,1,0,1,0,0,2
2004,Turkey,Burdur,5,0,15,0,24,0,0,44,7,0,5,0,46,0,0,58
2004,Turkey,Border,0,0,0,0,0,0,0,0,0,0,0,0,2,0,0,2
2004,Turkey,Bilecik,0,0,6,0,10,0,0,16,2,0,6,0,19,0,0,27
2004,Turkey,Balikesir,0,0,0,0,0,0,0,0,0,0,0,0,1,0,0,1
2004,Turkey,Antalya,0,0,0,0,0,0,0,0,0,0,0,0,1,0,0,1
2004,Turkey,Ankara,9,0,59,0,90,1,0,159,17,0,60,0,140,0,0,217
2004,Turkey,Amasya,4,0,10,0,27,0,0,41,7,0,13,0,25,0,0,45
2004,Turkey,Aksaray,13,0,26,0,35,0,0,74,7,0,21,0,60,2,0,90
2004,Turkey,Agri,0,0,5,0,5,0,0,10,1,0,2,0,7,0,0,10
2004,Turkey,Afyon,5,0,17,0,26,0,0,48,3,0,15,0,52,0,0,70
2004,Turkey,Adana,1,0,3,0,1,0,0,5,1,0,4,0,2,0,0,7
2004,United Rep. of Tanzania,Nyarugusu,5634,0,10301,0,13718,815,0,30468,5541,0,10549,0,12258,667,0,29015
2004,United Rep. of Tanzania,Nduta,2763,0,5845,0,7191,200,0,15999,2715,0,5789,0,7445,296,0,16245
2004,United Rep. of Tanzania,Myovosi,4189,0,5554,0,8150,244,0,18137,4269,0,5760,0,7790,321,0,18140
2004,United Rep. of Tanzania,Mwisa,0,0,0,0,0,0,0,0,0,0,0,0,16,0,0,16
2004,United Rep. of Tanzania,Mtendeli,2404,0,4719,0,5493,175,0,12791,2447,0,4755,0,5705,213,0,13120
2004,United Rep. of Tanzania,Mtabila 2,5306,0,6520,0,8057,290,0,20173,5203,0,6794,0,8485,308,0,20790
2004,United Rep. of Tanzania,Mtabila 1,2064,0,2874,0,2725,169,0,7832,2123,0,2949,0,3407,183,0,8662
2004,United Rep. of Tanzania,Mkugwa,149,0,351,0,457,13,0,970,142,0,359,0,533,11,0,1045
2004,United Rep. of Tanzania,Mbuba,7,0,7,0,22,0,0,36,6,0,14,0,31,0,0,51
2004,United Rep. of Tanzania,Lukole,7606,0,12326,0,15787,501,0,36220,7631,0,12758,0,14769,621,0,35779
2004,United Rep. of Tanzania,Lugufu,9599,0,16642,0,20832,1035,0,48108,9444,0,17556,0,18136,735,0,45871
2004,United Rep. of Tanzania,Karago,679,0,1231,0,1280,29,0,3219,692,0,1017,0,1549,33,0,3291
2004,United Rep. of Tanzania,Kane Mbwa,1214,0,2785,0,3478,177,0,7654,1131,0,2679,0,3331,214,0,7355
2004,United Rep. of Tanzania,Chogo,221,0,706,0,613,67,0,1607,200,0,536,0,463,61,0,1260
2004,Uganda,Rhinocamp,2466,0,5754,0,5034,157,0,13411,2487,0,6235,0,4495,107,0,13324
2004,Uganda,Oruchinga,680,0,566,0,623,32,0,1901,683,0,633,0,610,32,0,1958
2004,Uganda,Okollo,1090,0,1232,0,1437,96,0,3855,968,0,1490,0,1062,70,0,3590
2004,Uganda,Nakivale,2723,0,2289,0,2456,73,0,7541,2975,0,2510,0,2691,81,0,8257
2004,Uganda,Moyo,3333,0,6596,0,7606,258,0,17793,3765,0,7612,0,6559,235,0,18171
2004,Uganda,Masindi,2050,0,2598,0,2847,272,0,7767,2035,0,2573,0,2861,230,0,7699
2004,Uganda,Kyaka 2,1172,0,1489,0,1645,101,0,4407,1138,0,1547,0,1576,111,0,4372
2004,Uganda,Kampala,154,0,302,0,470,7,0,933,179,0,321,0,653,16,0,1169
2004,Uganda,Imvepi,1664,0,4758,0,4484,130,0,11036,2030,0,7338,0,4995,114,0,14477
2004,Uganda,Ikafe,1111,0,1802,0,1769,93,0,4775,1172,0,2185,0,1575,62,0,4994
2004,Uganda,Hoima,2730,0,2671,0,3039,245,0,8685,2829,0,3256,0,3192,166,0,9443
2004,Uganda,Adjumani,5316,0,11254,0,13082,741,0,30393,5746,0,12563,0,13197,614,0,32120
2004,Uruguay,Montevideo,0,0,5,0,22,5,0,32,0,0,10,0,61,4,0,75
2004,Uzbekistan,Termez,10,0,59,0,79,2,0,150,10,0,55,0,117,4,0,186
2004,Uzbekistan,Tashkent,1642,0,1341,0,2043,475,0,5501,1422,0,1237,0,1924,408,0,4991
2004,Uzbekistan,Syrdarya,1658,0,967,0,1519,461,0,4605,1412,0,824,0,1295,392,0,3923
2004,Uzbekistan,Surkhandarya,1562,0,912,0,1433,434,0,4341,1331,0,776,0,1220,370,0,3697
2004,Uzbekistan,Samarkand,870,0,512,0,802,243,0,2427,742,0,435,0,683,205,0,2065
2004,Uzbekistan,Kashkadarya,784,0,458,0,719,218,0,2179,668,0,390,0,612,186,0,1856
2004,Uzbekistan,Fergana,887,0,518,0,813,247,0,2465,756,0,441,0,693,210,0,2100
2004,Venezuela (Bolivarian Republic of),Zulia,50,0,112,0,141,9,0,312,56,0,108,0,158,15,0,337
2004,Venezuela (Bolivarian Republic of),Tachira,112,0,253,0,348,28,0,741,130,0,261,0,404,45,0,840
2004,Venezuela (Bolivarian Republic of),Caracas,16,0,57,0,159,9,0,241,23,0,48,0,264,11,0,346
2004,Venezuela (Bolivarian Republic of),Apure,134,0,319,0,375,22,0,850,157,0,338,0,417,34,0,946
2004,Viet Nam,Thu Duc (Ho Chi Minh City),0,0,0,0,0,0,39,39,0,0,0,0,0,0,39,39
2004,Viet Nam,Cu Chi (Ho Chi Minh City),0,0,0,0,0,0,129,129,0,0,0,0,0,0,104,104
2004,Viet Nam,B Phuoc,0,0,0,0,0,0,130,130,0,0,0,0,0,0,131,131
2004,Viet Nam,B Duong,0,0,0,0,0,0,930,930,0,0,0,0,0,0,858,858
2004,Yemen,Taiz,59,0,358,0,690,185,0,1292,56,0,680,0,650,180,0,1566
2004,Yemen,Shabwa,15,0,57,0,151,6,0,229,12,0,44,0,171,2,0,229
2004,Yemen,Sana'a/Aden,52,0,238,0,213,17,0,520,53,0,355,0,267,17,0,692
2004,Yemen,Sana'a,455,0,3461,0,5467,687,0,10070,412,0,3449,0,4942,564,0,9367
2004,Yemen,Sada'A,2,0,16,0,25,4,0,47,3,0,30,0,55,5,0,93
2004,Yemen,Rida'a,29,0,35,0,56,5,0,125,25,0,65,0,62,5,0,157
2004,Yemen,Mukalla,41,0,162,0,165,33,0,401,39,0,152,0,66,34,0,291
2004,Yemen,Mahra,32,0,123,0,157,7,0,319,32,0,140,0,182,7,0,361
2004,Yemen,Hodeidah,20,0,81,0,109,24,0,234,19,0,110,0,104,19,0,252
2004,Yemen,Dhamar,18,0,37,0,78,2,0,135,17,0,32,0,47,4,0,100
2004,Yemen,Al-Kharaz,817,0,2213,0,2259,59,0,5348,845,0,2383,0,1594,42,0,4864
2004,Yemen,Al-Baida,8,0,67,0,86,7,0,168,14,0,46,0,92,2,0,154
2004,Yemen,Aden,296,0,2678,0,3124,371,0,6469,333,0,2749,0,3424,304,0,6810
2004,Zambia,Nangweshi,2560,0,4135,0,3374,194,0,10263,2980,0,3267,0,4080,219,0,10546
2004,Zambia,Mwange,2329,0,4613,0,5307,309,0,12558,2303,0,4432,0,4889,265,0,11889
2004,Zambia,Meheba,1787,0,3776,0,3496,614,0,9673,1832,0,3339,0,3725,778,0,9674
2004,Zambia,Mayukwayuka,985,0,1256,0,1291,270,0,3802,879,0,1052,0,1339,171,0,3441
2004,Zambia,Kala,2229,0,4057,0,4512,203,0,11001,2301,0,4020,0,4623,185,0,11129
2004,Zimbabwe,Tongogara,83,0,142,0,253,0,0,478,121,0,293,0,676,0,0,1090
2005,Afghanistan,Zabul,307,0,277,0,306,10,0,900,299,0,301,0,298,27,0,925
2005,Afghanistan,Wardak,339,0,440,0,461,19,0,1259,339,0,403,0,675,47,0,1464
2005,Afghanistan,Various,33694,0,239515,0,379400,50022,2155711,2858342,34698,0,261416,0,478097,44550,2237044,3055805
2005,Afghanistan,Uruzgan,617,0,462,0,569,27,0,1675,542,0,589,0,654,46,0,1831
2005,Afghanistan,Takhar,733,0,659,0,911,40,0,2343,748,0,762,0,1214,88,0,2812
2005,Afghanistan,Sari Pul,466,0,543,0,692,43,0,1744,492,0,550,0,853,74,0,1969
2005,Afghanistan,Samangan,302,0,353,0,431,24,0,1110,306,0,372,0,447,38,0,1163
2005,Afghanistan,Parwan,903,0,1203,0,1278,52,0,3436,1027,0,1293,0,1699,83,0,4102
2005,Afghanistan,Panjsher,21,0,20,0,24,2,0,67,19,0,20,0,60,4,0,103
2005,Afghanistan,Paktya,5848,0,7289,0,8297,311,0,21745,6234,0,7671,0,6940,630,0,21475
2005,Afghanistan,Paktika,431,0,455,0,500,22,0,1408,449,0,518,0,499,36,0,1502
2005,Afghanistan,Nuristan,6,0,5,0,6,0,0,17,8,0,5,0,6,0,0,19
2005,Afghanistan,Nimroz,574,0,696,0,716,33,0,2019,576,0,734,0,657,75,0,2042
2005,Afghanistan,Nangarhar,9374,0,10549,0,10952,534,0,31409,9583,0,10728,0,10131,801,0,31243
2005,Afghanistan,Logar,2920,0,3327,0,3769,170,0,10186,2789,0,3445,0,3447,291,0,9972
2005,Afghanistan,Laghman,1267,0,1321,0,1323,55,0,3966,1236,0,1325,0,1363,82,0,4006
2005,Afghanistan,Kunduz,5005,0,5031,0,5911,317,0,16264,5132,0,5339,0,5733,465,0,16669
2005,Afghanistan,Kunar,2856,0,3410,0,3322,162,0,9750,3012,0,3523,0,3089,221,0,9845
2005,Afghanistan,Khost,8677,0,9330,0,11139,462,0,29608,9096,0,10267,0,9017,815,0,29195
2005,Afghanistan,Kapisa,271,0,331,0,354,10,0,966,305,0,415,0,652,31,0,1403
2005,Afghanistan,Kandahar,2073,0,2169,0,2351,123,0,6716,2125,0,2220,0,2134,176,0,6655
2005,Afghanistan,Kabul,9416,0,13882,0,15906,758,3,39965,9786,0,14095,0,14948,1110,18,39957
2005,Afghanistan,Jawzjan,1932,0,2505,0,3873,275,0,8585,2032,0,2505,0,3539,333,0,8409
2005,Afghanistan,Hirat,1482,0,2931,0,3289,175,10,7887,1553,0,3047,0,4101,234,15,8950
2005,Afghanistan,Hilmand,1351,0,1344,0,1450,67,0,4212,1378,0,1417,0,1365,126,0,4286
2005,Afghanistan,Ghor,24,0,36,0,51,7,0,118,39,0,55,0,242,13,0,349
2005,Afghanistan,Ghazni,7487,0,6002,0,6682,270,0,20441,7975,0,6688,0,6489,450,0,21602
2005,Afghanistan,Faryab,565,0,721,0,1102,74,0,2462,588,0,714,0,1912,90,0,3304
2005,Afghanistan,Farah,1584,0,1884,0,1833,71,0,5372,1631,0,1944,0,1670,136,0,5381
2005,Afghanistan,Bamyan,136,0,214,0,267,20,0,637,140,0,259,0,365,36,0,800
2005,Afghanistan,Balkh,1185,0,1649,0,2078,119,0,5031,1285,0,1738,0,2131,183,0,5337
2005,Afghanistan,Baghlan,3332,0,3642,0,4246,204,0,11424,3422,0,3752,0,4115,352,0,11641
2005,Afghanistan,Badghis,122,0,95,0,154,10,0,381,132,0,144,0,316,10,0,602
2005,Afghanistan,Badakhshan,86,0,85,0,108,4,0,283,88,0,112,0,342,8,0,550
2005,Angola,Viana,433,0,1874,0,1526,40,0,3873,439,0,1839,0,895,35,0,3208
2005,Angola,Sungi,5,0,51,0,100,2,0,158,10,0,49,0,65,5,0,129
2005,Angola,Moxico,219,0,734,0,427,25,0,1405,226,0,711,0,139,15,0,1091
2005,Angola,Malange,53,0,153,0,237,4,0,447,40,0,177,0,135,10,0,362
2005,Angola,Lunda Sul,53,0,167,0,208,2,0,430,9,0,52,0,317,2,0,380
2005,Angola,Lunda Norte,10,0,17,0,201,12,0,240,14,0,28,0,192,7,0,241
2005,Angola,Luanda,39,0,128,0,434,2,0,603,51,0,165,0,657,13,0,886
2005,Angola,Kwanza Sul,0,0,22,0,16,0,0,38,0,0,17,0,26,0,0,43
2005,Angola,Kwanza Norte,0,0,8,0,5,0,0,13,1,0,10,0,11,0,0,22
2005,Angola,Keutepwe,43,0,87,0,117,13,0,260,35,0,70,0,94,11,0,210
2005,Angola,Kamatende,93,0,186,0,162,18,0,459,94,0,187,0,82,8,0,371
2005,Albania,Tirana,2,0,9,0,12,0,0,23,4,0,8,0,23,0,0,35
2005,Albania,Peshkopi,0,0,0,0,1,0,0,1,0,0,0,0,0,0,0,0
2005,Albania,Lac,0,0,0,0,1,1,0,2,0,0,0,0,0,1,0,1
2005,Albania,Babrru (Tirana),0,0,3,0,2,0,0,5,2,0,7,0,15,0,0,24
2005,Argentina,Buenos Aires,45,0,168,0,1117,41,0,1371,61,0,199,0,2188,80,0,2528
2005,Armenia,Yerevan,3,0,36,0,75,25,29038,29177,6,0,34,0,107,11,21906,22064
2005,Armenia,Vayots Dzor,0,0,0,0,0,0,2232,2232,0,0,0,0,0,0,1684,1684
2005,Armenia,Tavush,0,0,0,0,0,0,5662,5662,0,0,0,0,0,0,4271,4271
2005,Armenia,Syunik (rural),0,0,0,0,45,3,0,48,0,0,0,0,48,16,0,64
2005,Armenia,Sisian,0,0,0,0,1,0,0,1,0,0,0,0,0,2,0,2
2005,Armenia,Shirak,0,0,0,0,0,0,2159,2159,0,0,0,0,0,0,1629,1629
2005,Armenia,Meghri,0,0,0,0,4,0,0,4,0,0,0,0,5,0,0,5
2005,Armenia,Lori,0,0,0,0,0,0,9451,9451,0,0,0,0,0,0,7130,7130
2005,Armenia,Kotayk,0,0,0,0,0,0,17109,17109,0,0,0,0,0,0,12906,12906
2005,Armenia,Kapan,0,0,1,0,29,8,0,38,0,0,0,0,26,13,0,39
2005,Armenia,Goris,0,0,0,0,24,4,0,28,0,0,0,0,28,5,0,33
2005,Armenia,Gegharkunik,0,0,0,0,0,0,14947,14947,0,0,0,0,0,0,11275,11275
2005,Armenia,Armavir,0,0,0,0,0,0,13709,13709,0,0,0,0,0,0,10342,10342
2005,Armenia,Ararat,0,0,0,0,0,0,26491,26491,0,0,0,0,0,0,19984,19984
2005,Armenia,Aragatsotn,0,0,0,0,0,0,4068,4068,0,0,0,0,0,0,3068,3068
2005,Azerbaijan,Yevlah,0,0,0,0,0,0,6432,6432,0,0,0,0,0,0,5214,5214
2005,Azerbaijan,Tartar,0,0,0,0,0,0,8059,8059,0,0,0,0,0,0,7457,7457
2005,Azerbaijan,Sumgait,0,0,0,0,0,0,22752,22752,0,0,0,0,0,0,21332,21332
2005,Azerbaijan,Sabirabad,0,0,0,0,0,0,9293,9293,0,0,0,0,0,0,7986,7986
2005,Azerbaijan,Saatli,0,0,0,0,0,0,6177,6177,0,0,0,0,0,0,4912,4912
2005,Azerbaijan,Naftalan,0,0,0,0,0,0,1513,1513,0,0,0,0,0,0,1455,1455
2005,Azerbaijan,Mingachevir,0,0,0,0,0,0,10215,10215,0,0,0,0,0,0,8821,8821
2005,Azerbaijan,Lachin,0,0,0,0,0,0,7140,7140,0,0,0,0,0,0,6869,6869
2005,Azerbaijan,Imishli,0,0,0,0,0,0,7592,7592,0,0,0,0,0,0,5746,5746
2005,Azerbaijan,Ganja,0,0,0,0,0,0,8910,8910,0,0,0,0,0,0,6648,6648
2005,Azerbaijan,Fizuli,0,0,0,0,0,0,27769,27769,0,0,0,0,0,0,26579,26579
2005,Azerbaijan,Bilasuvar,0,0,0,0,0,0,6582,6582,0,0,0,0,0,0,6032,6032
2005,Azerbaijan,Beylagan,0,0,0,0,0,0,8754,8754,0,0,0,0,0,0,7453,7453
2005,Azerbaijan,Barda,0,0,0,0,0,0,25313,25313,0,0,0,0,0,0,22671,22671
2005,Azerbaijan,Baku,241,0,457,0,963,27,84606,86294,283,0,473,0,1032,22,76951,78761
2005,Azerbaijan,Ali-Bayramli,0,0,0,0,0,0,2392,2392,0,0,0,0,0,0,2059,2059
2005,Azerbaijan,Agjabadi,0,0,0,0,0,0,1617,1617,0,0,0,0,0,0,1493,1493
2005,Azerbaijan,Agdam,0,0,0,0,0,0,13650,13650,0,0,0,0,0,0,11625,11625
2005,Azerbaijan,Agcabedi,0,0,0,0,0,0,7987,7987,0,0,0,0,0,0,7334,7334
2005,Burundi,Gihinga,209,0,534,0,418,23,0,1184,162,0,534,0,417,23,0,1136
2005,Burundi,Gasorwe,894,0,1582,0,1100,69,0,3645,687,0,1582,0,894,69,0,3232
2005,Burundi,Bujumbura,1,0,1,0,3,0,0,5,1,0,1,0,9,0,0,11
2005,Benin,Kpomasse,98,0,116,0,214,5,0,433,119,0,128,0,324,0,0,571
2005,Benin,Cotonou,475,0,1102,0,2633,85,0,4295,461,0,1064,0,3954,51,0,5530
2005,Benin,Come,88,0,177,0,271,34,0,570,70,0,184,0,308,9,0,571
2005,Benin,Agame,581,0,1021,0,2025,104,0,3731,589,0,1098,0,3799,31,0,5517
2005,Burkina Faso,Ouagadougou-Bobo,21,0,107,0,104,0,0,232,14,0,84,0,180,1,0,279
2005,Burkina Faso,Ouagadougou,20,0,104,0,135,5,0,264,11,0,41,0,333,1,0,386
2005,Bangladesh,Nayapara (Cox Bazaar),1224,0,2443,0,2546,147,0,6360,1320,0,2288,0,2377,127,0,6112
2005,Bangladesh,Kutapalong (Cox Bazaar),771,0,1644,0,1732,99,0,4246,781,0,1661,0,1683,96,0,4221
2005,Bangladesh,Dhaka,10,0,33,0,49,1,0,93,4,0,24,0,95,1,0,124
2005,Bulgaria,Sofia,3,0,8,0,49,3,0,63,3,0,188,0,565,3,0,759
2005,Bahrain,Manama,0,0,1,0,4,0,0,5,0,0,4,0,6,0,0,10
2005,Bosnia and Herzegovina,Brcko,23,0,125,0,529,146,0,823,24,0,128,0,546,109,0,807
2005,Belarus,Vitebsk Region,0,0,6,0,15,0,0,21,2,0,10,0,29,0,0,41
2005,Belarus,Mogilev Region,1,0,9,0,10,0,0,20,0,0,5,0,23,0,0,28
2005,Belarus,Minsk Region,3,0,28,0,38,5,0,74,3,0,27,0,54,1,0,85
2005,Belarus,Minsk,13,0,64,0,123,7,0,207,6,0,71,0,270,6,0,353
2005,Belarus,Grodno Region,1,0,3,0,13,1,0,18,0,0,3,0,18,1,0,22
2005,Belarus,Gomel Region,1,0,14,0,23,8,0,46,3,0,10,0,40,4,0,57
2005,Belarus,Brest Region,0,0,0,0,1,0,0,1,0,0,2,0,6,0,0,8
2005,Belize,Belmopan,0,0,163,0,84,27,0,274,0,0,186,0,134,30,0,350
2005,Belize,Belize City,0,0,0,0,2,0,0,2,0,0,0,0,12,0,0,12
2005,Bolivia (Plurinational State of),Tarija,0,0,0,0,1,0,0,1,0,0,0,0,1,0,0,1
2005,Bolivia (Plurinational State of),Sucre,0,0,0,0,0,0,0,0,0,0,0,0,1,0,0,1
2005,Bolivia (Plurinational State of),Santa Cruz,1,0,0,0,7,0,0,8,0,0,2,0,15,0,0,17
2005,Bolivia (Plurinational State of),La Paz,6,0,31,0,101,4,0,142,9,0,36,0,131,7,0,183
2005,Bolivia (Plurinational State of),Cochabamba,0,0,1,0,3,0,0,4,0,0,1,0,6,0,0,7
2005,Bolivia (Plurinational State of),Beni,0,0,0,0,0,0,0,0,0,0,0,0,1,0,0,1
2005,Brazil,Tocantins,0,0,0,0,0,0,0,0,0,0,0,0,1,0,0,1
2005,Brazil,São Paulo,0,0,50,0,257,5,1,313,1,0,57,0,862,8,0,928
2005,Brazil,Santa Catarina,0,0,1,0,3,0,0,4,0,0,1,0,10,0,0,11
2005,Brazil,Rio Grande do Sul,0,0,2,0,12,0,1,15,0,0,3,0,41,0,0,44
2005,Brazil,Rio Grande do Norte,0,0,1,0,4,0,0,5,0,0,1,0,14,0,0,15
2005,Brazil,Rio de Janeiro,1,0,81,0,416,9,0,507,1,0,92,0,1393,13,0,1499
2005,Brazil,Pernambuco,0,0,0,0,1,0,0,1,0,0,0,0,3,0,1,4
2005,Brazil,Paraná,0,0,1,0,3,0,0,4,0,0,1,0,9,0,0,10
2005,Brazil,Pará,0,0,0,0,0,0,0,0,0,0,0,0,1,0,0,1
2005,Brazil,Minas Gerais,0,0,1,0,2,0,0,3,0,0,1,0,9,0,0,10
2005,Brazil,Mato Grosso do Sul,0,0,0,0,0,0,1,1,0,0,0,0,1,0,0,1
2005,Brazil,Mato Grosso,0,0,0,0,0,0,0,0,0,0,0,0,1,0,0,1
2005,Brazil,Maranhão,0,0,0,0,1,0,0,1,0,0,0,0,3,0,0,3
2005,Brazil,Espírito Santo,0,0,0,0,0,0,0,0,0,0,0,0,1,0,0,1
2005,Brazil,Distrito Federal,0,0,1,0,6,0,0,7,0,0,1,0,22,0,0,23
2005,Brazil,Ceará,0,0,0,0,1,0,0,1,0,0,0,0,2,0,0,2
2005,Brazil,Bahia,0,0,0,0,2,0,0,2,0,0,0,0,7,0,0,7
2005,Brazil,Amazonas,0,0,1,0,6,0,0,7,0,0,1,0,22,0,0,23
2005,Brazil,Alagoas,0,0,0,0,0,0,1,1,0,0,0,0,1,0,0,1
2005,Brazil,Acre,0,0,0,0,0,0,0,0,0,0,0,0,1,0,0,1
2005,Botswana,Gaborone,0,0,16,0,36,0,0,52,0,0,7,0,54,0,0,61
2005,Botswana,Dukwi,152,0,372,0,471,21,0,1016,192,0,339,0,1410,38,0,1979
2005,Central African Rep.,Molangue,104,0,163,0,134,3,0,404,107,0,185,0,237,4,0,533
2005,Central African Rep.,Mboki,1379,0,3075,0,4871,199,0,9524,1379,0,3154,0,4921,225,0,9679
2005,Central African Rep.,Kbando,15,0,32,0,26,0,0,73,22,0,32,0,32,0,0,86
2005,Central African Rep.,Bangui,549,0,830,0,1628,18,0,3025,582,0,924,0,1674,25,0,3205
2005,Chile,Santiago,13,0,87,0,238,6,0,344,19,0,101,0,446,3,0,569
2005,China,Yunnan,1439,0,6127,0,12499,1756,0,21821,2624,0,6320,0,12347,1378,0,22669
2005,China,Wenchang,0,0,0,0,0,0,0,0,0,0,0,0,1,0,0,1
2005,China,Shanghai,0,0,0,0,0,0,0,0,0,0,0,0,1,0,0,1
2005,China,Ruili,0,0,0,0,0,0,0,0,0,0,0,0,1,0,0,1
2005,China,Nanjing,0,0,0,0,0,0,0,0,0,0,0,0,2,0,0,2
2005,China,Jiangxi,54,0,57,0,556,157,0,824,61,0,84,0,610,136,0,891
2005,China,Hangzhou,0,0,0,0,0,0,0,0,0,0,0,0,1,0,0,1
2005,China,Hainan,933,0,2864,0,8894,2176,0,14867,1213,0,3820,0,9570,2005,0,16608
2005,China,Guangzhou,0,0,0,0,0,0,0,0,0,0,0,0,1,0,0,1
2005,China,Guangxi,2983,0,11142,0,31724,7454,0,53303,3838,0,12571,0,35313,7243,0,58965
2005,China,Guangdong,2071,0,6502,0,23312,7999,0,39884,2459,0,7766,0,25284,8145,0,43654
2005,China,Fujian,900,0,3627,0,7985,699,0,13211,1175,0,3902,0,8408,713,0,14198
2005,China,Beijing,7,0,12,0,34,0,0,53,8,0,26,0,135,0,0,169
2005,China,Beihai,0,0,0,0,0,0,0,0,0,0,0,0,0,1,0,1
2005,Côte d'Ivoire,Tabou TC,247,0,663,0,806,41,0,1757,273,0,635,0,654,40,0,1602
2005,Côte d'Ivoire,Tabou,2288,0,3611,0,6061,253,0,12213,2318,0,3051,0,4495,193,0,10057
2005,Côte d'Ivoire,Nicla,492,0,997,0,1662,98,0,3249,503,0,936,0,1317,60,0,2816
2005,Côte d'Ivoire,Guiglo,392,0,729,0,1516,91,0,2728,401,0,604,0,971,110,0,2086
2005,Côte d'Ivoire,Abidjan,306,0,886,0,2156,54,19697,23099,236,0,1143,0,2715,66,18342,22502
2005,Cameroon,Banyo,602,0,2257,0,2161,88,0,5108,678,0,2131,0,1626,163,0,4598
2005,Dem. Rep. of the Congo,Zomfi,2,0,5,0,4,0,0,11,3,0,3,0,3,0,0,9
2005,Dem. Rep. of the Congo,Tshimbumbulu,19,0,27,0,42,12,0,100,10,0,34,0,41,13,0,98
2005,Dem. Rep. of the Congo,Tshifwameso,4,0,19,0,22,0,0,45,6,0,20,0,13,0,0,39
2005,Dem. Rep. of the Congo,Tshabobo,60,0,56,0,112,2,0,230,56,0,47,0,138,4,0,245
2005,Dem. Rep. of the Congo,Sadi/Zulu,1,0,8,0,2,0,0,11,1,0,4,0,11,0,0,16
2005,Dem. Rep. of the Congo,Nkondo,42,0,116,0,146,17,0,321,42,0,144,0,92,5,0,283
2005,Dem. Rep. of the Congo,Napassa,14,0,24,0,24,1,0,63,6,0,25,0,7,0,0,38
2005,Dem. Rep. of the Congo,Mbujimayi,1,0,3,0,5,0,0,9,1,0,6,0,13,0,0,20
2005,Dem. Rep. of the Congo,Lusuku,29,0,38,0,89,6,0,162,36,0,32,0,76,1,0,145
2005,Dem. Rep. of the Congo,Lubumbashi,26,0,41,0,63,7,0,137,25,0,48,0,50,2,0,125
2005,Dem. Rep. of the Congo,Kulindji,35,0,98,0,77,16,0,226,21,0,108,0,16,3,0,148
2005,Dem. Rep. of the Congo,Kisenge,11,0,51,0,51,5,0,118,14,0,44,0,57,9,0,124
2005,Dem. Rep. of the Congo,Kinshasa/Lubumbashi,0,0,0,0,0,0,30,30,0,0,0,0,0,0,108,108
2005,Dem. Rep. of the Congo,Kinshasa,91,0,660,0,591,79,0,1421,119,0,599,0,782,135,0,1635
2005,Dem. Rep. of the Congo,Kinsalulu,5,0,21,0,29,2,0,57,7,0,20,0,28,6,0,61
2005,Dem. Rep. of the Congo,Kinsafu,3,0,17,0,15,3,0,38,5,0,12,0,20,1,0,38
2005,Dem. Rep. of the Congo,Kimpindi,3,0,13,0,6,0,0,22,4,0,8,0,14,0,0,26
2005,Dem. Rep. of the Congo,Kimfwakata,4,0,14,0,15,1,0,34,4,0,15,0,17,2,0,38
2005,Dem. Rep. of the Congo,Kimaza,57,0,90,0,93,0,0,240,76,0,103,0,243,8,0,430
2005,Dem. Rep. of the Congo,Kilueka,107,0,254,0,355,34,0,750,93,0,322,0,271,28,0,714
2005,Dem. Rep. of the Congo,Katsha,60,0,50,0,119,1,0,230,50,0,45,0,156,6,0,257
2005,Dem. Rep. of the Congo,Ingbokolo,184,0,264,0,607,25,0,1080,185,0,216,0,649,33,0,1083
2005,Dem. Rep. of the Congo,Goma/Bukavu,25,0,57,0,117,3,0,202,41,0,73,0,98,4,0,216
2005,Dem. Rep. of the Congo,Dungu (Kpezu),26,0,31,0,57,2,0,116,25,0,35,0,73,9,0,142
2005,Dem. Rep. of the Congo,Dungu (Kaka2),42,0,75,0,124,19,0,260,43,0,70,0,143,27,0,283
2005,Dem. Rep. of the Congo,Dungu (Kaka1),13,0,30,0,36,2,0,81,21,0,18,0,32,2,0,73
2005,Dem. Rep. of the Congo,Dungu (Centre),7,0,11,0,28,26,0,72,2,0,1,0,22,6,0,31
2005,Dem. Rep. of the Congo,Doruma-Centre,28,0,46,0,90,42,0,206,30,0,27,0,104,47,0,208
2005,Dem. Rep. of the Congo,Doruma-Bangalu,4,0,22,0,52,22,0,100,1,0,31,0,90,23,0,145
2005,Dem. Rep. of the Congo,Doruma-Bangadi,13,0,15,0,38,2,0,68,2,0,8,0,43,3,0,56
2005,Dem. Rep. of the Congo,Doruma (Mandofi),40,0,98,0,211,38,0,387,67,0,109,0,202,38,0,416
2005,Dem. Rep. of the Congo,Divuma,11,0,46,0,41,6,0,104,18,0,53,0,46,8,0,125
2005,Dem. Rep. of the Congo,Boga,177,0,465,0,410,77,0,1129,146,0,342,0,355,44,0,887
2005,Dem. Rep. of the Congo,Biringi (Biringi),31,0,31,0,53,5,0,120,31,0,50,0,45,4,0,130
2005,Dem. Rep. of the Congo,Biringi (Ayamba),18,0,35,0,42,5,0,100,12,0,33,0,42,1,0,88
2005,Dem. Rep. of the Congo,Bas-Fleuve,107,0,280,0,307,15,0,709,116,0,219,0,345,36,0,716
2005,Dem. Rep. of the Congo,Bas Congo,4636,0,8872,0,13491,1734,0,28733,4661,0,9279,0,10499,1327,0,25766
2005,Dem. Rep. of the Congo,Aru-Centre,13,0,8,0,30,0,0,51,10,0,9,0,16,1,0,36
2005,Dem. Rep. of the Congo,Ariwara,67,0,157,0,248,65,0,537,101,0,210,0,290,97,0,698
2005,Dem. Rep. of the Congo,Aba (Rudu2),184,0,490,0,756,164,0,1594,273,0,674,0,614,151,0,1712
2005,Dem. Rep. of the Congo,Aba (Rudu1),79,0,249,0,361,64,0,753,85,0,256,0,305,48,0,694
2005,Dem. Rep. of the Congo,Aba,4,0,28,0,97,43,0,172,39,0,16,0,93,40,0,188
2005,Congo,Tchitanzi,16,0,49,0,86,6,0,157,33,0,77,0,110,5,0,225
2005,Congo,Tchiamba-Nzassi,48,0,96,0,116,3,0,263,47,0,93,0,142,2,0,284
2005,Congo,Sangha,20,0,191,0,232,1,0,444,22,0,194,0,321,2,0,539
2005,Congo,Pointe-Noire,15,0,42,0,121,5,0,183,18,0,67,0,145,47,0,277
2005,Congo,Oyo,12,0,8,0,20,0,0,40,6,0,14,0,29,0,0,49
2005,Congo,Ollombo,0,0,1,0,1,0,0,2,0,0,3,0,2,0,0,5
2005,Congo,Ngo,12,0,12,0,23,0,0,47,15,0,12,0,38,0,0,65
2005,Congo,Ndjoundou/Liranga,250,0,687,0,688,37,0,1662,344,0,587,0,612,44,0,1587
2005,Congo,Mpouya,2,0,1,0,0,0,0,3,0,0,0,0,1,0,0,1
2005,Congo,Malolo/Loudima,22,0,99,0,111,5,0,237,18,0,77,0,132,2,0,229
2005,Congo,Loukolela,444,0,434,0,619,32,0,1529,312,0,531,0,884,21,0,1748
2005,Congo,Kondi Mbaka,36,0,114,0,229,5,0,384,59,0,182,0,202,4,0,447
2005,Congo,Komi,9,0,39,0,54,2,0,104,13,0,36,0,63,5,0,117
2005,Congo,Kintele,9,0,76,0,336,2,0,423,14,0,197,0,439,15,0,665
2005,Congo,Impfondo,3187,0,7750,0,7396,706,0,19039,3069,0,8017,0,6462,597,0,18145
2005,Congo,Gamboma,1,0,1,0,3,0,0,5,0,0,2,0,7,0,0,9
2005,Congo,Dolisie,4,0,13,0,24,0,0,41,5,0,14,0,29,0,0,48
2005,Congo,Djambala,7,0,4,0,9,0,0,20,7,0,5,0,14,0,0,26
2005,Congo,Brazzaville,53,0,659,0,1011,7,0,1730,192,0,675,0,1201,51,0,2119
2005,Congo,Betou,1342,0,2254,0,2777,244,0,6617,1473,0,2298,0,2635,154,0,6560
2005,Colombia,Tuluá,0,0,0,0,0,0,0,0,0,0,0,0,1,0,0,1
2005,Colombia,San Andrés,0,0,0,0,2,0,0,2,0,0,1,0,1,0,0,2
2005,Colombia,Medellín,0,0,0,0,0,1,0,1,0,0,0,0,2,0,0,2
2005,Colombia,Maicao,0,0,0,0,1,0,0,1,0,0,0,0,0,0,0,0
2005,Colombia,Ibagué,0,0,0,0,1,0,0,1,0,0,0,0,2,0,0,2
2005,Colombia,Duitama,0,0,0,0,3,1,0,4,0,0,1,0,1,0,0,2
2005,Colombia,Cúcuta,1,0,0,0,1,0,0,2,1,0,1,0,3,0,0,5
2005,Colombia,Charalá,0,0,0,0,0,0,0,0,0,0,0,0,0,1,0,1
2005,Colombia,Cartagena,0,0,0,0,0,0,0,0,0,0,0,0,8,0,0,8
2005,Colombia,Cali,0,0,0,0,1,0,0,1,0,0,0,0,1,2,0,3
2005,Colombia,Buenaventura,1,0,2,0,2,0,0,5,0,0,6,0,2,0,0,8
2005,Colombia,Bogotá,3,0,9,0,32,6,0,50,4,0,9,0,75,7,0,95
2005,Colombia,Barranquilla,0,0,0,0,0,0,0,0,0,0,0,0,1,0,0,1
2005,Cuba,P.del Río,0,0,0,0,0,0,0,0,0,0,0,0,2,0,0,2
2005,Cuba,Matanzas,0,0,0,0,0,0,0,0,0,0,0,0,1,0,0,1
2005,Cuba,Havana,0,0,2,0,15,0,0,17,1,0,3,0,23,1,0,28
2005,Cuba,Guantánamo,0,0,0,0,0,0,0,0,0,0,0,0,1,0,0,1
2005,Czech Rep.,Zbysov,0,0,0,0,0,0,40,40,0,0,0,0,0,0,30,30
2005,Czech Rep.,Zastavka u Brna,0,0,0,0,0,0,47,47,0,0,0,0,0,0,43,43
2005,Czech Rep.,Zastavka,0,0,0,0,0,0,18,18,0,0,0,0,0,0,23,23
2005,Czech Rep.,Vysni Lhoty,0,0,0,0,0,0,29,29,0,0,0,0,0,0,119,119
2005,Czech Rep.,Straz p. Ralskem,0,0,0,0,0,0,22,22,0,0,0,0,0,0,41,41
2005,Czech Rep.,Straz,0,0,0,0,0,0,7,7,0,0,0,0,0,0,16,16
2005,Czech Rep.,Sec,0,0,0,0,0,0,12,12,0,0,0,0,0,0,26,26
2005,Czech Rep.,Predlice,0,0,0,0,0,0,6,6,0,0,0,0,0,0,15,15
2005,Czech Rep.,Praha Ruzyne Airport,0,0,0,0,0,0,0,0,0,0,0,0,0,0,16,16
2005,Czech Rep.,Kostelec nad Orlici,0,0,0,0,0,0,58,58,0,0,0,0,0,0,81,81
2005,Czech Rep.,Kasava,0,0,0,0,0,0,16,16,0,0,0,0,0,0,21,21
2005,Czech Rep.,Jaromer,0,0,0,0,0,0,8,8,0,0,0,0,0,0,15,15
2005,Czech Rep.,Hostka,0,0,0,0,0,0,8,8,0,0,0,0,0,0,7,7
2005,Czech Rep.,Havirov,0,0,0,0,0,0,27,27,0,0,0,0,0,0,27,27
2005,Czech Rep.,Bruntal,0,0,0,0,0,0,33,33,0,0,0,0,0,0,41,41
2005,Czech Rep.,Bela Jezova,0,0,0,0,0,0,57,57,0,0,0,0,0,0,97,97
2005,Djibouti,Djibouti,0,0,0,0,4,0,0,4,0,0,0,0,15,0,0,15
2005,Algeria,Alger,7,0,8,0,66,0,0,81,10,0,30,0,280,1,0,321
2005,Ecuador,Lago Agrio,11,0,21,0,84,28,0,144,8,0,26,0,116,11,0,161
2005,Egypt,Cairo,1568,0,2817,0,6502,149,77,11113,1828,0,3114,0,13855,118,19,18934
2005,Eritrea,Massawa,1,0,0,0,1,0,0,2,0,0,0,0,9,0,0,9
2005,Eritrea,Emkulu,356,0,555,0,675,30,0,1616,414,0,623,0,971,33,0,2041
2005,Eritrea,Elit,52,0,109,0,114,3,0,278,70,0,113,0,341,16,0,540
2005,Eritrea,Assab,0,0,0,0,0,0,0,0,0,0,0,0,1,0,0,1
2005,Eritrea,Asmara,109,0,195,0,405,30,0,739,126,0,185,0,451,23,0,785
2005,Eritrea,Afabet,0,0,0,0,0,0,0,0,0,0,0,0,29,0,0,29
2005,Estonia,Tallinn,0,0,0,0,0,0,0,0,0,0,0,0,6,0,0,6
2005,Estonia,Kohtla-Järve,0,0,0,0,0,0,0,0,0,0,0,0,1,0,0,1
2005,Estonia,Jõhvi,0,0,0,0,0,0,0,0,0,0,0,0,2,0,0,2
2005,Estonia,Illuka,0,0,0,0,0,0,0,0,0,0,0,0,6,0,0,6
2005,Ethiopia,Yarenja (Bamboudi),434,0,663,0,826,51,0,1974,442,0,775,0,694,0,83,1994
2005,Ethiopia,Shimelba (Shire/Shiraro),484,0,831,0,1514,144,0,2973,498,0,900,0,6117,0,195,7710
2005,Ethiopia,Sherkole (Assosa),1974,0,2517,0,3255,95,0,7841,2047,0,3144,0,3239,0,89,8519
2005,Ethiopia,Kebribeyah (Jijiga),1985,0,2717,0,3228,123,0,8053,2036,0,2829,0,2692,0,168,7725
2005,Ethiopia,Fugnido (Gambella),2856,0,4553,0,6356,174,0,13939,2931,0,5419,0,4227,0,75,12652
2005,Ethiopia,Dimma (Gambella),869,0,1109,0,1649,48,0,3675,899,0,1719,0,2306,0,24,4948
2005,Ethiopia,Bonga (Gambella),2502,0,2998,0,4102,109,0,9711,2730,0,3139,0,2851,0,71,8791
2005,Ethiopia,Addis Ababa,26,0,67,0,133,3,0,229,36,0,67,0,188,0,1,292
2005,Gabon,Voungou/Pont,4,0,8,0,14,2,0,28,8,0,11,0,13,0,0,32
2005,Gabon,Tchibanga,118,0,220,0,380,12,0,730,132,0,215,0,378,10,0,735
2005,Gabon,Sindara,0,0,0,0,0,0,0,0,0,0,0,0,1,0,0,1
2005,Gabon,Rinanzala,9,0,16,0,23,2,0,50,8,0,18,0,24,2,0,52
2005,Gabon,Port-Gentil,18,0,59,0,130,0,0,207,30,0,40,0,180,6,0,256
2005,Gabon,Pana/Dienga,0,0,0,0,0,0,0,0,0,0,0,0,5,0,0,5
2005,Gabon,Oyem,0,0,3,0,5,0,0,8,1,0,3,0,14,0,0,18
2005,Gabon,Okondja,5,0,2,0,3,0,0,10,2,0,2,0,38,0,0,42
2005,Gabon,Nzinga,4,0,7,0,7,2,0,20,3,0,6,0,5,0,0,14
2005,Gabon,Ntoum,0,0,1,0,2,0,0,3,1,0,0,0,1,0,0,2
2005,Gabon,Ngouoni,2,0,0,0,2,0,0,4,0,0,0,0,17,0,0,17
2005,Gabon,Ndendé,42,0,59,0,105,6,0,212,32,0,55,0,81,0,0,168
2005,Gabon,Mounana,8,0,27,0,30,1,0,66,12,0,17,0,88,1,0,118
2005,Gabon,Moulengui-Binza Frontiere,1,0,10,0,3,0,0,14,3,0,12,0,3,0,0,18
2005,Gabon,Moulengui-Binza Commune,33,0,56,0,76,13,0,178,36,0,76,0,57,6,0,175
2005,Gabon,Mouila,34,0,87,0,153,1,0,275,48,0,94,0,191,0,0,333
2005,Gabon,Moanda,122,0,250,0,430,25,0,827,95,0,247,0,507,21,0,870
2005,Gabon,Mitzic,0,0,0,0,1,0,0,1,0,0,0,0,3,0,0,3
2005,Gabon,Mékambo,0,0,0,0,0,0,0,0,0,0,0,0,2,1,0,3
2005,Gabon,Mayumba,1,0,6,0,13,0,0,20,2,0,1,0,17,0,0,20
2005,Gabon,Makokou,0,0,2,0,1,0,0,3,0,0,2,0,14,0,0,16
2005,Gabon,Mabanda,11,0,12,0,21,1,0,45,8,0,11,0,27,3,0,49
2005,Gabon,Libreville,216,0,474,0,819,22,0,1531,192,0,523,0,1644,47,0,2406
2005,Gabon,Lékindou,3,0,9,0,9,0,0,21,0,0,1,0,4,2,0,7
2005,Gabon,Lébamba,11,0,15,0,18,1,0,45,4,0,10,0,16,1,0,31
2005,Gabon,Lastourville,8,0,14,0,23,1,0,46,6,0,17,0,40,1,0,64
2005,Gabon,Lambarené,2,0,1,0,12,0,0,15,6,0,6,0,26,1,0,39
2005,Gabon,Koumou-Doussala,3,0,5,0,4,2,0,14,1,0,5,0,1,1,0,8
2005,Gabon,Koulamoutou,13,0,41,0,40,2,0,96,15,0,33,0,103,3,0,154
2005,Gabon,Gamba,13,0,25,0,71,0,0,109,16,0,13,0,85,0,0,114
2005,Gabon,Franceville,92,0,216,0,442,19,0,769,104,0,214,0,746,28,0,1092
2005,Gabon,Fougamou,1,0,0,0,2,0,0,3,0,0,1,0,4,0,0,5
2005,Gabon,Doussala,1,0,3,0,6,1,0,11,4,0,7,0,3,0,0,14
2005,Gabon,Dilemba,26,0,63,0,54,8,0,151,23,0,65,0,56,8,0,152
2005,Gabon,Boumango,6,0,12,0,6,2,0,26,3,0,5,0,10,1,0,19
2005,Gabon,Boué,0,0,1,0,1,0,0,2,0,0,0,0,1,0,0,1
2005,Gabon,Bongoville,1,0,1,0,1,0,0,3,0,0,0,0,1,0,0,1
2005,Gabon,Bitam,0,0,0,0,2,0,0,2,1,0,0,0,5,0,0,6
2005,Gabon,Bibora,4,0,5,0,11,2,0,22,2,0,6,0,7,2,0,17
2005,Gabon,Banda-Mamba,6,0,3,0,10,0,0,19,1,0,5,0,2,2,0,10
2005,Gabon,Bakoumba,12,0,20,0,22,1,0,55,8,0,13,0,9,0,0,30
2005,Gabon,Akiéni,0,0,2,0,2,0,0,4,3,0,1,0,8,0,0,12
2005,Georgia,Tbilisi,1,0,2,0,3,6,1,13,2,0,2,0,1,0,7,12
2005,Georgia,Pankisi,129,0,466,0,622,25,0,1242,177,0,525,0,507,29,0,1238
2005,Ghana,Volta,982,0,1793,0,3462,303,0,6540,1013,0,1788,0,2919,154,0,5874
2005,Ghana,Krisan,126,0,188,0,299,9,0,622,130,0,177,0,874,7,0,1188
2005,Ghana,Buduburam,2272,0,6686,0,10474,426,0,19858,2311,0,5938,0,11000,185,0,19434
2005,Ghana,Bole,0,0,0,0,0,0,0,0,0,0,0,0,1,0,0,1
2005,Ghana,Accra,247,0,669,0,1316,47,0,2279,296,0,716,0,2190,35,0,3237
2005,Guinea,Telikoro,262,0,701,0,968,122,0,2053,235,0,694,0,464,34,0,1427
2005,Guinea,Nzerekore Ville,2,0,19,0,17,0,0,38,3,0,34,0,20,0,0,57
2005,Guinea,Laine,1285,0,4354,0,4563,275,0,10477,1329,0,4189,0,3472,140,0,9130
2005,Guinea,Kountaya,561,0,1547,0,1981,221,0,4310,612,0,1488,0,1366,117,0,3583
2005,Guinea,Kouankan 2,228,0,742,0,572,51,0,1593,188,0,727,0,460,34,0,1409
2005,Guinea,Kouankan,1193,0,3476,0,3023,369,0,8061,1161,0,3654,0,1399,152,0,6366
2005,Guinea,Kola,416,0,1410,0,1351,74,0,3251,415,0,1495,0,999,62,0,2971
2005,Guinea,Conakry,259,0,1908,0,2922,57,0,5146,299,0,2109,0,3673,94,0,6175
2005,Guinea,Boreah,74,0,182,0,260,13,0,529,95,0,192,0,438,32,0,757
2005,Gambia,Banjul,0,0,0,0,0,0,4297,4297,0,0,0,0,0,0,3635,3635
2005,Guinea-Bissau,Jolmette,52,0,112,0,113,9,0,286,55,0,109,0,93,13,0,270
2005,Guinea-Bissau,Border area,634,0,1369,0,1381,104,0,3488,664,0,1326,0,1130,156,0,3276
2005,Guinea-Bissau,Bissau,34,0,66,0,98,3,0,201,36,0,72,0,145,8,0,261
2005,Guatemala,Guatemala City,0,0,1,0,195,27,0,223,1,0,3,0,140,27,0,171
2005,"China, Hong Kong SAR",Hong Kong,18,0,11,0,239,0,699,967,16,0,33,0,895,0,1120,2064
2005,Honduras,Trujillo,0,0,0,0,0,0,0,0,0,0,0,0,1,0,0,1
2005,Honduras,Tegucigalpa,0,0,1,0,2,0,0,3,0,0,2,0,16,1,0,19
2005,Honduras,San Pedro Sula,0,0,0,0,0,0,0,0,0,0,0,0,2,0,0,2
2005,Honduras,Puerto Cortes,0,0,0,0,0,0,0,0,0,0,0,0,4,0,0,4
2005,Honduras,"Ceiba, Santa Barbara",0,0,0,0,0,0,0,0,0,0,0,0,43,0,0,43
2005,Croatia,Sasna Greda,0,0,2,0,1,0,0,3,1,0,1,0,1,0,0,3
2005,Croatia,Jezevo,0,0,0,0,1,0,0,1,0,0,0,0,7,0,0,7
2005,Hungary,Győr/Nyirbátor,0,0,0,0,0,0,10,10,0,0,0,0,0,0,106,106
2005,Hungary,Debrecen,24,0,8,0,30,0,0,62,6,0,11,0,112,6,0,135
2005,Hungary,Bicske,1,0,6,0,22,8,0,37,2,0,9,0,68,5,0,84
2005,Hungary,Békéscsaba,1,0,6,0,15,0,0,22,0,0,2,0,56,2,0,60
2005,Indonesia,Tanjung Pinang,0,0,0,0,0,0,0,0,0,0,0,0,2,0,0,2
2005,Indonesia,Jakarta,7,0,16,0,26,1,0,50,11,0,17,0,89,0,0,117
2005,Indonesia,East Java & Mataram,6,0,12,0,30,1,0,49,11,0,19,0,130,0,0,160
2005,Indonesia,East Java & Jakarta,0,0,0,0,0,0,0,0,0,0,0,0,11,0,0,11
2005,Indonesia,East Java,1,0,0,0,0,0,0,1,0,0,0,0,3,0,0,3
2005,India,New Delhi,215,0,1559,0,3957,322,0,6053,258,0,1783,0,3244,321,0,5606
2005,Iran (Islamic Rep. of),Zanjan,1,0,4,0,4,0,0,9,1,0,5,0,10,1,0,17
2005,Iran (Islamic Rep. of),Zahedan,4,0,5,0,7,1,0,17,3,0,2,0,18,0,0,23
2005,Iran (Islamic Rep. of),West-Azerbaijan,71,0,284,0,302,18,0,675,89,0,320,0,658,36,0,1103
2005,Iran (Islamic Rep. of),Tehran,0,0,5,0,5,0,0,10,0,0,1,0,13,2,0,16
2005,Iran (Islamic Rep. of),Semnan,110,0,442,0,469,28,0,1049,138,0,497,0,1022,55,0,1712
2005,Iran (Islamic Rep. of),Mashad,4,0,20,0,15,0,0,39,6,0,7,0,12,0,0,25
2005,Iran (Islamic Rep. of),Markazi,156,0,622,0,661,39,0,1478,195,0,700,0,1439,78,0,2412
2005,Iran (Islamic Rep. of),Lorestan,37,0,150,0,159,9,0,355,47,0,168,0,346,19,0,580
2005,Iran (Islamic Rep. of),Kurdestan,3,0,14,0,14,1,0,32,4,0,15,0,31,2,0,52
2005,Iran (Islamic Rep. of),Khuzestan,10,0,42,0,45,3,0,100,13,0,47,0,97,5,0,162
2005,Iran (Islamic Rep. of),Khorasan,196,0,782,0,831,49,0,1858,245,0,880,0,1809,98,0,3032
2005,Iran (Islamic Rep. of),Kermanshah,9,0,38,0,40,2,0,89,12,0,43,0,88,5,0,148
2005,Iran (Islamic Rep. of),Kerman,510,0,2041,0,2168,128,0,4847,638,0,2296,0,4719,255,0,7908
2005,Iran (Islamic Rep. of),Fars,70,0,280,0,297,17,0,664,87,0,315,0,647,35,0,1084
2005,Iran (Islamic Rep. of),Bushehr,83,0,333,0,354,21,0,791,104,0,374,0,770,42,0,1290
2005,Iran (Islamic Rep. of),Ahwaz,1,0,0,0,4,1,0,6,0,0,0,0,4,0,0,4
2005,Iraq,Wassit,0,0,7,0,6,0,0,13,1,0,4,0,5,1,0,11
2005,Iraq,Tameem,0,0,2,0,4,0,0,6,1,0,2,0,3,1,0,7
2005,Iraq,Sulaymaniyah,125,0,1102,0,1566,148,0,2941,121,0,1315,0,1569,199,0,3204
2005,Iraq,Salah al-Din,1,0,7,0,15,1,0,24,1,0,11,0,13,0,0,25
2005,Iraq,Qadissiya,3,0,3,0,12,0,0,18,1,0,3,0,10,2,0,16
2005,Iraq,Ninewa,382,0,2006,0,2319,278,0,4985,437,0,2093,0,2053,237,0,4820
2005,Iraq,Missan,0,0,2,0,0,0,0,2,0,0,1,0,1,0,0,2
2005,Iraq,Kerbala,0,0,3,0,9,0,0,12,0,0,1,0,2,3,0,6
2005,Iraq,Erbil,16,0,296,0,417,27,0,756,13,0,259,0,525,33,0,830
2005,Iraq,Diyala,5,0,28,0,50,5,0,88,8,0,25,0,33,7,0,73
2005,Iraq,Dahuk,0,0,10,0,10,0,0,20,1,0,8,0,12,0,0,21
2005,Iraq,Basrah,0,0,2,0,4,0,0,6,0,0,1,0,7,0,0,8
2005,Iraq,Baghdad,585,0,3311,0,6393,870,0,11159,639,0,3405,0,6550,892,0,11486
2005,Iraq,Babylon,1,0,6,0,18,1,0,26,2,0,7,0,17,6,0,32
2005,Iraq,Anbar,17,0,38,0,58,6,0,119,7,0,36,0,151,6,0,200
2005,Jordan,Amman,533,0,1737,0,3916,273,1,6460,577,0,1964,0,8250,285,8,11084
2005,Kazakhstan,Almaty,86,0,95,0,180,15,0,376,103,0,106,0,294,5,0,508
2005,Kenya,Nairobi,647,0,3967,0,8664,191,0,13469,876,0,4803,0,13083,889,0,19651
2005,Kenya,Kakuma,6035,0,13678,0,17669,801,0,38183,6593,0,19788,0,29512,601,0,56494
2005,Kenya,Ifo (Dadaab),3316,0,7640,0,12347,598,0,23901,3501,0,8822,0,11533,698,0,24554
2005,Kenya,Hagadera (Dadaab),2902,0,7202,0,12339,620,0,23063,3121,0,7804,0,11557,759,0,23241
2005,Kenya,Dagahaley (Dadaab),2292,0,5474,0,8112,379,0,16257,2473,0,6046,0,7359,493,0,16371
2005,Kenya,Dadaab,840,0,2005,0,2203,158,0,5206,897,0,2273,0,3978,193,0,7341
2005,Kyrgyzstan,Osh region,8,0,17,0,45,5,0,75,11,0,18,0,52,7,0,88
2005,Kyrgyzstan,Osh,0,0,1,0,2,0,0,3,0,0,0,0,22,0,0,22
2005,Kyrgyzstan,Issyk-Kul region,1,0,2,0,4,0,0,7,0,0,1,0,4,0,0,5
2005,Kyrgyzstan,Djalal-Abad region,2,0,7,0,2,1,0,12,1,0,3,0,4,1,0,9
2005,Kyrgyzstan,Chui region,107,0,161,0,558,39,0,865,116,0,175,0,605,42,0,938
2005,Kyrgyzstan,Bishkek,30,0,110,0,277,22,0,439,30,0,133,0,419,15,0,597
2005,Kyrgyzstan,Batken region,2,0,3,0,8,1,0,14,2,0,4,0,15,1,0,22
2005,Cambodia,Phnom Penh,0,0,4,0,12,0,0,16,2,0,3,0,31,3,0,39
2005,Rep. of Korea,Seoul,6,0,2,0,120,12,0,140,5,0,3,0,436,4,0,448
2005,Kuwait,Kuwait City,2900,0,19220,0,26863,1796,0,50779,3351,0,19913,0,27144,1536,0,51944
2005,Liberia,Voa,83,0,295,0,377,26,0,781,113,0,405,0,502,28,0,1048
2005,Liberia,Samukai,70,0,155,0,179,8,0,412,92,0,127,0,292,7,0,518
2005,Liberia,Saclepea,72,0,182,0,175,28,0,457,103,0,158,0,171,37,0,469
2005,Liberia,Nimba,212,0,322,0,483,48,0,1065,228,0,372,0,507,52,0,1159
2005,Liberia,Mont Serrado County,7,0,29,0,23,0,0,59,6,0,22,0,92,0,0,120
2005,Liberia,Grand Gedeh,204,0,407,0,757,63,0,1431,204,0,521,0,781,89,0,1595
2005,Liberia,Bareken,24,0,70,0,80,11,0,185,38,0,85,0,86,6,0,215
2005,Liberia,Banjor,13,0,165,0,189,1,0,368,31,0,163,0,153,3,0,350
2005,Sri Lanka,Vavuniya,1272,0,5060,0,11395,1325,0,19052,1315,0,5284,0,10670,1370,0,18639
2005,Sri Lanka,Trincomalee,631,0,2535,0,5802,689,0,9657,653,0,2651,0,5425,711,0,9440
2005,Sri Lanka,Ratnapura,4,0,18,0,43,5,0,70,5,0,19,0,39,5,0,68
2005,Sri Lanka,Puttalam,2251,0,8537,0,17749,1841,0,30378,2310,0,8849,0,16720,1915,0,29794
2005,Sri Lanka,Polonnaruwa,91,0,367,0,846,101,0,1405,94,0,384,0,789,105,0,1372
2005,Sri Lanka,Mullaitivu,1811,0,7372,0,17212,2094,0,28489,1880,0,7725,0,16076,2160,0,27841
2005,Sri Lanka,Matara,29,0,118,0,278,34,0,459,30,0,124,0,259,35,0,448
2005,Sri Lanka,Matale,76,0,310,0,731,90,0,1207,79,0,326,0,683,93,0,1181
2005,Sri Lanka,Mannar,850,0,3428,0,7877,940,0,13095,881,0,3586,0,7365,970,0,12802
2005,Sri Lanka,Kurunegala,93,0,377,0,865,102,0,1437,98,0,394,0,809,106,0,1407
2005,Sri Lanka,Kilinochchi,555,0,2120,0,4466,473,0,7614,570,0,2201,0,4202,491,0,7464
2005,Sri Lanka,Kegalle,1,0,5,0,12,2,0,20,1,0,6,0,12,2,0,21
2005,Sri Lanka,Kalutara,27,0,109,0,257,32,0,425,28,0,115,0,241,33,0,417
2005,Sri Lanka,Jaffna,2042,0,8192,0,18709,2215,0,31158,2114,0,8565,0,17502,2289,0,30470
2005,Sri Lanka,Gampaha,61,0,251,0,593,73,0,978,64,0,264,0,553,75,0,956
2005,Sri Lanka,Galle,18,0,74,0,174,21,0,287,19,0,78,0,163,22,0,282
2005,Sri Lanka,Colombo,89,0,343,0,776,88,0,1296,95,0,363,0,778,93,0,1329
2005,Sri Lanka,Batticaloa,645,0,2644,0,6234,767,0,10290,671,0,2773,0,5818,791,0,10053
2005,Sri Lanka,Badulla,8,0,31,0,73,9,0,121,8,0,33,0,68,9,0,118
2005,Sri Lanka,Anuradhapura,344,0,1320,0,2805,302,0,4771,354,0,1372,0,2640,313,0,4679
2005,Sri Lanka,Ampara,125,0,512,0,1205,148,0,1990,130,0,537,0,1126,153,0,1946
2005,Latvia,Salaspils,0,0,0,0,0,0,0,0,0,0,0,0,1,0,0,1
2005,Latvia,Riga district,0,0,1,0,0,0,0,1,0,0,2,0,5,0,0,7
2005,Latvia,Riga,0,0,0,0,0,0,0,0,0,0,0,0,4,0,0,4
2005,Latvia,Jurmala,0,0,1,0,1,0,0,2,0,0,0,0,1,0,0,1
2005,Morocco,Rabat,0,0,0,0,0,0,3,3,0,0,0,0,0,0,1,1
2005,Rep. of Moldova,Chisinau,6,0,14,0,23,2,0,45,4,0,14,0,166,3,0,187
2005,Mexico,Mexico City,0,0,140,0,874,119,0,1133,0,0,144,0,1177,582,0,1903
2005,Mexico,Chiapas,0,0,0,0,200,6,0,206,0,0,6,0,137,5,0,148
2005,The former Yugoslav Republic of Macedonia,Veles,0,0,2,0,1,0,0,3,0,0,4,0,1,0,0,5
2005,The former Yugoslav Republic of Macedonia,Valandovo,1,0,1,0,1,0,0,3,1,0,1,0,1,0,0,3
2005,The former Yugoslav Republic of Macedonia,Tetovo,1,0,7,0,9,0,0,17,1,0,13,0,13,1,0,28
2005,The former Yugoslav Republic of Macedonia,Strumica,0,0,0,0,1,0,0,1,0,0,0,0,0,0,0,0
2005,The former Yugoslav Republic of Macedonia,Skopje,64,0,118,0,196,16,0,394,57,0,130,0,176,14,0,377
2005,The former Yugoslav Republic of Macedonia,Prilep,0,0,1,0,0,0,0,1,0,0,0,0,4,0,0,4
2005,The former Yugoslav Republic of Macedonia,Ohrid,0,0,0,0,0,0,0,0,0,0,0,0,1,0,0,1
2005,The former Yugoslav Republic of Macedonia,Kumanovo,0,0,9,0,12,0,0,21,0,0,16,0,6,1,0,23
2005,The former Yugoslav Republic of Macedonia,Kicevo,0,0,0,0,1,0,0,1,0,0,0,0,0,1,0,1
2005,The former Yugoslav Republic of Macedonia,Kavadarci,0,0,0,0,1,0,0,1,1,0,0,0,0,0,0,1
2005,The former Yugoslav Republic of Macedonia,Gostivar,0,0,1,0,2,0,0,3,0,0,0,0,0,0,0,0
2005,The former Yugoslav Republic of Macedonia,Gevgelija,0,0,0,0,2,0,0,2,0,0,0,0,1,0,0,1
2005,The former Yugoslav Republic of Macedonia,Gazi Baba TC / Skopje,1,0,0,0,2,1,0,4,0,0,1,0,4,1,0,6
2005,The former Yugoslav Republic of Macedonia,Berovo,0,0,0,0,1,0,0,1,0,0,0,0,0,0,0,0
2005,The former Yugoslav Republic of Macedonia,Banja Bansko RC / Strumica,0,0,0,0,0,0,0,0,0,0,0,0,1,0,0,1
2005,Mali,Zegoua,13,0,36,0,40,8,0,97,11,0,42,0,85,7,0,145
2005,Mali,Sikasso,10,0,24,0,40,0,0,74,13,0,19,0,90,0,0,122
2005,Mali,Loulouni,15,0,31,0,30,0,0,76,16,0,26,0,41,0,0,83
2005,Mali,Koutiala,0,0,1,0,1,0,0,2,3,0,2,0,0,0,0,5
2005,Mali,Kayes,819,0,1156,0,571,90,0,2636,349,0,1837,0,1217,126,0,3529
2005,Mali,Kadiolo,3,0,1,0,0,0,0,4,0,0,8,0,2,1,0,11
2005,Mali,Faragouaran,9,0,12,0,20,0,0,41,11,0,18,0,21,0,0,50
2005,Mali,Bamako,211,0,632,0,1378,37,0,2258,259,0,624,0,2969,48,0,3900
2005,Mongolia,Ulaanbaatar,0,0,0,0,0,0,0,0,0,0,0,0,2,0,0,2
2005,Mozambique,Zambezia,0,0,0,0,0,0,4,4,0,0,0,0,0,0,5,5
2005,Mozambique,Tete,0,0,0,0,0,0,10,10,0,0,0,0,0,0,9,9
2005,Mozambique,Sofala,0,0,0,0,0,0,3,3,0,0,0,0,0,0,12,12
2005,Mozambique,Niassa,0,0,0,0,0,0,58,58,0,0,0,0,0,0,73,73
2005,Mozambique,Nampula,0,0,0,0,0,0,55,55,0,0,0,0,0,0,138,138
2005,Mozambique,Maratane,0,0,0,0,0,0,1917,1917,0,0,0,0,0,0,2322,2322
2005,Mozambique,Maputo,0,0,0,0,0,0,543,543,0,0,0,0,0,0,728,728
2005,Mozambique,Manica,0,0,0,0,0,0,9,9,0,0,0,0,0,0,11,11
2005,Mozambique,Inhambane,0,0,0,0,0,0,7,7,0,0,0,0,0,0,14,14
2005,Mozambique,Gaza,0,0,0,0,0,0,13,13,0,0,0,0,0,0,18,18
2005,Mauritania,Nouakchott,25,0,42,0,182,9,0,258,25,0,55,0,375,11,0,466
2005,Malawi,Luwani,205,0,416,0,490,1,0,1112,162,0,452,0,894,7,0,1515
2005,Malawi,Lilongwe,62,0,218,0,208,20,0,508,86,0,473,0,414,1,0,974
2005,Malawi,Dzaleka,480,0,878,0,1364,21,0,2743,490,0,775,0,1433,21,0,2719
2005,Malaysia,Kuala Lumpur,1468,0,1805,0,7371,107,0,10751,1557,0,2316,0,29925,217,0,34015
2005,Namibia,Osire,543,0,1284,0,1058,52,0,2937,587,0,1325,0,1321,36,0,3269
2005,Niger,Niamey,23,0,27,0,52,0,0,102,15,0,25,0,101,0,0,141
2005,Niger,Goure,9,0,20,0,20,2,0,51,7,0,20,0,26,2,0,55
2005,Nigeria,Oru Camp,175,0,653,0,1914,71,0,2813,291,0,626,0,1975,46,0,2938
2005,Nigeria,Lagos,188,0,247,0,1049,0,0,1484,199,0,469,0,1533,3,0,2204
2005,Nicaragua,Managua,0,0,1,0,131,4,0,136,0,0,1,0,61,30,0,92
2005,Nepal,Timai,528,0,1494,0,2741,270,0,5033,513,0,1583,0,2791,341,0,5228
2005,Nepal,Tibetan Refugee Transit Camp,6,0,122,0,130,6,0,264,4,0,189,0,464,7,0,664
2005,Nepal,Sanischare,1010,0,3489,0,5230,458,0,10187,1173,0,3561,0,5410,580,0,10724
2005,Nepal,Khudunabari,550,0,2147,0,3596,331,0,6624,574,0,2020,0,3653,462,0,6709
2005,Nepal,Kathmandu,18,0,9,0,40,2,0,69,16,0,13,0,174,1,0,204
2005,Nepal,Goldhap,403,0,1296,0,2597,257,0,4553,469,0,1316,0,2827,304,0,4916
2005,Nepal,Beldangi 2 Extension,505,0,1648,0,3204,288,0,5645,531,0,1749,0,3258,363,0,5901
2005,Nepal,Beldangi 2,887,0,3199,0,6342,624,0,11052,969,0,3312,0,6410,733,0,11424
2005,Nepal,Beldangi 1,930,0,2640,0,4895,467,0,8932,897,0,2782,0,5070,571,0,9320
2005,Oman,Muscat,0,0,2,0,2,0,0,4,0,0,1,0,5,1,0,7
2005,Pakistan,Quetta,1,0,6,0,10,0,0,17,1,0,8,0,23,6,0,38
2005,Pakistan,Peshawar,5,0,14,0,7,0,0,26,4,0,11,0,11,0,0,26
2005,Pakistan,Lahore,0,0,0,0,2,0,0,2,0,0,1,0,34,0,0,35
2005,Pakistan,Karachi,5,0,6,0,18,0,0,29,1,0,9,0,20,0,0,30
2005,Pakistan,Islamabad,32,0,78,0,174,5,0,289,18,0,115,0,488,6,0,627
2005,Panama,Puerto Obaldia,5,0,29,0,25,1,0,60,4,0,26,0,29,1,0,60
2005,Panama,Jaque,23,0,61,0,70,7,0,161,28,0,48,0,72,14,0,162
2005,Panama,Embera,3,0,17,0,15,0,0,35,2,0,15,0,17,1,0,35
2005,Panama,Darien Centro,42,0,70,0,76,7,0,195,38,0,60,0,85,10,0,193
2005,Peru,Lima,9,0,74,0,302,50,0,435,24,0,93,0,505,127,0,749
2005,Papua New Guinea,Yogi,6,0,11,0,17,0,0,34,8,0,11,0,23,2,0,44
2005,Papua New Guinea,Wisky,1,0,5,0,11,1,0,18,2,0,5,0,4,3,0,14
2005,Papua New Guinea,Warastone,9,0,32,0,32,0,0,73,6,0,27,0,30,2,0,65
2005,Papua New Guinea,Wamena,7,0,21,0,17,0,0,45,3,0,18,0,21,0,0,42
2005,Papua New Guinea,Trakbits,4,0,12,0,13,3,0,32,6,0,20,0,24,1,0,51
2005,Papua New Guinea,Port Moresby,1,0,1,0,1,0,0,3,1,0,0,0,4,0,0,5
2005,Papua New Guinea,Niogamban,23,0,57,0,68,6,0,154,21,0,67,0,72,3,0,163
2005,Papua New Guinea,Kungim,11,0,32,0,51,4,0,98,18,0,49,0,62,5,0,134
2005,Papua New Guinea,Kuiu,14,0,29,0,50,4,0,97,13,0,51,0,39,3,0,106
2005,Papua New Guinea,Komopkin,30,0,80,0,112,10,0,232,34,0,87,0,112,8,0,241
2005,Papua New Guinea,Dome,3,0,32,0,30,3,0,68,8,0,31,0,34,3,0,76
2005,Papua New Guinea,Blackwara,7,0,15,0,23,1,0,46,3,0,27,0,25,3,0,58
2005,Papua New Guinea,Atkamba,35,0,105,0,145,20,0,305,29,0,102,0,155,9,0,295
2005,Paraguay,Asuncion,0,0,6,0,16,1,0,23,0,0,3,0,31,1,0,35
2005,Qatar,Doha,0,0,5,0,8,0,0,13,1,0,7,0,51,2,0,61
2005,Romania,Timisoara,3,0,10,0,46,0,0,59,1,0,7,0,296,2,0,306
2005,Russian Federation,Volgograd,3,0,20,0,22,0,0,45,3,0,19,0,70,1,0,93
2005,Russian Federation,Tatarstan,0,0,0,0,0,0,0,0,0,0,0,0,2,0,0,2
2005,Russian Federation,Stavropol,0,0,0,0,4,0,0,4,2,0,1,0,2,0,0,5
2005,Russian Federation,St-Peterburg,4,0,10,0,15,1,0,30,2,0,10,0,39,0,0,51
2005,Russian Federation,Smoleksk,0,0,0,0,0,0,0,0,0,0,0,0,1,0,0,1
2005,Russian Federation,Saratov,0,0,0,0,0,0,0,0,0,0,0,0,1,0,0,1
2005,Russian Federation,Sachalin,0,0,0,0,1,0,0,1,0,0,3,0,3,0,0,6
2005,Russian Federation,Ryazan,0,0,0,0,0,0,0,0,0,0,0,0,3,0,0,3
2005,Russian Federation,Rostov-na Donu,0,0,3,0,2,1,0,6,0,0,2,0,19,0,0,21
2005,Russian Federation,Pskov,0,0,3,0,1,0,0,4,1,0,1,0,1,0,0,3
2005,Russian Federation,Orel,0,0,5,0,4,0,0,9,0,0,2,0,6,0,0,8
2005,Russian Federation,North Ossetia Republic,1,0,10,0,33,17,0,61,3,0,7,0,27,12,0,49
2005,Russian Federation,Murmansk,0,0,0,0,0,1,0,1,0,0,0,0,0,0,0,0
2005,Russian Federation,Moscow region,5,0,8,0,23,3,0,39,0,0,16,0,20,1,0,37
2005,Russian Federation,Moscow City,14,0,23,0,42,2,0,81,5,0,34,0,81,2,0,122
2005,Russian Federation,Lipeck,0,0,0,0,0,0,0,0,0,0,0,0,2,1,0,3
2005,Russian Federation,Leningradskaya Oblast,0,0,1,0,1,0,0,2,0,0,0,0,2,0,0,2
2005,Russian Federation,Krasnodar,0,0,0,0,0,0,0,0,0,0,0,0,1,0,0,1
2005,Russian Federation,Kaluga,0,0,0,0,2,0,0,2,0,0,0,0,2,1,0,3
2005,Russian Federation,Ivanovo,0,0,0,0,1,0,0,1,0,0,0,0,17,0,0,17
2005,Russian Federation,Grozny,0,0,0,0,0,0,71,71,0,0,0,0,0,0,54,54
2005,Russian Federation,Dagestan Republic,0,0,0,0,1,0,0,1,0,0,0,0,1,0,0,1
2005,Russian Federation,Belgorod,0,0,0,0,1,0,0,1,0,0,0,0,6,0,0,6
2005,Russian Federation,Bashkortostan,0,0,0,0,0,0,0,0,0,0,0,0,2,0,0,2
2005,Russian Federation,Arkhangelsk,0,0,0,0,0,0,0,0,0,0,0,0,1,0,0,1
2005,Russian Federation,Altay,0,0,0,0,4,1,0,5,1,0,1,0,12,1,0,15
2005,Russian Federation,Adyguea,1,0,2,0,1,0,0,4,0,0,0,0,2,0,0,2
2005,Rwanda,Nyamure (Butare),268,0,223,0,478,14,0,983,281,0,169,0,490,8,0,948
2005,Rwanda,Nyabiheke (Byumba),553,0,969,0,1073,68,0,2663,532,0,901,0,526,42,0,2001
2005,Rwanda,Nkamira (Gisenyi),136,0,230,0,271,18,0,655,163,0,166,0,124,15,0,468
2005,Rwanda,Kiziba (Kibuye),1608,0,3937,0,3745,380,0,9670,1535,0,3691,0,2264,313,0,7803
2005,Rwanda,Kigeme (Gikongoro),57,0,128,0,158,2,0,345,70,0,142,0,129,12,0,353
2005,Rwanda,Kigali,408,0,1108,0,1352,78,0,2946,567,0,1191,0,1581,59,0,3398
2005,Rwanda,Gihembe (Byumba),1636,0,3932,0,3714,347,0,9629,1563,0,3562,0,2323,197,0,7645
2005,Saudi Arabia,Riyadh,9,0,35,0,30,1,0,75,4,0,35,0,52,2,0,93
2005,Saudi Arabia,Rafha,14,0,50,0,41,3,0,108,17,0,55,0,180,3,0,255
2005,Saudi Arabia,Makkah,1,0,1,0,1,0,0,3,0,0,2,0,0,0,0,2
2005,Saudi Arabia,Khobar,0,0,3,0,1,0,0,4,0,0,2,0,4,0,0,6
2005,Saudi Arabia,Jeddah,7,0,24,0,26,1,0,58,5,0,17,0,54,4,0,80
2005,Saudi Arabia,Gizan,2,0,0,0,3,0,0,5,0,0,0,0,209,0,0,209
2005,Sudan,Wad Sherife,959,0,7789,0,8281,722,0,17751,1028,0,6612,0,7079,612,0,15331
2005,Sudan,Um Gargur,571,0,1947,0,2069,180,0,4767,643,0,1942,0,2064,180,0,4829
2005,Sudan,"Shagrabs 1, 2 & 3",1511,0,4175,0,4436,387,0,10509,1547,0,4266,0,4533,395,0,10741
2005,Sudan,Kilo 26,545,0,2180,0,2316,202,0,5243,555,0,3950,0,4197,366,0,9068
2005,Sudan,Girba,349,0,1935,0,2056,179,0,4519,342,0,1889,0,2007,175,0,4413
2005,Sudan,Fau 5,76,0,155,0,165,14,0,410,84,0,403,0,428,37,0,952
2005,Sudan,Abuda,187,0,791,0,841,73,0,1892,220,0,756,0,804,70,0,1850
2005,Sudan,"Suki (Awad El Seid, Fath El Rahman, Kilo 7)",89,0,671,0,713,62,0,1535,98,0,680,0,722,63,0,1563
2005,Senegal,Podor,942,0,2265,0,1355,239,0,4801,628,0,1504,0,904,160,0,3196
2005,Senegal,Matam,946,0,2251,0,1341,240,0,4778,636,0,1498,0,895,160,0,3189
2005,Senegal,Dakar,32,0,108,0,902,23,0,1065,53,0,204,0,2273,34,0,2564
2005,Senegal,Dagana,229,0,542,0,323,57,0,1151,153,0,361,0,217,38,0,769
2005,Senegal,Bakel,217,0,517,0,308,54,0,1096,145,0,344,0,207,36,0,732
2005,Singapore,Singapore,0,0,0,0,2,0,0,2,0,0,0,0,2,0,0,2
2005,Sierra Leone,Tobanda,654,0,1199,0,1772,183,0,3808,563,0,1118,0,1358,150,0,3189
2005,Sierra Leone,Taiiama,417,0,1120,0,1112,98,0,2747,464,0,1155,0,1170,81,0,2870
2005,Sierra Leone,Largo,496,0,1237,0,1666,199,0,3598,518,0,1236,0,1220,142,0,3116
2005,Sierra Leone,Kenema,123,0,769,0,947,66,0,1905,133,0,758,0,829,81,0,1801
2005,Sierra Leone,Jimmi Bagbo,384,0,971,0,1014,90,0,2459,433,0,1092,0,932,70,0,2527
2005,Sierra Leone,Jembe,382,0,1236,0,1225,154,0,2997,438,0,1285,0,1311,119,0,3153
2005,Sierra Leone,Gondama,486,0,1365,0,1633,120,0,3604,542,0,1384,0,1563,114,0,3603
2005,Sierra Leone,Gerihun,385,0,1010,0,1177,125,0,2697,370,0,988,0,1210,107,0,2675
2005,Sierra Leone,Freetown,209,0,1432,0,2333,77,0,4051,224,0,1318,0,2393,56,0,3991
2005,Sierra Leone,Bo,34,0,218,0,246,4,0,502,39,0,208,0,214,11,0,472
2005,Sierra Leone,Bandajuma,332,0,796,0,957,93,0,2178,338,0,853,0,912,88,0,2191
2005,El Salvador,San Salvador,0,0,0,0,16,0,0,16,0,0,1,0,26,7,0,34
2005,Somalia,Hargeisa,63,0,38,0,130,0,0,231,55,0,52,0,154,1,0,262
2005,Serbia and Kosovo (S/RES/1244 (1999)),Kosovo,3,0,145,0,285,47,52511,52991,8,0,134,0,269,78,55971,56460
2005,Serbia and Kosovo (S/RES/1244 (1999)),Serbia (excluding Kosovo),2004,0,32214,0,99294,43188,0,176700,2139,0,34511,0,102737,30297,0,169684
2005,Serbia and Kosovo (S/RES/1244 (1999)),Montenegro,532,0,3290,0,7742,2214,0,13778,614,0,3614,0,6612,1593,0,12433
2005,Serbia and Kosovo (S/RES/1244 (1999)),Belgrade,0,0,3,0,8,0,0,11,5,0,8,0,19,0,0,32
2005,Slovenia,Postojna,0,0,0,0,0,0,17,17,0,0,0,0,0,0,15,15
2005,Slovenia,Novo Mesto,0,0,0,0,0,0,11,11,0,0,0,0,0,0,10,10
2005,Slovenia,Maribor,0,0,0,0,0,0,12,12,0,0,0,0,0,0,12,12
2005,Slovenia,Ljubljana,0,0,0,0,0,0,111,111,0,0,0,0,0,0,193,193
2005,Slovenia,Celje,0,0,0,0,0,0,35,35,0,0,0,0,0,0,20,20
2005,Swaziland,Malindza,4,0,15,0,19,1,0,39,11,0,23,0,18,0,0,52
2005,Syrian Arab Rep.,Damascus,1181,0,4037,0,7902,554,0,13674,1213,0,4414,0,10142,581,0,16350
2005,Chad,Yaroungou,2030,0,2883,0,3267,100,0,8280,1896,0,2601,0,3014,67,0,7578
2005,Chad,Treguine,1293,0,2665,0,3305,271,0,7534,1366,0,2774,0,2058,269,0,6467
2005,Chad,Touloum,2358,0,4905,0,4086,467,0,11816,2093,0,4140,0,1761,248,0,8242
2005,Chad,Oure-Cassoni,3647,0,6824,0,6724,655,0,17850,3456,0,5344,0,2645,315,0,11760
2005,Chad,Mile,1382,0,3013,0,3325,355,0,8075,1301,0,2468,0,1326,249,0,5344
2005,Chad,Kounougou,1214,0,2598,0,2674,205,0,6691,1197,0,2355,0,1195,190,0,4937
2005,Chad,Iridimi,1610,0,3618,0,3107,317,0,8652,1547,0,3258,0,1322,195,0,6322
2005,Chad,Goz Amer,1821,0,3427,0,4139,432,0,9819,1931,0,3280,0,2312,359,0,7882
2005,Chad,Gaga,597,0,1242,0,1402,73,0,3314,450,0,1302,0,834,78,0,2664
2005,Chad,Farchana,1716,0,3456,0,4177,311,0,9660,1668,0,3332,0,2319,270,0,7589
2005,Chad,Djabal,1418,0,2868,0,3394,299,0,7979,1423,0,2834,0,1904,241,0,6402
2005,Chad,Bredjing,2375,0,5241,0,6323,561,0,14500,2369,0,5400,0,4027,473,0,12269
2005,Chad,Amboko,3078,0,5173,0,5417,235,0,13903,3024,0,4195,0,3848,419,0,11486
2005,Chad,Am nabak,1966,0,3906,0,3829,408,0,10109,1994,0,2850,0,1306,239,0,6389
2005,Togo,Lome,85,0,207,0,423,7,0,722,89,0,218,0,674,6,0,987
2005,Thailand,Um Pium (Pob Phra),1008,0,2613,0,3695,287,0,7603,1065,0,2784,0,3608,241,0,7698
2005,Thailand,Tham Hin,750,0,1715,0,2082,187,0,4734,763,0,1713,0,2016,175,0,4667
2005,Thailand,Nu Po (Umphang),664,0,1764,0,2252,183,0,4863,704,0,1831,0,2210,160,0,4905
2005,Thailand,Mae Surin,181,0,416,0,568,35,0,1200,187,0,401,0,617,52,0,1257
2005,Thailand,Mae Sot,283,0,908,0,2287,60,0,3538,300,0,797,0,1682,69,0,2848
2005,Thailand,Mae Ra Ma Luang (Sob Moei),679,0,1533,0,1909,179,0,4300,726,0,1646,0,1949,207,0,4528
2005,Thailand,Mae La Oon,771,0,1836,0,2384,189,0,5180,864,0,2025,0,2353,213,0,5455
2005,Thailand,Mae La (Thasongyang),2617,0,6650,0,8908,749,0,18924,2773,0,7178,0,8580,688,0,19219
2005,Thailand,Kanchanaburi,9,0,39,0,97,1,0,146,10,0,38,0,77,1,0,126
2005,Thailand,Don Yang,254,0,664,0,827,59,0,1804,273,0,692,0,630,59,0,1654
2005,Thailand,Bangkok,179,0,489,0,2926,37,0,3631,199,0,482,0,2181,33,0,2895
2005,Thailand,Ban Mai Nai Soi,1477,0,2888,0,3907,348,0,8620,1560,0,2821,0,4126,383,0,8890
2005,Tajikistan,Khujand,0,0,0,0,0,0,58,58,0,0,0,0,0,0,45,45
2005,Tajikistan,Dushanbe,0,0,0,0,0,0,572,572,0,0,0,0,0,0,383,383
2005,Turkmenistan,Turkmenbashi,0,0,0,0,5,4,0,9,0,0,2,0,3,0,0,5
2005,Turkmenistan,Turkmenabad,0,0,21,0,15,0,0,36,2,0,12,0,19,0,0,33
2005,Turkmenistan,Tedjen,0,0,0,0,1,0,0,1,0,0,1,0,0,0,0,1
2005,Turkmenistan,Mary province,251,0,734,0,1099,87,0,2171,226,0,705,0,1086,68,0,2085
2005,Turkmenistan,Mary,0,0,0,0,0,0,0,0,0,0,0,0,1,0,0,1
2005,Turkmenistan,Lebap province,340,0,956,0,1591,113,0,3000,374,0,1006,0,1531,123,0,3034
2005,Turkmenistan,Balkanabad,0,0,0,0,0,0,0,0,0,0,0,0,1,0,0,1
2005,Turkmenistan,Balkan province,0,0,3,0,7,0,0,10,4,0,8,0,4,0,0,16
2005,Turkmenistan,Ashgabat,2,0,12,0,21,4,0,39,4,0,10,0,31,1,0,46
2005,Turkmenistan,Akhal province,77,0,233,0,425,28,0,763,52,0,231,0,414,17,0,714
2005,Timor-Leste,Dili,0,0,0,0,1,0,0,1,0,0,0,0,12,0,0,12
2005,Tunisia,Tunis,1,0,2,0,24,7,0,34,2,0,5,0,64,8,0,79
2005,Turkey,Yozgat Camp,1,0,3,0,13,0,0,17,2,0,2,0,13,0,0,17
2005,Turkey,Yozgat,2,0,11,0,12,0,0,25,1,0,6,0,25,0,0,32
2005,Turkey,Yalova,0,0,0,0,2,0,0,2,0,0,2,0,2,0,0,4
2005,Turkey,Van,14,0,35,0,129,3,0,181,11,0,49,0,334,4,0,398
2005,Turkey,Tokat,0,0,2,0,2,0,0,4,1,0,2,0,3,0,0,6
2005,Turkey,Sivas,0,0,4,0,4,0,0,8,1,0,2,0,6,0,0,9
2005,Turkey,Sirnak,0,0,0,0,0,0,0,0,0,0,0,0,3,0,0,3
2005,Turkey,Silopi,0,0,0,0,0,0,0,0,0,0,0,0,1,0,0,1
2005,Turkey,Samsun,0,0,0,0,1,0,0,1,0,0,0,0,2,0,0,2
2005,Turkey,Nigde,3,0,19,0,46,1,0,69,2,0,21,0,58,3,0,84
2005,Turkey,Nevsehir,14,0,32,0,114,8,0,168,6,0,48,0,141,6,0,201
2005,Turkey,Kutahya,6,0,8,0,25,0,0,39,3,0,18,0,36,0,0,57
2005,Turkey,Konya,5,0,26,0,61,1,0,93,17,0,31,0,95,3,0,146
2005,Turkey,Kirsehir,8,0,17,0,38,0,0,63,5,0,19,0,62,0,0,86
2005,Turkey,Kirklareli,0,0,4,0,5,1,0,10,0,0,2,0,8,0,0,10
2005,Turkey,Kirikkale,2,0,1,0,5,0,0,8,0,0,2,0,6,0,0,8
2005,Turkey,Kayseri,16,0,84,0,291,18,0,409,21,0,107,0,275,21,0,424
2005,Turkey,Kastamonu,4,0,16,0,35,3,0,58,2,0,22,0,57,0,0,81
2005,Turkey,Karaman,6,0,19,0,39,0,0,64,3,0,13,0,57,0,0,73
2005,Turkey,K.Maras,0,0,0,0,1,0,0,1,0,0,0,0,1,0,0,1
2005,Turkey,Izmit,0,0,0,0,0,0,0,0,0,0,0,0,1,0,0,1
2005,Turkey,Izmir,0,0,1,0,4,0,0,5,0,0,3,0,18,0,0,21
2005,Turkey,Istanbul,82,0,268,0,728,40,0,1118,102,0,309,0,860,34,0,1305
2005,Turkey,Isparta,4,0,16,0,32,0,0,52,7,0,11,0,72,1,0,91
2005,Turkey,Hatay,0,0,2,0,4,0,0,6,0,0,0,0,11,1,0,12
2005,Turkey,Hakkari,0,0,2,0,7,0,0,9,0,0,2,0,7,0,0,9
2005,Turkey,Eskisehir,12,0,35,0,108,1,0,156,16,0,53,0,145,2,0,216
2005,Turkey,Edirne,0,0,0,0,3,0,0,3,0,0,0,0,0,0,0,0
2005,Turkey,Corum,0,0,7,0,8,0,0,15,0,0,9,0,9,0,0,18
2005,Turkey,Cankiri,4,0,10,0,24,0,0,38,8,0,20,0,48,0,0,76
2005,Turkey,Bursa,0,0,1,0,1,0,0,2,0,0,1,0,1,0,0,2
2005,Turkey,Burdur,3,0,20,0,29,0,0,52,5,0,10,0,55,1,0,71
2005,Turkey,Border,0,0,0,0,0,0,0,0,0,0,0,0,1,0,0,1
2005,Turkey,Bilecik,1,0,2,0,9,0,0,12,1,0,7,0,12,0,0,20
2005,Turkey,Antalya,0,0,0,0,0,0,0,0,0,0,0,0,2,0,0,2
2005,Turkey,Ankara,9,0,57,0,109,1,0,176,16,0,54,0,173,3,0,246
2005,Turkey,Amasya,6,0,13,0,34,1,0,54,6,0,21,0,36,0,0,63
2005,Turkey,Aksaray,7,0,30,0,43,1,0,81,3,0,23,0,82,2,0,110
2005,Turkey,Agri,2,0,2,0,5,0,0,9,0,0,4,0,6,0,0,10
2005,Turkey,Afyon,3,0,13,0,25,0,0,41,2,0,10,0,48,0,0,60
2005,Turkey,Adana,0,0,3,0,1,0,0,4,1,0,4,0,2,0,0,7
2005,United Rep. of Tanzania,Nyarugusu,5514,0,10597,0,12415,729,0,29255,7685,0,10809,0,10985,569,0,30048
2005,United Rep. of Tanzania,Nduta,2602,0,4233,0,4700,137,0,11672,2537,0,5163,0,4932,189,0,12821
2005,United Rep. of Tanzania,Myovosi,3852,0,4537,0,6965,272,0,15626,2682,0,5742,0,6251,274,0,14949
2005,United Rep. of Tanzania,Mtendeli,2726,0,4440,0,5068,160,0,12394,3651,0,4486,0,5229,190,0,13556
2005,United Rep. of Tanzania,Mtabila1,1125,0,3147,0,3368,188,0,7828,1131,0,3216,0,2753,206,0,7306
2005,United Rep. of Tanzania,Mtabila 2,3564,0,6670,0,7596,273,0,18103,4951,0,3426,0,8818,266,0,17461
2005,United Rep. of Tanzania,Mkugwa,224,0,408,0,449,16,0,1097,275,0,422,0,623,10,0,1330
2005,United Rep. of Tanzania,Mbuba,14,0,23,0,28,0,0,65,15,0,24,0,30,1,0,70
2005,United Rep. of Tanzania,Lukole,5306,0,8534,0,9774,648,0,24262,5446,0,8568,0,9511,980,0,24505
2005,United Rep. of Tanzania,Lugufu,9239,0,16265,0,19033,985,0,45522,9980,0,16791,0,17846,670,0,45287
2005,United Rep. of Tanzania,Kanembwa,1424,0,2753,0,2932,191,0,7300,1867,0,2652,0,2745,206,0,7470
2005,United Rep. of Tanzania,Chogo,227,0,716,0,511,51,0,1505,218,0,435,0,450,55,0,1158
2005,Uganda,Rhinocamp,1370,0,4328,0,3959,168,0,9825,1439,0,4559,0,3758,116,0,9872
2005,Uganda,Palorinya,3003,0,6317,0,7496,542,0,17358,3013,0,6770,0,5788,263,0,15834
2005,Uganda,Oruchinga,330,0,430,0,520,18,0,1298,306,0,426,0,566,29,0,1327
2005,Uganda,Okollo,863,0,1335,0,1456,121,0,3775,788,0,1600,0,1171,80,0,3639
2005,Uganda,Nakivale,2074,0,2386,0,3091,102,0,7653,1964,0,2427,0,3521,119,0,8031
2005,Uganda,Kyangwali,1874,0,3261,0,3494,319,0,8948,1948,0,3529,0,3457,211,0,9145
2005,Uganda,Kyaka 2,1645,0,2465,0,2961,175,0,7246,1572,0,2627,0,2977,176,0,7352
2005,Uganda,Kiryandongo,1135,0,2149,0,2568,404,0,6256,1193,0,2306,0,2431,242,0,6172
2005,Uganda,Imvepi,1490,0,4790,0,3952,151,0,10383,1631,0,6871,0,4329,79,0,12910
2005,Uganda,Ikafe,1017,0,1820,0,1806,111,0,4754,998,0,2038,0,1555,71,0,4662
2005,Uganda,Adjumani,4422,0,9649,0,11633,978,0,26682,4529,0,9898,0,10385,546,0,25358
2005,Uruguay,Montevideo,1,0,7,0,26,6,0,40,0,0,11,0,72,7,0,90
2005,Uzbekistan,Termez,5,0,75,0,76,3,0,159,6,0,69,0,117,8,0,200
2005,Uzbekistan,Tashkent,1624,0,1255,0,1974,471,0,5324,1403,0,1132,0,1831,405,0,4771
2005,Uzbekistan,Syrdarya,1658,0,967,0,1519,461,0,4605,1412,0,824,0,1295,392,0,3923
2005,Uzbekistan,Surkhandarya,1562,0,912,0,1433,434,0,4341,1331,0,776,0,1220,370,0,3697
2005,Uzbekistan,Samarkand,873,0,517,0,811,243,0,2444,743,0,445,0,700,205,0,2093
2005,Uzbekistan,Namangan,0,0,0,0,0,0,0,0,0,0,0,0,1,0,0,1
2005,Uzbekistan,Kashkadarya,784,0,458,0,719,218,0,2179,668,0,390,0,612,186,0,1856
2005,Uzbekistan,Fergana,887,0,518,0,813,247,0,2465,756,0,441,0,694,210,0,2101
2005,Uzbekistan,Bukhara,0,0,0,0,1,0,0,1,0,0,1,0,3,0,0,4
2005,Uzbekistan,Andijan,0,0,0,0,0,0,0,0,0,0,0,0,1,1,0,2
2005,Venezuela (Bolivarian Republic of),Zulia,89,0,201,0,265,12,0,567,96,0,188,0,307,28,0,619
2005,Venezuela (Bolivarian Republic of),Tachira,154,0,341,0,499,38,0,1032,168,0,371,0,576,49,0,1164
2005,Venezuela (Bolivarian Republic of),Caracas,31,0,94,0,229,12,0,366,41,0,90,0,374,30,0,535
2005,Venezuela (Bolivarian Republic of),Apure,155,0,361,0,437,26,0,979,182,0,383,0,474,44,0,1083
2005,Viet Nam,Thu Duc (Ho Chi Minh City),0,0,0,0,0,0,39,39,0,0,0,0,0,0,39,39
2005,Viet Nam,Cu Chi (Ho Chi Minh City),0,0,0,0,0,0,129,129,0,0,0,0,0,0,104,104
2005,Viet Nam,B Phuoc,0,0,0,0,0,0,130,130,0,0,0,0,0,0,131,131
2005,Viet Nam,B Duong,0,0,0,0,0,0,930,930,0,0,0,0,0,0,855,855
2005,Yemen,Taiz,59,0,358,0,690,185,0,1292,56,0,680,0,650,180,0,1566
2005,Yemen,Shabwa,15,0,57,0,151,6,0,229,12,0,44,0,171,2,0,229
2005,Yemen,Sana'a/Aden,47,0,100,0,167,17,0,331,53,0,115,0,228,8,0,404
2005,Yemen,Sana'a,500,0,3519,0,5497,676,0,10192,453,0,3507,0,5156,552,0,9668
2005,Yemen,Sada'a,2,0,16,0,25,4,0,47,3,0,30,0,55,5,0,93
2005,Yemen,Rida'a,29,0,35,0,56,5,0,125,25,0,65,0,62,5,0,157
2005,Yemen,Mukalla,41,0,162,0,165,33,0,401,39,0,152,0,66,34,0,291
2005,Yemen,Mahra,32,0,123,0,157,7,0,319,32,0,140,0,182,7,0,361
2005,Yemen,Hodeidah,20,0,81,0,109,24,0,234,19,0,110,0,104,19,0,252
2005,Yemen,Dhamar,18,0,37,0,78,2,0,135,17,0,32,0,47,4,0,100
2005,Yemen,AL-Kharaz,700,0,1504,0,1784,15,0,4003,689,0,1634,0,1872,28,0,4223
2005,Yemen,Al-Baida,8,0,67,0,86,7,0,168,14,0,46,0,92,2,0,154
2005,Yemen,Aden,299,0,2692,0,3147,372,0,6510,336,0,2761,0,3474,307,0,6878
2005,Zambia,Nangweshi,1279,0,3475,0,1993,147,0,6894,1686,0,2863,0,3486,187,0,8222
2005,Zambia,Mwange,2631,0,3415,0,4907,511,0,11464,2302,0,4308,0,3859,267,0,10736
2005,Zambia,Meheba,1489,0,2575,0,2398,456,0,6918,1434,0,2164,0,2875,584,0,7057
2005,Zambia,Mayukwayukwa,780,0,943,0,1083,236,0,3042,567,0,793,0,1196,154,0,2710
2005,Zambia,Kala,1537,0,3167,0,3675,262,0,8641,2167,0,3280,0,4136,196,0,9779
2006,Afghanistan,Zehray Dasht,0,0,0,0,0,0,18939,18939,0,0,0,0,0,0,19712,19712
2006,Afghanistan,Zabul,77,88,0,45,125,7,381,723,72,115,0,38,116,19,396,756
2006,Afghanistan,Wardak,112,139,0,102,240,16,0,609,122,164,0,83,254,29,0,652
2006,Afghanistan,Various,110521,248844,0,124175,582094,60955,1026429,2153018,119119,267159,0,223089,666616,59306,1193502,2528791
2006,Afghanistan,Uruzgan,18,13,0,6,21,2,0,60,14,24,0,9,18,3,0,68
2006,Afghanistan,Takhar,220,232,0,123,444,39,286,1344,235,258,0,117,503,43,298,1454
2006,Afghanistan,Saripul ,0,0,0,0,0,0,218,218,0,0,0,0,0,0,227,227
2006,Afghanistan,Sari Pul,95,103,0,42,172,14,0,426,90,119,0,59,187,21,0,476
2006,Afghanistan,Samangan,63,57,0,29,110,11,4,274,58,54,0,35,108,8,5,268
2006,Afghanistan,Parwan,245,219,0,151,411,19,6,1051,245,260,0,155,487,33,6,1186
2006,Afghanistan,Panjwayi,0,0,0,0,0,0,21051,21051,0,0,0,0,0,0,21910,21910
2006,Afghanistan,Panjsher,2,3,0,1,4,0,0,10,0,4,0,3,7,0,0,14
2006,Afghanistan,Paktya,829,1086,0,657,1779,117,0,4468,868,1128,0,616,1404,200,0,4216
2006,Afghanistan,Paktika,99,98,0,51,147,8,135,538,94,120,0,38,151,15,140,558
2006,Afghanistan,Nuristan,24,25,0,16,31,2,0,98,14,28,0,12,32,3,0,89
2006,Afghanistan,Nimroz,14,12,0,6,24,1,5,62,21,27,0,5,18,2,5,78
2006,Afghanistan,Nangarhar,2390,2945,0,1431,4206,297,0,11269,2520,2995,0,1608,3840,346,0,11309
2006,Afghanistan,Mukhtar,0,0,0,0,0,0,11564,11564,0,0,0,0,0,0,12036,12036
2006,Afghanistan,Maiwand,0,0,0,0,0,0,3150,3150,0,0,0,0,0,0,3278,3278
2006,Afghanistan,Logar,1160,1475,0,695,2197,128,0,5655,1151,1566,0,658,1939,155,0,5469
2006,Afghanistan,Laghman,393,437,0,188,610,43,0,1671,415,482,0,233,604,63,0,1797
2006,Afghanistan,Kunduz,1881,2327,0,882,2881,218,121,8310,1890,2319,0,927,2562,261,126,8085
2006,Afghanistan,Kunar,275,341,0,179,477,39,0,1311,299,382,0,205,468,43,0,1397
2006,Afghanistan,Khost,320,447,0,240,702,47,0,1756,372,496,0,268,644,67,0,1847
2006,Afghanistan,Kapisa,44,38,0,39,80,1,0,202,40,50,0,31,140,7,0,268
2006,Afghanistan,Kandahar,227,278,0,131,398,40,396,1470,231,325,0,137,378,45,412,1528
2006,Afghanistan,Kabul,2680,3387,0,2292,6742,524,1679,17304,2789,3643,0,2294,6079,661,1747,17213
2006,Afghanistan,Jawzjan,341,394,0,167,704,49,664,2319,342,392,0,224,670,80,691,2399
2006,Afghanistan,Hirat,132,148,0,132,375,21,0,808,122,168,0,128,568,48,0,1034
2006,Afghanistan,Hilmand,143,178,0,92,235,15,181,844,161,174,0,70,232,30,188,855
2006,Afghanistan,Herat ,0,0,0,0,0,0,4698,4698,0,0,0,0,0,0,4890,4890
2006,Afghanistan,Ghor,4,6,0,3,10,1,58,82,2,2,0,1,30,0,61,96
2006,Afghanistan,Ghazni,695,845,0,344,1536,143,0,3563,708,855,0,362,1441,184,0,3550
2006,Afghanistan,Faryab,117,133,0,83,288,30,705,1356,134,131,0,85,406,33,735,1524
2006,Afghanistan,Farah,36,33,0,15,58,4,345,491,38,48,0,20,62,6,359,533
2006,Afghanistan,DayKundi,7,15,0,4,37,3,0,66,17,14,0,4,55,3,0,93
2006,Afghanistan,Bamyan,27,24,0,19,61,5,0,136,16,33,0,14,64,11,0,138
2006,Afghanistan,Balkh,259,318,0,184,590,62,855,2268,259,333,0,173,558,65,890,2278
2006,Afghanistan,Baghlan,686,799,0,382,1393,101,172,3533,715,864,0,467,1222,134,179,3581
2006,Afghanistan,Baghi Shirkat,0,0,0,0,0,0,419,419,0,0,0,0,0,0,436,436
2006,Afghanistan,Badghis,27,19,0,14,37,2,1744,1843,16,19,0,13,52,7,1815,1922
2006,Afghanistan,Badakhshan,11,13,0,4,22,1,0,51,10,14,0,5,67,3,0,99
2006,Angola,Zaire,1533,850,0,1036,2713,353,0,6485,1297,925,0,732,2123,235,0,5312
2006,Angola,Viana,433,625,0,949,1376,40,0,3423,439,420,0,1119,796,35,0,2809
2006,Angola,Uige,1614,990,0,1086,2857,372,0,6919,1366,869,0,785,2236,248,0,5504
2006,Angola,Sungi,5,10,0,41,100,2,0,158,10,9,0,40,65,5,0,129
2006,Angola,Moxico,2243,1777,0,1449,4009,492,0,9970,1939,1281,0,1610,2942,326,0,8098
2006,Angola,Malange,53,67,0,86,237,4,0,447,40,96,0,81,135,10,0,362
2006,Angola,Lunda Sul,51,48,0,119,196,2,0,416,9,30,0,22,246,2,0,309
2006,Angola,Lunda Norte,10,6,0,11,201,12,0,240,14,18,0,10,192,7,0,241
2006,Angola,Luanda,60,34,0,79,194,12,0,379,55,50,0,101,453,18,0,677
2006,Angola,Kwanza Sul,0,15,0,7,16,0,0,38,0,10,0,7,26,0,0,43
2006,Angola,Kwanza Norte,0,0,0,8,5,0,0,13,1,3,0,7,11,0,0,22
2006,Angola,Kuando Kubango,550,406,0,270,974,127,0,2327,465,262,0,330,767,84,0,1908
2006,Angola,Keutepwe,43,16,0,71,117,13,0,260,35,44,0,26,94,11,0,210
2006,Angola,Kamatende,93,92,0,94,162,18,0,459,94,48,0,139,82,8,0,371
2006,Angola,Huambo,275,119,0,219,487,63,0,1163,232,148,0,152,381,42,0,955
2006,Angola,Cabinda,34,11,0,31,61,8,0,145,29,16,0,26,48,5,0,124
2006,Albania,Tirana,0,6,0,5,13,2,0,26,1,7,0,9,42,1,0,60
2006,Albania,Peshkopi,0,0,0,0,1,0,0,1,0,0,0,0,0,0,0,0
2006,Albania,Mamurras,0,0,0,0,1,2,0,3,0,0,0,0,0,1,0,1
2006,Albania,Fushekruje,0,0,0,0,0,0,0,0,0,0,0,0,1,0,0,1
2006,United Arab Emirates,Abu Dhabi,6,7,0,13,63,0,0,89,8,12,0,19,68,10,0,117
2006,Argentina,Buenos Aires,41,79,0,81,1166,48,0,1415,48,92,0,114,2279,77,0,2610
2006,Armenia,Yerevan,12,22,0,32,158,52,25888,26164,14,21,0,36,192,29,24874,25166
2006,Armenia,Vedi,0,0,0,2,17,7,0,26,0,0,0,1,9,3,0,13
2006,Armenia,Vayk,0,0,0,0,1,0,0,1,0,0,0,0,0,0,0,0
2006,Armenia,Vayits-Dzor marz,0,0,0,0,4,0,0,4,0,0,0,0,5,0,0,5
2006,Armenia,Vardenis,0,0,0,0,0,0,0,0,0,0,0,0,1,0,0,1
2006,Armenia,Vanadzor,0,0,0,0,2,1,0,3,0,0,0,0,3,0,0,3
2006,Armenia,Tavush marz,0,0,0,0,84,22,0,106,0,0,0,4,61,12,0,77
2006,Armenia,Tashir,0,0,0,0,3,1,0,4,0,0,0,0,8,0,0,8
2006,Armenia,Syunik marz,0,0,0,0,30,11,0,41,0,0,0,0,37,2,0,39
2006,Armenia,Stepanavan,0,0,0,0,8,2,0,10,0,0,0,1,13,0,0,14
2006,Armenia,Spitak,0,0,0,0,8,2,0,10,0,0,0,0,1,3,0,4
2006,Armenia,Sisian,0,0,0,0,1,1,0,2,0,0,0,0,0,0,0,0
2006,Armenia,Shirak marz ,0,0,0,0,8,1,0,9,0,0,0,0,7,3,0,10
2006,Armenia,Sevan,0,0,0,0,4,2,0,6,0,0,0,1,1,2,0,4
2006,Armenia,Noyemberyan,0,0,0,0,2,1,0,3,0,0,0,0,2,1,0,3
2006,Armenia,Meghri,0,0,0,0,5,0,0,5,0,0,0,0,3,0,0,3
2006,Armenia,Masis,0,0,0,0,21,10,0,31,0,0,0,0,14,4,0,18
2006,Armenia,Martuni,0,0,0,0,2,0,0,2,0,0,0,0,0,0,0,0
2006,Armenia,Lori marz,0,0,0,0,39,11,0,50,0,0,0,1,49,6,0,56
2006,Armenia,Kotayk marz,0,0,0,0,0,0,15205,15205,0,0,0,0,0,0,14610,14610
2006,Armenia,Kapan,0,0,0,0,26,10,0,36,0,0,0,1,27,5,0,33
2006,Armenia,Kajaran,0,0,0,0,8,4,0,12,0,0,0,0,3,1,0,4
2006,Armenia,Ijevan,0,0,0,0,3,0,0,3,0,0,0,0,4,1,0,5
2006,Armenia,Gyumri,0,0,0,0,14,3,0,17,0,0,0,2,20,1,0,23
2006,Armenia,Goris,0,0,0,0,19,4,0,23,0,0,0,0,28,3,0,31
2006,Armenia,Gegharkunik,0,0,0,2,41,5,0,48,0,0,0,2,60,3,0,65
2006,Armenia,Gavar ,0,0,0,0,0,0,0,0,0,0,0,0,1,0,0,1
2006,Armenia,Dilijan,0,0,0,0,5,7,0,12,0,0,0,0,4,1,0,5
2006,Armenia,Chambarak,0,0,0,0,0,0,0,0,0,0,0,1,0,0,0,1
2006,Armenia,Berd,0,0,0,0,2,0,0,2,0,0,0,0,2,0,0,2
2006,Armenia,Artik,0,0,0,0,4,0,0,4,0,0,0,0,0,0,0,0
2006,Armenia,Artashat,0,0,0,0,26,8,0,34,0,0,0,0,16,4,0,20
2006,Armenia,Armavir marz,0,0,0,0,0,0,12235,12235,0,0,0,0,0,0,11756,11756
2006,Armenia,Ararat marz,0,0,0,8,207,66,0,281,0,0,0,11,224,34,0,269
2006,Armenia,Ararat city,0,0,0,0,9,3,0,12,0,0,0,0,4,0,0,4
2006,Armenia,Aragatsotn marz,0,0,0,0,0,0,3637,3637,0,0,0,0,0,0,3495,3495
2006,Armenia,Akhtala,0,0,0,0,1,0,0,1,0,0,0,0,0,0,0,0
2006,Armenia,Agarak ,0,0,0,0,3,0,0,3,0,0,0,0,2,0,0,2
2006,Azerbaijan,Yevlakh,0,0,0,0,0,0,6172,6172,0,0,0,0,0,0,5474,5474
2006,Azerbaijan,Ujar,0,0,0,0,0,0,552,552,0,0,0,0,0,0,490,490
2006,Azerbaijan,Tovuz,0,0,0,0,0,0,15946,15946,0,0,0,0,0,0,14141,14141
2006,Azerbaijan,Tar-Tar,0,0,0,0,0,0,8223,8223,0,0,0,0,0,0,7293,7293
2006,Azerbaijan,Sumgait,0,0,0,0,0,0,23365,23365,0,0,0,0,0,0,20719,20719
2006,Azerbaijan,Shemkir,0,0,0,0,0,0,1019,1019,0,0,0,0,0,0,904,904
2006,Azerbaijan,Sheki,0,0,0,0,0,0,2921,2921,0,0,0,0,0,0,2590,2590
2006,Azerbaijan,Shamakhi,0,0,0,0,0,0,599,599,0,0,0,0,0,0,531,531
2006,Azerbaijan,Samukh,0,0,0,0,0,0,939,939,0,0,0,0,0,0,833,833
2006,Azerbaijan,Salyan,0,0,0,0,0,0,726,726,0,0,0,0,0,0,643,643
2006,Azerbaijan,Sabirabad,0,0,0,0,0,0,9158,9158,0,0,0,0,0,0,8121,8121
2006,Azerbaijan,Saatli,0,0,0,0,0,0,5877,5877,0,0,0,0,0,0,5212,5212
2006,Azerbaijan,Oghuz,0,0,0,0,0,0,1465,1465,0,0,0,0,0,0,1299,1299
2006,Azerbaijan,Nakhichivan,0,0,0,0,0,0,513,513,0,0,0,0,0,0,454,454
2006,Azerbaijan,Naftalan,0,0,0,0,0,0,1573,1573,0,0,0,0,0,0,1395,1395
2006,Azerbaijan,Mingachevir,0,0,0,0,0,0,10089,10089,0,0,0,0,0,0,8947,8947
2006,Azerbaijan,Lachin,0,0,0,0,0,0,7425,7425,0,0,0,0,0,0,6584,6584
2006,Azerbaijan,Kurdemir,0,0,0,0,0,0,1455,1455,0,0,0,0,0,0,1290,1290
2006,Azerbaijan,Khanlar,0,0,0,0,0,0,3191,3191,0,0,0,0,0,0,2830,2830
2006,Azerbaijan,Jalilabad,0,0,0,0,0,0,752,752,0,0,0,0,0,0,666,666
2006,Azerbaijan,Ismayilli,0,0,0,0,0,0,1787,1787,0,0,0,0,0,0,1585,1585
2006,Azerbaijan,Imishli,0,0,0,0,0,0,7069,7069,0,0,0,0,0,0,6269,6269
2006,Azerbaijan,Hajigabul,0,0,0,0,0,0,980,980,0,0,0,0,0,0,869,869
2006,Azerbaijan,Goychay,0,0,0,0,0,0,1053,1053,0,0,0,0,0,0,933,933
2006,Azerbaijan,Goranboy,0,0,0,0,0,0,3840,3840,0,0,0,0,0,0,3406,3406
2006,Azerbaijan,Gebele,0,0,0,0,0,0,1030,1030,0,0,0,0,0,0,913,913
2006,Azerbaijan,Gazakh,0,0,0,0,0,0,19193,19193,0,0,0,0,0,0,17020,17020
2006,Azerbaijan,Ganja,0,0,0,0,0,0,8246,8246,0,0,0,0,0,0,7312,7312
2006,Azerbaijan,Gakh,0,0,0,0,0,0,574,574,0,0,0,0,0,0,509,509
2006,Azerbaijan,Gadebey,0,0,0,0,0,0,7223,7223,0,0,0,0,0,0,6406,6406
2006,Azerbaijan,Fizuli,0,0,0,0,0,0,28800,28800,0,0,0,0,0,0,25539,25539
2006,Azerbaijan,Dashkesen,0,0,0,0,0,0,674,674,0,0,0,0,0,0,598,598
2006,Azerbaijan,Bilasuvar,0,0,0,0,0,0,6685,6685,0,0,0,0,0,0,5929,5929
2006,Azerbaijan,Beylagan ,0,0,0,0,0,0,15268,15268,0,0,0,0,0,0,13539,13539
2006,Azerbaijan,Barda,0,0,0,0,0,0,25432,25432,0,0,0,0,0,0,22552,22552
2006,Azerbaijan,Baku,203,253,0,172,814,34,85625,87101,224,319,0,150,902,22,75932,77549
2006,Azerbaijan,Ali-Bayramli,0,0,0,0,0,0,2359,2359,0,0,0,0,0,0,2092,2092
2006,Azerbaijan,Agstafa,0,0,0,0,0,0,4807,4807,0,0,0,0,0,0,4263,4263
2006,Azerbaijan,Aghsu,0,0,0,0,0,0,940,940,0,0,0,0,0,0,834,834
2006,Azerbaijan,Aghjabedi,0,0,0,0,0,0,9768,9768,0,0,0,0,0,0,8663,8663
2006,Azerbaijan,Aghdash,0,0,0,0,0,0,1785,1785,0,0,0,0,0,0,1582,1582
2006,Azerbaijan,Aghdam,0,0,0,0,0,0,20713,20713,0,0,0,0,0,0,18369,18369
2006,Azerbaijan,Absheron,0,0,0,0,0,0,5349,5349,0,0,0,0,0,0,4744,4744
2006,Burundi,Gihinga,198,242,0,256,508,23,0,1227,152,293,0,253,544,23,0,1265
2006,Burundi,Giharo,20,16,0,16,49,4,0,105,21,19,0,20,43,3,0,106
2006,Burundi,Gasorwe,881,920,0,770,1161,73,0,3805,775,930,0,689,1074,45,0,3513
2006,Burundi,Bujumbura,500,1164,0,1107,2225,99,0,5095,494,1244,0,1100,1981,72,0,4891
2006,Benin,Lokossa,16,0,0,23,112,1,0,152,19,0,0,36,423,1,0,479
2006,Benin,Kpomasse,36,58,0,44,196,1,0,335,43,58,0,54,223,3,0,381
2006,Benin,Cotonou,221,292,0,269,1411,29,0,2222,225,384,0,219,2418,28,0,3274
2006,Benin,Agame,349,0,0,651,1186,40,0,2226,383,0,0,654,2022,18,0,3077
2006,Burkina Faso,Ouagadougou,27,49,0,88,315,0,0,479,13,48,0,61,665,1,0,788
2006,Bangladesh,Dhaka,5,9,0,20,65,3,0,102,4,11,0,11,105,3,0,134
2006,Bangladesh,Nayapara (Cox Bazaar),1416,1988,0,1167,3573,188,0,8332,1450,1985,0,1065,2987,191,0,7678
2006,Bangladesh,Kutapalong (Cox Bazaar),868,1263,0,713,2274,127,0,5245,862,1247,0,751,1924,115,0,4899
2006,Bulgaria,Sofia,0,0,0,0,0,0,60,60,0,0,0,0,0,0,579,579
2006,Bahrain,Manama,1,1,0,1,4,0,0,7,0,1,0,3,7,0,0,11
2006,Bosnia and Herzegovina,Various (Republika Srpska),861,2935,0,2963,24721,8983,1654,42117,863,2966,0,3003,25887,7034,1550,41303
2006,Bosnia and Herzegovina,Various (Federation of BiH),995,2936,0,3043,21240,5884,1245,35343,1012,3014,0,3114,18391,4878,1154,31563
2006,Bosnia and Herzegovina,Brcko district,14,36,0,37,383,162,0,632,17,45,0,47,345,100,0,554
2006,Belarus,Vitebsk Region,2,4,0,1,26,2,0,35,2,4,0,9,30,0,0,45
2006,Belarus,Mogilev Region,1,5,0,4,14,0,0,24,0,1,0,2,23,0,0,26
2006,Belarus,Minsk Region,4,12,0,12,37,4,0,69,2,9,0,9,55,2,0,77
2006,Belarus,Minsk,15,44,0,20,105,6,0,190,10,36,0,17,227,6,0,296
2006,Belarus,Grodno Region,1,1,0,0,7,1,0,10,0,0,0,1,10,0,0,11
2006,Belarus,Gomel Region,0,7,0,5,24,7,0,43,2,8,0,2,42,2,0,56
2006,Belarus,Brest Region,0,0,0,0,2,0,0,2,0,1,0,1,7,0,0,9
2006,Belize,Belize City,0,0,0,29,31,16,0,76,0,0,0,30,50,17,0,97
2006,Bolivia (Plurinational State of),Tarija,0,0,0,0,1,0,0,1,0,0,0,0,1,0,0,1
2006,Bolivia (Plurinational State of),Sucre,0,0,0,0,0,0,0,0,0,0,0,0,1,0,0,1
2006,Bolivia (Plurinational State of),Santa Cruz,0,0,0,0,8,0,0,8,0,0,0,2,17,0,0,19
2006,Bolivia (Plurinational State of),La Paz,6,12,0,21,109,4,0,152,10,17,0,23,166,7,0,223
2006,Bolivia (Plurinational State of),Cochabamba,0,0,0,1,2,0,0,3,0,1,0,0,5,0,0,6
2006,Bolivia (Plurinational State of),Beni,0,0,0,0,0,0,0,0,0,0,0,0,1,0,0,1
2006,Botswana,Gaborone,0,4,0,0,17,0,0,21,0,4,0,41,0,0,0,45
2006,Botswana,Dukwi,332,191,0,0,517,28,0,1068,355,161,0,0,1555,40,0,2111
2006,Central African Rep.,Vakaga,725,963,0,537,2700,90,0,5015,750,970,0,560,2640,65,0,4985
2006,Central African Rep.,Pastoralists,2175,2889,0,1611,8100,270,0,15045,2250,2910,0,1680,7920,195,0,14955
2006,Central African Rep.,Ouham Pende,2175,2889,0,1611,8100,270,0,15045,2250,2910,0,1680,7920,195,0,14955
2006,Central African Rep.,Ouham ,1450,1926,0,1074,5400,180,0,10030,1500,1940,0,1120,5280,130,0,9970
2006,Central African Rep.,Nana -Mambere,1089,1443,0,804,4050,135,0,7521,1125,1455,0,840,3960,99,0,7479
2006,Central African Rep.,Nana -Gribizi,1450,1926,0,1074,5400,180,0,10030,1500,1940,0,1120,5280,130,0,9970
2006,Central African Rep.,Molangue,104,98,0,65,134,3,0,404,107,118,0,67,237,4,0,533
2006,Central African Rep.,Mboki,425,572,0,404,1778,71,0,3250,412,612,0,408,1864,111,0,3407
2006,Central African Rep.,Kbandoro,15,19,0,13,26,0,0,73,22,21,0,11,32,0,0,86
2006,Central African Rep.,Haute Kotto,1089,1443,0,804,4050,135,0,7521,1125,1455,0,840,3960,99,0,7479
2006,Central African Rep.,Bangui,441,484,0,335,1454,16,0,2730,504,468,0,354,2452,23,0,3801
2006,Central African Rep.,Bamingui-Bangoran,450,710,0,280,2050,40,0,3530,435,720,0,310,1990,15,0,3470
2006,Chile,Santiago,40,80,0,70,401,8,0,599,53,89,0,58,667,6,0,873
2006,China,Wenchang,0,0,0,0,0,0,0,0,0,0,0,0,1,0,0,1
2006,China,Shanghai,0,0,0,0,0,0,0,0,0,0,0,0,1,0,0,1
2006,China,Nanjing,0,0,0,0,0,0,0,0,0,0,0,0,2,0,0,2
2006,China,Hangzhou,0,0,0,0,0,0,0,0,0,0,0,0,1,0,0,1
2006,China,Guangzhou,0,0,0,0,0,0,0,0,0,0,0,0,1,0,0,1
2006,China,Beijing,7,9,0,6,42,0,17,81,11,16,0,8,107,2,2,146
2006,China,Beihai,0,0,0,0,0,0,0,0,0,0,0,0,0,1,0,1
2006,Côte d'Ivoire,Yamoussoukro,0,0,0,0,0,0,27075,27075,0,0,0,0,0,0,26552,26552
2006,Côte d'Ivoire,Toulepleu,0,0,0,0,0,0,4523,4523,0,0,0,0,0,0,3820,3820
2006,Côte d'Ivoire,Tabou,1287,2094,0,1452,4223,176,0,9232,1311,1121,0,1241,3217,145,0,7035
2006,Côte d'Ivoire,Nicla,349,341,0,303,1069,58,0,2120,360,325,0,278,841,39,0,1843
2006,Côte d'Ivoire,Guiglo,238,225,0,216,921,57,0,1657,241,189,0,177,606,65,0,1278
2006,Côte d'Ivoire,Duekoue,0,0,0,0,0,0,35456,35456,0,0,0,0,0,0,34357,34357
2006,Côte d'Ivoire,Daloa,0,0,0,0,0,0,42418,42418,0,0,0,0,0,0,39393,39393
2006,Côte d'Ivoire,Abidjan,147,265,0,423,2021,50,257847,260753,200,314,0,444,2491,81,237936,241466
2006,Cameroon,Yaoundé,0,0,0,0,3,1,0,4,0,0,0,2,4,1,0,7
2006,Cameroon,"Douala, Yaoundé",564,889,0,983,4071,54,0,6561,531,924,0,1057,6671,122,0,9305
2006,Cameroon,Northwest/Adamaoua province,256,386,0,231,668,29,0,1570,307,369,0,214,432,56,0,1378
2006,Cameroon,East/Adamaoua province,1864,2633,0,1423,4137,165,0,10222,1890,2792,0,1284,3798,433,0,10197
2006,Dem. Rep. of the Congo,Zomfi,3,5,0,0,5,0,0,13,2,4,0,0,4,0,0,10
2006,Dem. Rep. of the Congo,Uvira/Fizi,1871,3066,0,0,3934,334,0,9205,1817,3178,0,0,3282,202,0,8479
2006,Dem. Rep. of the Congo,Uvira,354,580,0,0,880,55,0,1869,300,532,0,0,551,48,0,1431
2006,Dem. Rep. of the Congo,Pweto,29,85,0,0,72,9,0,195,31,108,0,0,64,3,0,206
2006,Dem. Rep. of the Congo,Orientale,66,86,0,0,191,53,0,396,65,92,0,0,137,75,0,369
2006,Dem. Rep. of the Congo,Nkondo,42,119,0,0,145,17,0,323,42,140,0,0,92,5,0,279
2006,Dem. Rep. of the Congo,Moba,350,779,0,0,861,37,0,2027,320,748,0,0,766,40,0,1874
2006,Dem. Rep. of the Congo,Mfuiki,15,40,0,0,30,1,0,86,20,25,0,0,48,2,0,95
2006,Dem. Rep. of the Congo,Lusuku,29,38,0,0,89,6,0,162,36,32,0,0,76,1,0,145
2006,Dem. Rep. of the Congo,Lume,79,96,0,0,145,160,0,480,122,93,0,0,124,150,0,489
2006,Dem. Rep. of the Congo,Kimaza,48,81,0,0,127,2,0,258,56,102,0,0,215,9,0,382
2006,Dem. Rep. of the Congo,Katsha,60,50,0,0,119,1,0,230,50,45,0,0,156,6,0,257
2006,Dem. Rep. of the Congo,Kalemie,578,1542,0,0,1678,65,0,3863,632,1659,0,0,1348,76,0,3715
2006,Dem. Rep. of the Congo,Isiro,5,3,0,0,7,0,0,15,17,16,0,0,12,4,0,49
2006,Dem. Rep. of the Congo,Goma,17,20,0,0,40,1,0,78,9,26,0,0,39,1,0,75
2006,Dem. Rep. of the Congo,Equateur,1205,1878,0,0,2163,265,0,5511,1358,1908,0,0,1674,204,0,5144
2006,Dem. Rep. of the Congo,Divuma,11,46,0,0,41,6,0,104,18,53,0,0,46,8,0,125
2006,Dem. Rep. of the Congo,Buta,6,8,0,0,10,0,0,24,4,4,0,0,10,1,0,19
2006,Dem. Rep. of the Congo,Bukavu,18,30,0,0,74,4,0,126,28,49,0,0,70,3,0,150
2006,Dem. Rep. of the Congo,Tshimbumbulu,19,27,0,0,42,12,0,100,10,34,0,0,41,13,0,98
2006,Dem. Rep. of the Congo,Tshifwameso,4,19,0,0,22,0,0,45,6,20,0,0,13,0,0,39
2006,Dem. Rep. of the Congo,Tshabobo,60,56,0,0,112,2,0,230,56,47,0,0,138,4,0,245
2006,Dem. Rep. of the Congo,Tseke zole,57,132,0,0,141,2,0,332,58,98,0,0,156,14,0,326
2006,Dem. Rep. of the Congo,Sadi/Zulu,1,5,0,0,3,0,0,9,1,3,0,0,11,0,0,15
2006,Dem. Rep. of the Congo,Rugetsi,312,363,0,0,283,250,0,1208,309,231,0,0,315,296,0,1151
2006,Dem. Rep. of the Congo,Plaine Semliki,47,46,0,0,61,49,0,203,178,75,0,0,74,55,0,382
2006,Dem. Rep. of the Congo,Nlundu Matende,17,62,0,0,75,6,0,160,19,54,0,0,73,11,0,157
2006,Dem. Rep. of the Congo,Napassa,14,24,0,0,24,1,0,63,6,25,0,0,7,0,0,38
2006,Dem. Rep. of the Congo,Mutwanga,110,59,0,0,102,98,0,369,109,260,0,0,131,141,0,641
2006,Dem. Rep. of the Congo,Mbujimayi,1,3,0,0,5,0,0,9,1,6,0,0,13,0,0,20
2006,Dem. Rep. of the Congo,Masambo,263,109,0,0,116,102,0,590,141,184,0,0,189,100,0,614
2006,Dem. Rep. of the Congo,Lumbubashi,0,0,0,0,5,0,0,5,0,0,0,0,10,0,0,10
2006,Dem. Rep. of the Congo,Lubumbashi,16,65,0,0,115,0,0,196,14,53,0,0,110,0,0,177
2006,Dem. Rep. of the Congo,Lubumabashi,11,18,0,0,46,2,0,77,14,18,0,0,41,2,0,75
2006,Dem. Rep. of the Congo,Kulindji,35,98,0,0,77,16,0,226,21,108,0,0,16,3,0,148
2006,Dem. Rep. of the Congo,Kisenge,11,51,0,0,51,5,0,118,14,44,0,0,57,9,0,124
2006,Dem. Rep. of the Congo,Kisanga,220,158,0,0,110,92,0,580,147,177,0,0,126,107,0,557
2006,Dem. Rep. of the Congo,Kinshasa,1376,4259,0,0,7656,1414,0,14705,1301,4188,0,0,7101,1236,0,13826
2006,Dem. Rep. of the Congo,Kinsalulu,11,20,0,0,26,1,0,58,13,29,0,0,10,0,0,52
2006,Dem. Rep. of the Congo,Kinsafu,7,22,0,0,15,1,0,45,5,14,0,0,9,0,0,28
2006,Dem. Rep. of the Congo,Kimpindi,4,8,0,0,9,2,0,23,7,15,0,0,3,0,0,25
2006,Dem. Rep. of the Congo,Kimfwakata,9,15,0,0,12,0,0,36,6,17,0,0,7,0,0,30
2006,Dem. Rep. of the Congo,Kimbianga,18,46,0,0,61,6,0,131,19,42,0,0,68,9,0,138
2006,Dem. Rep. of the Congo,Kilueka,101,254,0,0,355,35,0,745,93,322,0,0,271,28,0,714
2006,Dem. Rep. of the Congo,Kikingi-Kikura,178,194,0,0,150,102,0,624,158,185,0,0,131,118,0,592
2006,Dem. Rep. of the Congo,Kasindi Port,59,56,0,0,98,56,0,269,121,82,0,0,68,47,0,318
2006,Dem. Rep. of the Congo,Kamango,312,529,0,0,474,144,0,1459,176,299,0,0,177,99,0,751
2006,Dem. Rep. of the Congo,Kainama,365,472,0,0,427,278,0,1542,311,271,0,0,246,243,0,1071
2006,Dem. Rep. of the Congo,Ingbokolo,83,107,0,0,392,14,0,596,61,72,0,0,493,27,0,653
2006,Dem. Rep. of the Congo,Fizi (Baraka),114,193,0,0,341,41,0,689,110,197,0,0,247,26,0,580
2006,Dem. Rep. of the Congo,Dungu-Centre,8,13,0,0,29,26,0,76,4,2,0,0,22,6,0,34
2006,Dem. Rep. of the Congo,Dungu (Kpezu),27,16,0,0,40,2,0,85,18,16,0,0,54,8,0,96
2006,Dem. Rep. of the Congo,Dungu (Kaka2),31,29,0,0,53,16,0,129,31,22,0,0,67,24,0,144
2006,Dem. Rep. of the Congo,Dungu (Kaka1),13,27,0,0,36,0,0,76,21,17,0,0,26,1,0,65
2006,Dem. Rep. of the Congo,Doruma-Centre,33,45,0,0,92,41,0,211,32,27,0,0,104,47,0,210
2006,Dem. Rep. of the Congo,Doruma-Bangalu,4,22,0,0,52,22,0,100,2,31,0,0,90,23,0,146
2006,Dem. Rep. of the Congo,Doruma-Bangadi,12,9,0,0,23,2,0,46,1,8,0,0,36,6,0,51
2006,Dem. Rep. of the Congo,Doruma (Mandofi),41,90,0,0,193,36,0,360,75,105,0,0,185,36,0,401
2006,Dem. Rep. of the Congo,Bas-Congo,5993,13694,0,0,21833,2973,0,44493,5899,14599,0,0,16608,2793,0,39899
2006,Dem. Rep. of the Congo,Bangalu Afflux,330,253,0,0,210,127,0,920,178,243,0,0,200,153,0,774
2006,Dem. Rep. of the Congo,Aru-Centre,13,7,0,0,22,0,0,42,9,0,0,0,7,1,0,17
2006,Dem. Rep. of the Congo,Ariwara,6,85,0,0,117,57,0,265,50,147,0,0,233,96,0,526
2006,Dem. Rep. of the Congo,Aba-Centre,0,1,0,0,0,0,0,1,0,0,0,0,4,0,0,4
2006,Congo,Tchitanzi,14,16,0,23,79,5,0,137,27,31,0,38,92,3,0,191
2006,Congo,Tchiamba-Nzassi,48,42,0,54,115,3,0,262,47,52,0,41,142,2,0,284
2006,Congo,Sangha,18,73,0,93,259,1,0,444,14,66,0,113,344,2,0,539
2006,Congo,Pointe-Noire,12,14,0,24,116,4,0,170,11,21,0,40,169,3,0,244
2006,Congo,Oyo,6,5,0,8,21,0,0,40,3,7,0,8,31,0,0,49
2006,Congo,Owando,0,0,0,0,3,0,0,3,0,0,0,1,6,0,0,7
2006,Congo,Ollombo,0,0,0,1,1,0,0,2,0,1,0,2,2,0,0,5
2006,Congo,Okoyo,1,0,0,0,4,0,0,5,1,0,0,0,3,0,0,4
2006,Congo,Ngo,6,8,0,7,26,0,0,47,5,7,0,13,40,0,0,65
2006,Congo,Ndjoundou/Liranga,191,302,0,274,601,33,0,1401,302,213,0,288,575,32,0,1410
2006,Congo,Mpouya,0,2,0,1,0,0,0,3,0,0,0,0,1,0,0,1
2006,Congo,Malolo/Loudima,14,42,0,66,110,5,0,237,11,38,0,44,134,2,0,229
2006,Congo,Makoua,0,1,0,3,4,0,0,8,1,0,0,2,11,0,0,14
2006,Congo,Makotipoko,3,2,0,6,9,0,0,20,1,1,0,4,17,0,0,23
2006,Congo,Loukolela,370,165,0,217,566,16,0,1334,201,207,0,289,792,17,0,1506
2006,Congo,Kondi Mbaka,21,49,0,68,212,4,0,354,38,71,0,84,188,2,0,383
2006,Congo,Komi,7,12,0,18,47,1,0,85,9,11,0,15,58,3,0,96
2006,Congo,Kintele,5,29,0,36,351,2,0,423,12,76,0,104,458,15,0,665
2006,Congo,Impfondo,3004,3293,0,4175,7316,626,0,18414,2910,3891,0,3758,6428,535,0,17522
2006,Congo,Gamboma,0,1,0,0,4,0,0,5,0,1,0,2,4,0,0,7
2006,Congo,Dolisie,7,14,0,23,51,2,0,97,9,16,0,17,41,3,0,86
2006,Congo,Djambala,3,3,0,5,9,0,0,20,4,3,0,4,15,0,0,26
2006,Congo,Brazzaville,37,254,0,357,916,8,0,1572,154,318,0,322,1070,57,0,1921
2006,Congo,Boundji/Obouya,1,0,0,2,3,0,0,6,0,0,0,1,3,0,0,4
2006,Congo,Bouemba,1,0,0,2,7,0,0,10,0,1,0,3,14,0,0,18
2006,Congo,Betou,515,444,0,556,995,185,0,2695,467,497,0,586,993,94,0,2637
2006,Colombia,Tulua,0,0,0,0,0,0,0,0,0,0,0,0,1,0,0,1
2006,Colombia,San Andres,0,0,0,0,2,0,0,2,0,0,0,1,1,0,0,2
2006,Colombia,Medellin,0,0,0,0,0,1,0,1,0,0,0,0,1,0,0,1
2006,Colombia,Maicao,0,0,0,0,1,0,0,1,0,0,0,0,0,0,0,0
2006,Colombia,Ibague,0,0,0,0,2,0,0,2,0,0,0,0,2,0,0,2
2006,Colombia,Duitama,0,0,0,0,1,1,0,2,0,0,0,0,0,0,0,0
2006,Colombia,Cucuta,1,0,0,0,7,0,0,8,1,1,0,0,17,0,0,19
2006,Colombia,Charala,0,0,0,0,0,0,0,0,0,0,0,0,0,1,0,1
2006,Colombia,Cartagena,0,0,0,0,2,0,0,2,0,0,0,0,8,0,0,8
2006,Colombia,Cali,0,0,0,0,1,0,0,1,0,0,0,0,3,1,0,4
2006,Colombia,Buenaventura,0,0,0,2,2,0,0,4,0,3,0,0,1,0,0,4
2006,Colombia,Bucaramanga,0,0,0,0,1,0,0,1,0,0,0,0,3,0,0,3
2006,Colombia,Bogota,4,3,0,5,29,7,0,48,3,6,0,2,86,6,0,103
2006,Costa Rica,San Jose,13,9,0,7,227,1,0,257,6,18,0,7,485,2,0,518
2006,Cuba,Villaclara,0,0,0,0,1,0,0,1,0,0,0,0,31,0,0,31
2006,Cuba,Santiago Cuba,0,0,0,0,0,0,0,0,0,0,0,0,13,0,0,13
2006,Cuba,Sancti Spiritus,0,0,0,0,0,0,0,0,0,0,0,0,1,0,0,1
2006,Cuba,Pinar del Río,0,0,0,0,0,0,0,0,0,0,0,0,24,0,0,24
2006,Cuba,Matanzas,0,0,0,0,0,0,0,0,0,0,0,1,16,0,0,17
2006,Cuba,Las Tunas,0,0,0,0,0,0,0,0,0,0,0,0,24,0,0,24
2006,Cuba,Isla Juventud,0,0,0,0,0,0,0,0,0,0,0,94,267,0,0,361
2006,Cuba,Holguín,0,0,0,0,0,0,0,0,0,0,0,0,42,0,0,42
2006,Cuba,Havanna,1,2,0,0,23,0,0,26,0,2,0,2,64,1,0,69
2006,Cuba,Guantánamo,0,0,0,0,0,0,0,0,0,0,0,0,14,0,0,14
2006,Cuba,Granma,0,0,0,0,0,0,0,0,0,0,0,0,13,0,0,13
2006,Cuba,Cienfuegos,0,0,0,0,0,0,0,0,0,0,0,0,14,0,0,14
2006,Cuba,Ciego de Avila,0,0,0,0,0,0,0,0,0,0,0,0,3,0,0,3
2006,Cuba,Camagüey,0,0,0,0,1,0,0,1,0,0,0,0,40,0,0,40
2006,Czech Rep.,IAS Predlice,0,0,0,0,0,0,15,15,0,0,0,0,0,0,19,19
2006,Czech Rep.,IAS Jaromer,0,0,0,0,0,0,11,11,0,0,0,0,0,0,15,15
2006,Czech Rep.,IAS Havirov,0,0,0,0,0,0,16,16,0,0,0,0,0,0,22,22
2006,Czech Rep.,IAS Zastavka u Brna,0,0,0,0,0,0,15,15,0,0,0,0,0,0,20,20
2006,Czech Rep.,IAS Straz pod Ralskem,0,0,0,0,0,0,19,19,0,0,0,0,0,0,25,25
2006,Djibouti,Djibouti,0,0,0,0,5,0,0,5,0,0,0,0,11,0,0,11
2006,Algeria,Algiers,0,7,0,0,21,0,0,28,2,11,0,3,131,0,0,147
2006,Egypt,Cairo,7754,10239,0,6391,21087,1139,0,46610,8562,7440,0,11597,29457,801,0,57857
2006,Eritrea,Emkulu,396,391,0,165,705,31,0,1688,458,380,0,264,1016,32,0,2150
2006,Eritrea,Elit,55,63,0,46,116,3,0,283,77,81,0,32,346,16,0,552
2006,Eritrea,Dekemhare,1,0,0,0,1,0,0,2,0,0,0,0,9,0,0,9
2006,Eritrea,Asmara,118,147,0,101,547,56,0,969,127,169,0,85,565,30,0,976
2006,Eritrea,Afabet,0,0,0,0,0,0,0,0,0,0,0,0,28,0,0,28
2006,Estonia,Tartu,0,0,0,0,0,0,0,0,0,0,0,0,1,0,0,1
2006,Estonia,Kohtla-Järve,0,0,0,0,0,0,0,0,0,0,0,0,0,1,0,1
2006,Estonia,Illuka,0,0,0,0,2,0,0,2,0,0,0,0,3,0,0,3
2006,Ethiopia,Yarenja (Bamboudi),217,239,0,132,381,25,0,994,194,238,0,146,412,49,0,1039
2006,Ethiopia,Sherkole (Assosa),1281,1597,0,824,2948,97,0,6747,1300,1735,0,1128,2956,92,0,7211
2006,Ethiopia,Kebribeyah (Jijiga),1454,2010,0,1091,3661,140,0,8356,1493,1989,0,1222,3136,203,0,8043
2006,Ethiopia,Fugnido (Gambella),2713,3422,0,1469,6428,176,0,14208,2904,3510,0,2090,4386,77,0,12967
2006,Ethiopia,Dimma (Gambella),719,858,0,410,1701,49,0,3737,762,909,0,818,2375,24,0,4888
2006,Ethiopia,Bonga (Gambella),1962,1970,0,724,3287,91,0,8034,2074,2071,0,751,2367,60,0,7323
2006,Ethiopia,Addis Ababa,30,60,0,40,163,9,0,302,34,44,0,50,279,4,0,411
2006,Ethiopia,Shimelba (Shire/Shiraro),494,557,0,392,1720,171,0,3334,533,569,0,435,7958,214,0,9709
2006,Fiji,Suva,0,0,0,0,0,0,0,0,0,0,0,0,2,0,0,2
2006,Micronesia (Federated States of),Yapp,0,0,0,0,0,0,0,0,0,0,0,0,2,0,0,2
2006,Gabon,Voungou/Pont,4,7,0,1,14,2,0,28,8,7,0,4,12,0,0,31
2006,Gabon,Tchibanga,131,138,0,77,375,12,0,733,140,131,0,82,375,10,0,738
2006,Gabon,Sindara,0,0,0,0,0,0,0,0,0,0,0,0,1,0,0,1
2006,Gabon,Rinanzala,9,14,0,2,23,2,0,50,8,13,0,5,24,2,0,52
2006,Gabon,Port-Gentil,18,22,0,35,129,0,0,204,29,28,0,12,174,6,0,249
2006,Gabon,Pana/Dienga,0,0,0,0,1,0,0,1,0,0,0,1,6,0,0,7
2006,Gabon,Oyem,0,0,0,3,5,0,0,8,1,1,0,2,14,0,0,18
2006,Gabon,Okondja,4,2,0,1,3,0,0,10,2,1,0,1,38,0,0,42
2006,Gabon,Nzinga,4,3,0,4,7,2,0,20,3,2,0,4,5,0,0,14
2006,Gabon,Ntoum,0,1,0,0,2,0,0,3,1,0,0,0,1,0,0,2
2006,Gabon,Ngouoni,2,0,0,0,2,0,0,4,0,0,0,0,17,0,0,17
2006,Gabon,Ndjole,1,1,0,1,2,0,0,5,1,1,0,1,6,0,0,9
2006,Gabon,Ndendé,42,32,0,27,103,6,0,210,30,30,0,25,79,0,0,164
2006,Gabon,Mounana,8,14,0,13,27,1,0,63,11,14,0,3,89,1,0,118
2006,Gabon,Moulengui-Binza Commune,33,42,0,14,76,13,0,178,36,41,0,35,57,6,0,175
2006,Gabon,Mouila,33,54,0,31,153,1,0,272,48,60,0,30,192,0,0,330
2006,Gabon,Moanda,81,154,0,106,408,18,0,767,63,162,0,87,458,14,0,784
2006,Gabon,Mitzic,0,0,0,0,1,0,0,1,0,0,0,0,3,0,0,3
2006,Gabon,Mékambo,0,0,0,0,0,0,0,0,0,0,0,0,2,1,0,3
2006,Gabon,Mayumba,1,2,0,4,12,0,0,19,2,1,0,0,17,0,0,20
2006,Gabon,Makokou,0,0,0,2,1,0,0,3,0,1,0,1,14,0,0,16
2006,Gabon,Mabanda,11,3,0,9,21,1,0,45,8,4,0,7,27,3,0,49
2006,Gabon,Lope,1,0,0,3,2,0,0,6,0,1,0,0,5,0,0,6
2006,Gabon,Libreville,197,266,0,233,887,20,0,1603,172,278,0,207,1629,50,0,2336
2006,Gabon,Lékindou,3,0,0,9,9,0,0,21,0,1,0,0,4,2,0,7
2006,Gabon,Lébamba,11,11,0,4,18,1,0,45,4,7,0,3,16,1,0,31
2006,Gabon,Lastourville,3,10,0,10,25,1,0,49,3,10,0,4,45,1,0,63
2006,Gabon,Lambarené,2,0,0,1,12,0,0,15,6,4,0,2,24,1,0,37
2006,Gabon,Koumou-Doussala,3,2,0,3,4,2,0,14,1,2,0,3,1,1,0,8
2006,Gabon,Koulamoutou,12,22,0,17,44,2,0,97,13,19,0,13,108,4,0,157
2006,Gabon,Gamba,13,12,0,12,70,0,0,107,16,12,0,1,85,0,0,114
2006,Gabon,Franceville,67,127,0,73,424,9,0,700,64,131,0,89,773,20,0,1077
2006,Gabon,Four place,0,0,0,1,1,0,0,2,0,2,0,1,0,0,0,3
2006,Gabon,Fougamou,1,0,0,0,2,0,0,3,0,0,0,1,4,0,0,5
2006,Gabon,Doussala,1,3,0,0,6,1,0,11,4,6,0,1,3,0,0,14
2006,Gabon,Dilemba,24,27,0,31,53,8,0,143,23,31,0,25,56,8,0,143
2006,Gabon,Boumango,6,10,0,2,6,2,0,26,3,5,0,0,10,1,0,19
2006,Gabon,Booue,1,0,0,0,1,0,0,2,1,0,0,0,6,0,0,7
2006,Gabon,Bongoville,1,1,0,0,1,0,0,3,0,0,0,0,3,0,0,3
2006,Gabon,Bitam,0,0,0,0,2,0,0,2,1,0,0,0,5,0,0,6
2006,Gabon,Bibora,4,0,0,5,11,2,0,22,2,0,0,6,7,2,0,17
2006,Gabon,Banda-Mamba,6,0,0,3,10,0,0,19,1,3,0,2,2,2,0,10
2006,Gabon,Bakoumba,7,17,0,6,25,1,0,56,7,10,0,5,10,1,0,33
2006,Gabon,Akiéni,0,0,0,2,2,0,0,4,2,0,0,2,8,0,0,12
2006,Gabon,Moulengui-Binza Frontiere,1,2,0,8,3,0,0,14,3,2,0,10,3,0,0,18
2006,Georgia,Tbilisi,0,0,0,1,4,3,0,8,0,1,0,4,5,1,0,11
2006,Ghana,Volta,631,663,0,344,1887,146,0,3671,626,646,0,367,1419,68,0,3126
2006,Ghana,Tamale,0,0,0,0,0,0,0,0,0,1,0,0,1,0,0,2
2006,Ghana,Kumasi,0,1,0,0,1,0,0,2,1,1,0,2,1,0,0,5
2006,Ghana,Krisan,107,107,0,62,317,13,0,606,83,99,0,53,855,9,0,1099
2006,Ghana,Buduburam,721,3504,0,3046,10664,552,0,18487,701,2660,0,2447,11598,266,0,17672
2006,Ghana,Accra,263,499,0,253,1352,56,0,2423,316,545,0,241,2298,42,0,3442
2006,Guinea,Nzerekore,3,4,0,9,23,0,0,39,3,8,0,21,25,0,0,57
2006,Guinea,Laine,597,1552,0,1023,2778,167,0,6117,692,1493,0,988,2013,103,0,5289
2006,Guinea,Kouankan 2,251,475,0,285,630,49,0,1690,190,472,0,304,456,34,0,1456
2006,Guinea,Kouankan,423,966,0,594,1677,105,0,3765,480,915,0,611,1275,80,0,3361
2006,Guinea,Conakry,286,888,0,1081,3284,57,0,5596,331,960,0,1339,4333,119,0,7082
2006,Guinea,Boreah,52,76,0,51,183,9,0,371,67,82,0,53,308,22,0,532
2006,Guinea-Bissau,Jolmette,53,78,0,41,124,9,0,305,55,29,0,84,99,14,0,281
2006,Guinea-Bissau,Frontiere Sn,634,1382,0,921,511,110,0,3558,667,571,0,769,1145,158,0,3310
2006,Guinea-Bissau,Bissau,30,33,0,36,115,4,0,218,43,80,0,61,248,17,0,449
2006,Greece,Athens,0,0,0,10,219,0,0,229,0,0,0,272,2448,7,0,2727
2006,Guatemala,Guatemala City,0,0,0,0,186,27,0,213,0,0,0,4,141,27,0,172
2006,"China, Hong Kong SAR",Hong Kong,10,7,0,4,333,0,699,1053,14,7,0,11,2141,1,1120,3294
2006,Honduras,Tegucigalpa,0,0,0,0,3,0,0,3,0,0,0,2,14,1,0,17
2006,Honduras,San Pedro Sula,0,0,0,0,0,0,0,0,0,0,0,0,2,0,0,2
2006,Croatia,Kutina,0,1,0,0,3,0,0,4,0,1,0,3,2,0,0,6
2006,Hungary,Nyirbátor,0,0,0,0,0,0,13,13,0,0,0,0,0,0,51,51
2006,Indonesia,Mataram,0,3,0,0,3,1,0,7,2,3,0,12,0,0,0,17
2006,Indonesia,Makassar,0,0,0,0,0,0,0,0,0,0,0,8,84,0,0,92
2006,Indonesia,Jakarta/Bogor,4,4,0,3,26,0,0,37,1,7,0,2,98,0,0,108
2006,Indonesia,Jakarta,6,10,0,6,22,1,0,45,4,17,0,11,211,0,0,243
2006,Indonesia,Belawan,0,0,0,0,0,0,0,0,0,1,0,0,15,0,0,16
2006,Indonesia,Bali,0,0,0,0,0,0,0,0,0,0,0,0,1,0,0,1
2006,India,Tamil Nadu,0,0,0,0,0,0,33947,33947,0,0,0,0,0,0,35662,35662
2006,India,New Delhi,292,547,0,1108,4072,306,0,6325,343,701,0,1200,3375,297,0,5916
2006,Iran (Islamic Rep. of),Zanjan,1,3,0,0,6,0,0,10,1,3,0,3,8,1,0,16
2006,Iran (Islamic Rep. of),West Azarbaijan,65,224,0,16,407,24,0,736,69,243,0,180,569,40,0,1101
2006,Iran (Islamic Rep. of),Tehran,30,42,0,42,145,5,0,264,35,49,0,49,220,8,0,361
2006,Iran (Islamic Rep. of),Semnan,98,337,0,24,610,36,0,1105,104,366,0,271,854,61,0,1656
2006,Iran (Islamic Rep. of),Mashad,21,27,0,28,53,2,0,131,20,31,0,20,59,0,0,130
2006,Iran (Islamic Rep. of),Markazi,138,475,0,34,859,50,0,1556,147,515,0,382,1202,87,0,2333
2006,Iran (Islamic Rep. of),Lorestan,33,114,0,8,206,12,0,373,35,124,0,92,290,21,0,562
2006,Iran (Islamic Rep. of),Kurdestan,3,9,0,1,17,1,0,31,3,10,0,7,23,2,0,45
2006,Iran (Islamic Rep. of),Khuzestan,7,24,0,2,43,3,0,79,7,26,0,19,60,3,0,115
2006,Iran (Islamic Rep. of),Khorasan,175,605,0,44,1095,64,0,1983,187,656,0,487,1532,110,0,2972
2006,Iran (Islamic Rep. of),Kermanshah,7,25,0,2,45,3,0,82,8,27,0,20,63,5,0,123
2006,Iran (Islamic Rep. of),Kerman,450,1553,0,112,2810,165,0,5090,480,1683,0,1250,3931,281,0,7625
2006,Iran (Islamic Rep. of),Fars,63,218,0,16,394,23,0,714,67,236,0,175,552,40,0,1070
2006,Iran (Islamic Rep. of),Bushehr,75,259,0,19,469,28,0,850,80,281,0,209,657,47,0,1274
2006,Iran (Islamic Rep. of),Ahwaz,1,0,0,0,4,1,0,6,0,0,0,0,4,0,0,4
2006,Iran (Islamic Rep. of),Zahedan,8,16,0,4,29,0,0,57,9,15,0,8,33,1,0,66
2006,Iraq,Wassit-Dijaila,0,3,0,2,8,0,0,13,1,1,0,3,5,1,0,11
2006,Iraq,Wassit,46,100,0,77,225,35,0,483,50,98,0,66,217,16,0,447
2006,Iraq,Sulaymaniyah-Sherwan,0,0,0,1,4,1,0,6,0,0,0,2,3,0,0,5
2006,Iraq,Sulaymaniyah-Khaniqen,0,1,0,1,7,2,0,11,0,0,0,0,7,1,0,8
2006,Iraq,Sulaymaniyah-Kalar,0,0,0,0,2,0,0,2,0,0,0,0,0,0,0,0
2006,Iraq,Sulaymaniyah-Barika,77,174,0,150,473,38,0,912,80,183,0,194,481,50,0,988
2006,Iraq,Sulaymaniyah,202,454,0,384,1248,98,0,2386,209,482,0,504,1312,129,0,2636
2006,Iraq,Salah al-Hudin-Beiji,1,2,0,3,17,1,0,24,1,5,0,5,13,0,0,24
2006,Iraq,Salah al-Hudin,0,0,0,0,0,0,0,0,0,0,0,0,3,0,0,3
2006,Iraq,No man's land (Syria),33,39,0,22,102,4,0,200,24,31,0,35,160,10,0,260
2006,Iraq,No man's land (Jordan),0,0,0,0,0,0,0,0,2,0,0,0,1,0,0,3
2006,Iraq,No man's land,10,23,0,22,38,0,0,93,7,23,0,18,57,0,0,105
2006,Iraq,Ninewa-Makhmour,687,1200,0,1040,2809,289,0,6025,727,1188,0,1012,2671,277,0,5875
2006,Iraq,Mousil,6,17,0,25,73,3,0,124,16,14,0,17,69,4,0,120
2006,Iraq,Missan - Ali-Al-Gharbi,0,1,0,1,0,0,0,2,0,0,0,1,1,0,0,2
2006,Iraq,Missan,15,32,0,25,73,11,0,156,16,32,0,21,70,5,0,144
2006,Iraq,Kiruk,0,0,0,0,3,0,0,3,0,0,0,1,1,0,0,2
2006,Iraq,Kirkuk,0,1,0,0,2,0,0,3,1,1,0,0,2,1,0,5
2006,Iraq,Karbala,0,2,0,0,10,0,0,12,0,0,0,1,2,3,0,6
2006,Iraq,Erbil-Koya,0,4,0,4,14,0,0,22,1,2,0,2,17,3,0,25
2006,Iraq,Erbil-Kawa,61,133,0,131,344,25,0,694,61,156,0,137,342,32,0,728
2006,Iraq,Erbil-Hareer,11,32,0,38,62,7,0,150,12,31,0,28,56,3,0,130
2006,Iraq,Erbil-Degala,0,0,0,1,2,0,0,3,0,0,0,1,3,0,0,4
2006,Iraq,Erbil - Koya,4,1,0,1,7,0,0,13,2,2,0,3,11,0,0,18
2006,Iraq,Erbil,19,109,0,74,335,25,0,562,21,88,0,84,565,27,0,785
2006,Iraq,Dohuk-Zakho,11,19,0,14,17,1,0,62,9,19,0,21,19,1,0,69
2006,Iraq,Dohuk-Sumeil,1,0,0,0,7,0,0,8,0,0,0,0,7,0,0,7
2006,Iraq,Dohuk-Muqible,0,0,0,0,0,0,0,0,0,0,0,0,1,0,0,1
2006,Iraq,Dohuk-Moquble,35,122,0,96,56,5,0,314,43,137,0,147,74,7,0,408
2006,Iraq,Dohuk-Messirike,0,0,0,0,7,0,0,7,3,0,0,0,9,1,0,13
2006,Iraq,Dohuk-Meserike,1,3,0,2,1,0,0,7,1,4,0,4,2,0,0,11
2006,Iraq,Dohuk-Hussainiya,0,0,0,0,2,0,0,2,0,0,0,0,1,0,0,1
2006,Iraq,Dohuk-Dohuk,13,7,0,3,51,0,0,74,9,10,0,8,50,0,0,77
2006,Iraq,Dohuk-Balqus,5,9,0,12,12,0,0,38,7,9,0,6,17,0,0,39
2006,Iraq,Dohuk (Various),2,0,0,0,21,0,0,23,3,1,0,0,19,0,0,23
2006,Iraq,Diwaniya-Diwaniya,3,2,0,0,13,0,0,18,1,1,0,2,10,2,0,16
2006,Iraq,Diwaniya,8,18,0,14,40,6,0,86,9,17,0,12,38,3,0,79
2006,Iraq,Diala-Khalis,4,13,0,11,51,5,0,84,2,13,0,15,34,6,0,70
2006,Iraq,Diala-Baquba,0,1,0,1,2,0,0,4,1,0,0,0,1,1,0,3
2006,Iraq,Dahuk-Zakho,10,8,0,2,15,1,0,36,1,15,0,5,12,1,0,34
2006,Iraq,Dahuk- Zakho,50,102,0,49,127,3,0,331,63,94,0,66,116,3,0,342
2006,Iraq,Dahuk- Teldif,3,9,0,4,15,1,0,32,3,2,0,3,11,1,0,20
2006,Iraq,Dahuk- Sumeil,6,3,0,3,11,0,0,23,1,2,0,5,12,0,0,20
2006,Iraq,Dahuk- Sersink,2,2,0,4,13,1,0,22,4,4,0,5,14,0,0,27
2006,Iraq,Dahuk- Muqible,0,0,0,0,0,0,0,0,0,0,0,0,1,0,0,1
2006,Iraq,Dahuk- Muqibla,3,2,0,1,8,1,0,15,6,5,0,4,10,0,0,25
2006,Iraq,Dahuk- Mesirike,90,121,0,75,259,32,0,577,86,107,0,101,226,19,0,539
2006,Iraq,Dahuk- Malaparwan,7,14,0,11,19,2,0,53,11,13,0,6,20,0,0,50
2006,Iraq,Dahuk- Kure Gavana,0,1,0,5,13,1,0,20,0,1,0,4,16,1,0,22
2006,Iraq,Dahuk- Hussainiya,38,62,0,44,111,18,0,273,52,69,0,44,106,15,0,286
2006,Iraq,Dahuk- Grey Gewry,78,93,0,60,174,7,0,412,76,96,0,65,158,11,0,406
2006,Iraq,Dahuk- Dohuk,39,61,0,46,116,6,0,268,51,70,0,53,104,2,0,280
2006,Iraq,Dahuk- Daratoo,25,49,0,42,120,6,0,242,35,63,0,60,118,7,0,283
2006,Iraq,Dahuk- Balqus,7,6,0,7,17,1,0,38,6,11,0,11,18,0,0,46
2006,Iraq,Basrah,53,116,0,91,264,40,0,564,58,114,0,77,257,19,0,525
2006,Iraq,Baghdad,243,1050,0,1020,4173,609,0,7095,263,1112,0,1044,4221,646,0,7286
2006,Iraq,Babylon-Hilla,1,5,0,8,28,2,0,44,4,3,0,6,30,7,0,50
2006,Iraq,Anbar-Ramadi,3,5,0,4,20,3,0,35,0,3,0,3,18,3,0,27
2006,Iraq,Anbar-Al Tash,16,29,0,36,76,7,0,164,8,31,0,30,82,7,0,158
2006,Iraq,Anbar,6,6,0,2,10,0,0,24,4,8,0,2,99,1,0,114
2006,Jordan,Amman,488,1201,0,975,4708,391,0,7763,503,1227,0,1082,9190,420,0,12422
2006,Kazakhstan,Almaty,54,15,0,82,178,0,7,336,52,18,0,70,298,1,14,453
2006,Kenya,Nairobi,680,2173,0,1953,9107,189,0,14102,919,2619,0,2389,14050,928,0,20905
2006,Kenya,Kakuma,5535,7948,0,5253,17136,828,0,36700,6072,9583,0,8821,28604,677,0,53757
2006,Kenya,Ifo (Dadaab),3556,5049,0,3502,13695,767,0,26569,3728,5564,0,4243,13218,835,0,27588
2006,Kenya,Hagadera (Dadaab),3929,5348,0,3730,15211,829,0,29047,4113,5672,0,4331,15083,939,0,30138
2006,Kenya,Dagahaley (Dadaab),2707,3856,0,2687,9543,528,0,19321,2905,4202,0,3207,9240,651,0,20205
2006,Kenya,Dadaab,831,1175,0,802,3153,165,0,6126,878,1254,0,955,3307,194,0,6588
2006,Kyrgyzstan,Talas region,0,0,0,0,0,0,130,130,0,0,0,0,0,0,90,90
2006,Kyrgyzstan,Osh region,7,4,0,9,43,5,60,128,9,9,0,12,54,7,20,111
2006,Kyrgyzstan,Osh,0,1,0,2,7,0,70,80,1,0,0,1,26,0,80,108
2006,Kyrgyzstan,Naryn region,0,0,0,0,0,0,0,0,0,0,0,0,0,0,10,10
2006,Kyrgyzstan,Issyk-Kul region,0,0,0,1,4,0,190,195,0,0,0,1,2,0,160,163
2006,Kyrgyzstan,Djalalabat region,0,0,0,4,1,1,210,216,1,0,0,2,3,1,170,177
2006,Kyrgyzstan,Chui region,8,15,0,129,305,36,3250,3743,15,20,0,124,308,17,3120,3604
2006,Kyrgyzstan,Bishkek,30,35,0,54,164,10,1060,1353,13,32,0,66,302,10,1130,1553
2006,Kyrgyzstan,Batken region,1,0,0,2,6,1,130,140,2,2,0,1,13,1,120,139
2006,Cambodia,Phnom Penh,7,12,0,12,69,0,0,100,11,16,0,21,146,1,0,195
2006,Rep. of Korea,Seoul/Kyunggi,8,1,0,0,133,11,0,153,8,3,0,0,542,4,0,557
2006,Kuwait,Kuwait,24,44,0,60,123,5,0,256,28,35,0,34,217,5,0,319
2006,Liberia,Voa,99,133,0,159,371,25,0,787,117,207,0,204,506,29,0,1063
2006,Liberia,Sinoe,0,0,0,0,0,0,1592,1592,0,0,0,0,0,0,2337,2337
2006,Liberia,Samukai,72,81,0,72,179,8,0,412,92,69,0,58,292,7,0,518
2006,Liberia,Saclepea,62,98,0,81,173,23,0,437,98,67,0,87,167,34,0,453
2006,Liberia,River Gee,0,0,0,0,0,0,765,765,0,0,0,0,0,0,761,761
2006,Liberia,River Cess,0,0,0,0,0,0,2097,2097,0,0,0,0,0,0,1898,1898
2006,Liberia,Nimba,71,127,0,159,1483,48,4257,6145,66,111,0,209,1507,52,4251,6196
2006,Liberia,Montserrado,0,0,0,0,0,0,5765,5765,0,0,0,0,0,0,5332,5332
2006,Liberia,Monrovia,7,9,0,20,21,0,0,57,6,11,0,11,117,0,0,145
2006,Liberia,Maryland,22,41,0,27,74,11,1206,1381,37,35,0,42,90,5,1776,1985
2006,Liberia,Margibi,0,0,0,0,0,0,1082,1082,0,0,0,0,0,0,1069,1069
2006,Liberia,Lofa,0,0,0,0,0,0,91495,91495,0,0,0,0,0,0,90413,90413
2006,Liberia,Grand Kru,0,0,0,0,0,0,108,108,0,0,0,0,0,0,130,130
2006,Liberia,Grand Gedeh,89,109,0,145,3381,56,1361,5141,103,96,0,129,3243,89,1691,5351
2006,Liberia,Grand Cape Mount,0,0,0,0,0,0,8734,8734,0,0,0,0,0,0,8240,8240
2006,Liberia,Grand Bassa,0,0,0,0,0,0,2441,2441,0,0,0,0,0,0,2576,2576
2006,Liberia,Gbarpolu,0,0,0,0,0,0,17088,17088,0,0,0,0,0,0,17443,17443
2006,Liberia,Bong,0,0,0,0,0,0,19887,19887,0,0,0,0,0,0,19315,19315
2006,Liberia,Bomi,0,0,0,0,0,0,15817,15817,0,0,0,0,0,0,14713,14713
2006,Liberia,Banjor,13,78,0,87,189,1,0,368,31,75,0,88,151,4,0,349
2006,Libya,Tripoli,67,200,0,250,1245,59,0,1821,99,214,0,273,2226,121,0,2933
2006,Liechtenstein,Vaduz,0,0,0,0,0,0,11,11,0,0,0,0,0,0,14,14
2006,Sri Lanka,Vavuniya,0,1,0,1,4,1,19899,19906,2,0,0,1,1,1,19118,19123
2006,Sri Lanka,Trincomalee,0,0,0,0,0,0,4088,4088,0,0,0,0,0,0,3928,3928
2006,Sri Lanka,Puttalam,0,0,0,0,0,0,31838,31838,0,0,0,0,0,0,30590,30590
2006,Sri Lanka,Polonnaruwa,0,0,0,0,0,0,1416,1416,0,0,0,0,0,0,1361,1361
2006,Sri Lanka,Mullaitivu,0,0,0,0,0,0,41267,41267,0,0,0,0,0,0,39649,39649
2006,Sri Lanka,Mannar,0,0,0,0,0,0,15606,15606,0,0,0,0,0,0,14995,14995
2006,Sri Lanka,Kurunegala,0,1,0,0,2,0,1836,1839,1,0,0,1,0,2,1765,1769
2006,Sri Lanka,Kilinochchi,0,0,0,0,0,0,29236,29236,0,0,0,0,0,0,28090,28090
2006,Sri Lanka,Jaffna,0,0,0,0,0,0,54367,54367,0,0,0,0,0,0,52235,52235
2006,Sri Lanka,Gampaha,0,0,0,0,0,0,1158,1158,0,0,0,0,0,0,1114,1114
2006,Sri Lanka,Colombo,19,26,0,10,75,4,1223,1357,12,19,0,15,120,5,1175,1346
2006,Sri Lanka,Batticaloa,0,0,0,0,0,0,45900,45900,0,0,0,0,0,0,44100,44100
2006,Sri Lanka,Anuradhapura,0,0,0,0,0,0,6231,6231,0,0,0,0,0,0,5986,5986
2006,Sri Lanka,Ampara,0,0,0,0,0,0,28368,28368,0,0,0,0,0,0,27255,27255
2006,Latvia,Salaspils,0,0,0,0,0,0,0,0,0,0,0,0,1,0,0,1
2006,Latvia,Riga district,0,0,0,0,1,0,0,1,0,0,0,0,6,0,0,6
2006,Latvia,Riga,0,0,0,1,1,0,0,2,0,0,0,1,9,0,0,10
2006,Latvia,Jurmala,0,0,0,1,1,0,0,2,0,0,0,0,1,0,0,1
2006,Latvia,Jelgava,0,0,0,0,0,0,0,0,0,0,0,0,1,0,0,1
2006,Rep. of Moldova,Chisinau,5,8,0,5,31,3,0,52,2,11,0,4,167,3,0,187
2006,Mexico,Mexico City,0,0,0,140,1118,121,0,1379,0,6,0,152,1323,595,0,2076
2006,The former Yugoslav Republic of Macedonia,Veles,0,0,0,0,0,0,0,0,0,0,0,0,1,0,0,1
2006,The former Yugoslav Republic of Macedonia,Valandovo,1,1,0,0,4,0,0,6,1,1,0,0,4,1,0,7
2006,The former Yugoslav Republic of Macedonia,Tetovo,1,6,0,1,12,1,0,21,4,4,0,8,15,1,0,32
2006,The former Yugoslav Republic of Macedonia,Sveti Nikole,0,0,0,0,0,1,0,1,0,0,0,0,0,0,0,0
2006,The former Yugoslav Republic of Macedonia,Strumica,0,0,0,0,1,0,0,1,0,0,0,0,0,0,0,0
2006,The former Yugoslav Republic of Macedonia,Skopje,117,185,0,130,426,32,0,890,120,185,0,133,438,24,0,900
2006,The former Yugoslav Republic of Macedonia,Prilep,0,0,0,0,1,0,0,1,0,0,0,0,4,0,0,4
2006,The former Yugoslav Republic of Macedonia,"Panada, Skopje",0,0,0,0,1,0,0,1,0,0,0,0,1,0,0,1
2006,The former Yugoslav Republic of Macedonia,Ohrid,0,0,0,0,0,0,0,0,0,0,0,0,1,0,0,1
2006,The former Yugoslav Republic of Macedonia,Kumanovo,1,6,0,4,13,1,0,25,0,3,0,7,8,1,0,19
2006,The former Yugoslav Republic of Macedonia,Krusevo,0,0,0,0,0,0,0,0,0,0,0,0,0,1,0,1
2006,The former Yugoslav Republic of Macedonia,Kicevo,0,0,0,0,1,0,0,1,0,0,0,0,0,0,0,0
2006,The former Yugoslav Republic of Macedonia,Kavadarci,0,0,0,0,2,0,0,2,0,0,0,0,0,0,0,0
2006,The former Yugoslav Republic of Macedonia,Gostivar,0,1,0,0,4,0,0,5,0,0,0,0,0,0,0,0
2006,The former Yugoslav Republic of Macedonia,Gevgelija,0,0,0,0,2,0,0,2,0,0,0,0,1,0,0,1
2006,The former Yugoslav Republic of Macedonia,Berovo,0,0,0,0,1,0,0,1,0,0,0,0,0,0,0,0
2006,Mali,Sikasso,0,0,0,0,0,0,0,0,0,0,0,0,5,0,0,5
2006,Mali,Kayes,819,731,0,425,571,90,0,2636,349,623,0,1214,1217,126,0,3529
2006,Mali,Faragouana,5,6,0,0,15,1,0,27,6,6,0,4,10,1,0,27
2006,Mali,Bamako,221,342,0,297,1393,38,0,2291,262,344,0,292,3007,49,0,3954
2006,Montenegro,Žabljak,0,2,0,2,2,0,0,6,0,1,0,0,1,0,0,2
2006,Montenegro,Ulcinj,14,26,0,29,143,55,0,267,7,46,0,25,137,42,0,257
2006,Montenegro,Tivat,11,58,0,40,310,121,0,540,15,60,0,74,257,90,0,496
2006,Montenegro,Šavnik,0,0,0,0,2,2,0,4,0,1,0,2,2,1,0,6
2006,Montenegro,Rožaje,9,38,0,42,129,22,0,240,11,52,0,32,114,20,0,229
2006,Montenegro,Podgorica,317,622,0,456,2256,490,0,4141,363,671,0,548,1943,352,0,3877
2006,Montenegro,Plužine,0,0,0,0,6,2,0,8,0,0,0,0,3,2,0,5
2006,Montenegro,Pljevlja,1,14,0,20,97,26,0,158,4,7,0,18,67,17,0,113
2006,Montenegro,Plav,6,43,0,47,276,77,0,449,12,63,0,47,222,64,0,408
2006,Montenegro,Nikšić,15,88,0,74,405,85,0,667,15,96,0,83,274,48,0,516
2006,Montenegro,Mojkovac,2,7,0,7,32,8,0,56,1,8,0,2,26,6,0,43
2006,Montenegro,Kotor,2,20,0,14,128,50,0,214,2,21,0,25,135,35,0,218
2006,Montenegro,Kolašin,3,11,0,7,82,29,0,132,2,11,0,14,80,21,0,128
2006,Montenegro,Herceg-Novi,6,19,0,25,125,55,0,230,7,25,0,19,91,37,0,179
2006,Montenegro,Herceg Novi,8,28,0,51,553,194,0,834,6,47,0,51,444,141,0,689
2006,Montenegro,Danilovgrad,3,17,0,34,144,62,0,260,7,24,0,40,119,39,0,229
2006,Montenegro,Cetinje,1,1,0,3,19,6,0,30,1,2,0,0,11,3,0,17
2006,Montenegro,Budva,10,46,0,48,356,106,0,566,14,62,0,55,334,78,0,543
2006,Montenegro,Bijelo Polje,5,36,0,36,155,24,0,256,1,51,0,34,109,23,0,218
2006,Montenegro,Berane,48,221,0,135,686,193,0,1283,72,178,0,154,594,122,0,1120
2006,Montenegro,Bar,43,168,0,160,867,303,0,1541,43,170,0,188,797,231,0,1429
2006,Montenegro,Andrijevica,1,44,0,36,142,51,0,274,7,37,0,38,132,40,0,254
2006,Mongolia,Ulaanbaatar,0,0,0,0,3,0,0,3,0,0,0,0,4,0,0,4
2006,Mozambique,Zambezia,1,1,0,0,5,0,0,7,1,4,0,0,4,0,0,9
2006,Mozambique,Tete,1,1,0,3,7,0,0,12,0,1,0,1,8,1,0,11
2006,Mozambique,Sofala,0,0,0,1,7,0,0,8,2,3,0,0,9,0,0,14
2006,Mozambique,Niassa ,6,22,0,12,24,0,0,64,12,16,0,7,43,0,0,78
2006,Mozambique,Nampula,16,12,0,7,43,0,0,78,21,23,0,7,136,3,0,190
2006,Mozambique,Maratane ,557,552,0,257,863,13,0,2242,579,620,0,274,1298,6,0,2777
2006,Mozambique,Maputo,77,133,0,57,280,7,0,554,55,127,0,70,484,7,0,743
2006,Mozambique,Manica,1,2,0,1,7,0,0,11,1,1,0,1,10,0,0,13
2006,Mozambique,Inhambane,1,2,0,1,3,1,0,8,3,5,0,1,9,0,0,18
2006,Mozambique,Gaza,3,10,0,2,7,0,0,22,1,6,0,0,8,0,0,15
2006,Mauritania,Nouakchott/Nouadhibou,35,32,0,15,195,9,0,286,34,30,0,25,475,11,0,575
2006,Malawi,Luwani,318,202,0,131,484,4,0,1139,277,199,0,163,1018,4,0,1661
2006,Malawi,Lilongwe,57,155,0,52,322,4,0,590,66,152,0,56,572,2,0,848
2006,Malawi,Dzaleka,398,630,0,287,975,26,0,2316,435,611,0,356,1203,29,0,2634
2006,Malaysia,Kuala Lumpur,1758,976,0,1542,7803,125,0,12204,1787,1080,0,1975,29048,262,0,34152
2006,Namibia,Osire,636,639,0,642,1078,52,0,3047,674,663,0,666,1401,35,0,3439
2006,Niger,Niamey,7,13,0,24,47,0,0,91,6,9,0,14,95,0,0,124
2006,Niger,Goure,2,10,0,16,29,1,0,58,8,8,0,9,38,1,0,64
2006,Nigeria,Oru Camp,192,237,0,335,1712,69,0,2545,249,121,0,431,1654,44,0,2499
2006,Nigeria,Lagos,188,100,0,171,1099,0,0,1558,197,132,0,327,2183,3,0,2842
2006,Nicaragua,Managua City,0,0,0,1,122,3,0,126,0,2,0,1,54,25,0,82
2006,Nepal,Timai,308,673,0,641,3170,314,0,5106,337,700,0,728,3163,379,0,5307
2006,Nepal,Sanischare,709,1749,0,1420,5880,611,0,10369,859,1845,0,1441,6090,681,0,10916
2006,Nepal,Khudunabari,307,803,0,1040,4167,387,0,6704,360,795,0,980,4132,535,0,6802
2006,Nepal,Kathmandu,22,9,0,11,54,2,0,98,19,16,0,53,170,1,0,259
2006,Nepal,Goldhap,264,530,0,593,2923,305,0,4615,311,548,0,622,3148,358,0,4987
2006,Nepal,Beldangi 2 Extension,468,810,0,765,3307,356,0,5706,466,943,0,745,3439,393,0,5986
2006,Nepal,Beldangi 2,859,1469,0,1539,6595,698,0,11160,953,1630,0,1564,6606,809,0,11562
2006,Nepal,Beldangi 1,783,1335,0,1332,5109,544,0,9103,872,1422,0,1313,5244,629,0,9480
2006,Nepal,Tibetan Refugee Transit Camp,3,21,0,30,54,2,0,110,2,29,0,50,193,3,0,277
2006,Oman,Maskat,0,0,0,2,2,0,0,4,0,0,0,1,7,2,0,10
2006,Pakistan,Quetta,2,0,0,6,10,0,0,18,0,0,0,8,10,1,0,19
2006,Pakistan,Punjab,0,0,0,0,0,0,5219,5219,0,0,0,0,0,0,5220,5220
2006,Pakistan,Peshawar,2,0,0,13,6,7,0,28,1,0,0,7,16,0,0,24
2006,Pakistan,Karachi,1,0,0,3,8,0,0,12,0,0,0,1,2,0,0,3
2006,Pakistan,Islamabad,23,12,0,97,191,4,0,327,20,11,0,101,500,6,0,638
2006,Pakistan,Balochistan,0,0,0,0,0,0,92079,92079,0,0,0,0,0,0,95838,95838
2006,Pakistan,North-West-Frontier Province,0,0,0,0,0,0,422814,422814,0,0,0,0,0,0,422814,422814
2006,Panama,Puerto Obaldia,5,13,0,16,25,1,0,60,4,12,0,14,29,1,0,60
2006,Panama,Panama City,23,14,0,16,324,67,6075,6519,33,20,0,23,578,92,7425,8171
2006,Panama,Jaque,23,30,0,31,70,7,0,161,28,24,0,24,72,14,0,162
2006,Panama,Embera,3,7,0,10,15,0,0,35,2,5,0,10,17,1,0,35
2006,Panama,Darien Centro,42,35,0,35,76,7,0,195,38,29,0,31,85,10,0,193
2006,Philippines,Visayas,0,0,0,0,0,0,0,0,0,0,0,0,2,0,0,2
2006,Philippines,Metro Manila,0,0,0,0,8,0,0,8,1,2,0,0,45,0,0,48
2006,Philippines,Luzon,0,0,0,1,2,0,0,3,0,0,0,1,2,1,0,4
2006,Philippines,"Metro Manila, Visayas",0,0,0,0,0,0,0,0,0,0,0,0,3,0,0,3
2006,Philippines,"Metro Manila, Mindanao",0,0,0,1,1,0,0,2,0,1,0,1,21,0,0,23
2006,Philippines,"Metro Manila, Luzon",0,0,0,0,0,0,0,0,0,0,0,0,12,0,0,12
2006,Papua New Guinea,Port Moresby,0,1,0,1,0,0,0,2,0,0,0,3,0,0,0,3
2006,Papua New Guinea,East Awin ,0,0,0,0,0,0,1305,1305,0,0,0,0,0,0,1372,1372
2006,Papua New Guinea,Daru,0,0,0,0,0,0,0,0,0,0,0,3,0,0,0,3
2006,Paraguay,Asunción,0,0,0,6,16,1,0,23,0,1,0,3,33,1,0,38
2006,Qatar,Doha,0,0,0,7,10,0,0,17,0,2,0,5,55,2,0,64
2006,Romania,Timisoara,0,0,0,0,0,0,0,0,0,0,0,0,5,0,0,5
2006,Romania,Somcuta Mare,0,0,0,0,0,0,0,0,0,0,0,0,6,0,0,6
2006,Romania,Radauti,0,0,0,0,0,0,0,0,0,0,0,0,2,0,0,2
2006,Romania,Galati,1,0,0,0,1,0,0,2,0,0,0,0,12,0,0,12
2006,Romania,Bucharest,3,8,0,10,55,2,0,78,5,10,0,16,244,3,0,278
2006,Rwanda,Umutara,0,0,0,0,1,0,0,1,0,0,0,0,1,0,0,1
2006,Rwanda,Ruhengeri,109,72,0,32,370,6,0,589,112,51,0,41,141,0,0,345
2006,Rwanda,Nyagatare (Cyangugu),103,78,0,66,152,11,0,410,60,74,0,56,58,6,0,254
2006,Rwanda,Nyabiheke (Byumba),618,584,0,464,1125,72,0,2863,574,604,0,373,598,46,0,2195
2006,Rwanda,Nkamira (Gisenyi),320,354,0,302,688,68,0,1732,335,305,0,230,338,42,0,1250
2006,Rwanda,Kiziba (Kibuye),1860,2116,0,1815,3758,365,0,9914,1774,2096,0,1588,2303,303,0,8064
2006,Rwanda,Kigeme (Gikongoro),219,209,0,155,455,23,0,1061,229,219,0,168,386,20,0,1022
2006,Rwanda,Kigali Ngali,65,33,0,14,126,2,0,240,55,30,0,10,35,0,0,130
2006,Rwanda,Kigali,201,316,0,270,637,22,0,1446,231,357,0,272,615,15,0,1490
2006,Rwanda,Kibuye,165,99,0,45,365,16,0,690,138,87,0,42,116,6,0,389
2006,Rwanda,Kibungo,25,15,0,15,65,2,0,122,25,15,0,9,28,0,0,77
2006,Rwanda,Gitarama,42,18,0,12,78,2,0,152,30,18,0,18,34,2,0,102
2006,Rwanda,Gisenyi,186,131,0,59,568,12,0,956,206,130,0,44,295,5,0,680
2006,Rwanda,Gikongoro,42,25,0,16,99,2,0,184,49,22,0,9,34,1,0,115
2006,Rwanda,Gihembe (Byumba),1794,2155,0,1779,3736,349,0,9813,1750,2061,0,1534,2377,197,0,7919
2006,Rwanda,Cyangugu,103,72,0,39,196,5,0,415,84,85,0,37,44,7,0,257
2006,Rwanda,Byumba,16,4,0,5,32,1,0,58,9,8,0,4,29,0,0,50
2006,Rwanda,Butare,27,33,0,5,85,1,0,151,44,29,0,6,41,1,0,121
2006,Saudi Arabia,Riyadh,8,49,0,38,97,4,0,196,8,48,0,47,167,10,0,280
2006,Saudi Arabia,Rafha ,8,15,0,12,25,3,0,63,9,13,0,7,128,1,0,158
2006,Saudi Arabia,Madina,1,1,0,0,1,0,0,3,0,0,0,0,3,0,0,3
2006,Saudi Arabia,Khobar,0,1,0,1,1,0,0,3,0,1,0,1,9,0,0,11
2006,Saudi Arabia,Jeddah,13,21,0,28,48,2,0,112,11,31,0,19,85,5,0,151
2006,Saudi Arabia,Arar,0,0,0,0,0,0,0,0,0,0,0,0,1,0,0,1
2006,Saudi Arabia,Al-Qateef,1,2,0,0,1,0,0,4,0,0,0,4,1,0,0,5
2006,Saudi Arabia,Al-Ihsa,0,0,0,0,0,0,0,0,0,0,0,0,1,0,0,1
2006,Saudi Arabia, Gizan,1,0,0,0,1,0,0,2,0,0,0,0,41,0,0,41
2006,Sudan,Yei,0,0,0,0,0,0,92,92,0,0,0,0,0,0,92,92
2006,Sudan,Wad Sherife,981,3567,0,3039,8845,1482,0,17914,1075,2950,0,2513,7509,1410,0,15457
2006,Sudan,Wad El Hileau,0,0,0,0,0,0,1500,1500,0,0,0,0,0,0,1500,1500
2006,Sudan,Um Shalaya,0,0,0,0,0,0,1770,1770,0,0,0,0,0,0,1769,1769
2006,Sudan,Um Sagata,0,0,0,0,0,0,3500,3500,0,0,0,0,0,0,3500,3500
2006,Sudan,Um Gargur,565,449,0,384,2623,871,0,4892,640,489,0,418,2546,860,0,4953
2006,Sudan,Um Ali,0,0,0,0,0,0,200,200,0,0,0,0,0,0,200,200
2006,Sudan,Suki (Awad El Seid),4,21,0,18,14,6,0,63,4,23,0,20,13,4,0,64
2006,Sudan,"Shagrabs 1, 2 & 3",1543,1878,0,1601,5124,741,0,10887,1662,1559,0,1329,5827,735,0,11112
2006,Sudan,Port Sudan,0,0,0,0,0,0,2750,2750,0,0,0,0,0,0,2750,2750
2006,Sudan,Pochalla,0,0,0,0,0,0,3400,3400,0,0,0,0,0,0,3400,3400
2006,Sudan,Pibor,0,0,0,0,0,0,241,241,0,0,0,0,0,0,340,340
2006,Sudan,Mukjar,0,0,0,0,0,0,117,117,0,0,0,0,0,0,117,117
2006,Sudan,Malakal,0,0,0,0,0,0,4,4,0,0,0,0,0,0,105,105
2006,Sudan,Laffa-Gulsa,0,0,0,0,0,0,4750,4750,0,0,0,0,0,0,4750,4750
2006,Sudan,Kilo 26,515,774,0,664,3257,284,0,5494,524,839,0,741,3440,385,0,5929
2006,Sudan,Kassala,0,0,0,0,0,0,3000,3000,0,0,0,0,0,0,3000,3000
2006,Sudan,Karkora,0,0,0,0,0,0,1500,1500,0,0,0,0,0,0,1500,1500
2006,Sudan,Juba,0,0,0,0,0,0,1378,1378,0,0,0,0,0,0,1159,1159
2006,Sudan,Girba,409,703,0,599,2698,125,0,4534,392,679,0,580,2710,101,0,4462
2006,Sudan,Gedarif,0,0,0,0,0,0,1250,1250,0,0,0,0,0,0,1250,1250
2006,Sudan,Fau 5,88,37,0,33,570,31,0,759,71,27,0,23,493,18,0,632
2006,Sudan,Bor,0,0,0,0,0,0,1577,1577,0,0,0,0,0,0,1576,1576
2006,Sudan,Abuda,207,320,0,273,1003,136,0,1939,230,261,0,224,1072,203,0,1990
2006,Sudan,Abu Rakham area,0,0,0,0,0,0,1250,1250,0,0,0,0,0,0,1250,1250
2006,Sudan,"Suki (Awad El Seid, Fath El Rahman, Kilo 7)",89,480,0,409,339,155,0,1472,87,542,0,462,297,104,0,1492
2006,Senegal,Podor,940,1435,0,819,1345,239,0,4778,624,982,0,517,900,160,0,3183
2006,Senegal,Matam,946,1139,0,1112,1331,240,0,4768,636,756,0,732,890,160,0,3174
2006,Senegal,Dakar,37,43,0,74,879,23,0,1056,56,100,0,108,2240,35,0,2539
2006,Senegal,Dagana,228,169,0,371,314,57,0,1139,153,156,0,204,217,38,0,768
2006,Senegal,Bakel,217,238,0,279,308,54,0,1096,145,212,0,132,199,36,0,724
2006,Singapore,Singapore,1,0,0,0,1,0,0,2,0,0,0,0,9,0,0,9
2006,Sierra Leone,Tobanda,214,370,0,183,727,36,0,1530,203,321,0,187,568,37,0,1316
2006,Sierra Leone,Taiama,244,410,0,193,662,38,0,1547,230,404,0,267,727,29,0,1657
2006,Sierra Leone,Largo,273,485,0,229,965,98,0,2050,283,473,0,241,688,53,0,1738
2006,Sierra Leone,Kenema,90,199,0,294,594,23,0,1200,71,192,0,255,540,45,0,1103
2006,Sierra Leone,Jimmi Bagbo,118,197,0,174,399,17,0,905,145,208,0,190,367,23,0,933
2006,Sierra Leone,Jembe,104,425,0,163,528,49,0,1269,136,408,0,124,611,30,0,1309
2006,Sierra Leone,Gondama,231,437,0,225,759,29,0,1681,248,423,0,220,668,47,0,1606
2006,Sierra Leone,Gerihun,153,332,0,98,517,39,0,1139,150,291,0,115,559,36,0,1151
2006,Sierra Leone,Freetown,102,210,0,251,766,28,0,1357,100,217,0,248,876,23,0,1464
2006,Sierra Leone,Bo,34,79,0,91,189,0,0,393,39,75,0,90,168,8,0,380
2006,Sierra Leone,Bandajuma,148,230,0,124,428,25,0,955,135,221,0,144,382,28,0,910
2006,El Salvador,San Salvador,0,0,0,0,2,0,0,2,0,0,0,0,7,1,0,8
2006,El Salvador,San Miguel,0,0,0,0,0,0,0,0,0,0,0,0,1,0,0,1
2006,El Salvador,La Union,0,0,0,0,8,0,0,8,0,0,0,0,14,3,0,17
2006,El Salvador,Cuscatlan,0,0,0,0,1,0,0,1,0,1,0,0,1,0,0,2
2006,Somalia,North-East Somalia,76,31,0,9,181,4,0,301,68,34,0,11,367,4,0,484
2006,Somalia,Hargeisa,55,23,0,23,466,2,19,588,67,24,0,23,805,24,15,958
2006,Serbia and Kosovo (S/RES/1244 (1999)),Vojvodina,230,1998,0,2347,16673,9611,0,30859,255,2172,0,2568,19524,5754,0,30273
2006,Serbia and Kosovo (S/RES/1244 (1999)),Kosovo,67,133,0,132,476,103,52513,53424,79,120,0,119,521,99,53447,54385
2006,Serbia and Kosovo (S/RES/1244 (1999)),Central/Southern Serbia,344,6525,0,6394,36341,11947,0,61551,362,6670,0,6901,36720,9607,0,60260
2006,Serbia and Kosovo (S/RES/1244 (1999)),Belgrade/West Serbia,453,5352,0,6063,35602,14894,0,62364,478,5735,0,6452,37175,10008,0,59848
2006,Serbia and Kosovo (S/RES/1244 (1999)),Belgrade,1,5,0,0,12,1,0,19,4,9,0,4,23,2,0,42
2006,Slovakia,Bratislava,3,0,0,0,2,0,0,5,0,0,0,0,3,0,0,3
2006,Slovenia,Postojna,0,1,0,0,18,2,0,21,0,1,0,2,8,3,0,14
2006,Slovenia,Novo Mesto,0,0,0,0,6,2,0,8,0,1,0,1,4,4,0,10
2006,Slovenia,Maribor,0,0,0,1,7,6,0,14,0,0,0,1,4,7,0,12
2006,Slovenia,Ljubljana,0,0,0,0,0,0,97,97,0,0,0,0,0,0,409,409
2006,Slovenia,Celje,0,0,0,3,20,7,0,30,1,1,0,3,10,3,0,18
2006,Swaziland,Malindza,5,9,0,6,19,0,0,39,11,10,0,13,18,0,0,52
2006,Syrian Arab Rep.,Damascus,2076,3649,0,3310,12975,951,0,22961,2235,3848,0,3632,15944,1027,0,26686
2006,Chad,Treguine,1466,1789,0,1075,3509,282,0,8121,1561,1826,0,1100,2042,271,0,6800
2006,Chad,Touloum,1520,4315,0,1890,4860,530,0,13115,1492,3765,0,1530,2166,290,0,9243
2006,Chad,Oure-Cassoni,2520,5009,0,1792,6362,608,0,16291,2529,4186,0,1229,2270,281,0,10495
2006,Chad,Mile,1517,2513,0,1042,3486,357,0,8915,1557,2203,0,872,1736,274,0,6642
2006,Chad,Kounongou,1329,2161,0,895,2979,209,0,7573,1302,2071,0,804,1357,208,0,5742
2006,Chad,Iridimi,1132,3246,0,1476,3771,378,0,10003,1170,2972,0,1349,1648,238,0,7377
2006,Chad,Gaga,1205,1827,0,702,3076,208,0,7018,1075,1782,0,755,1605,167,0,5384
2006,Chad,Farchana,1817,2521,0,1383,4644,332,0,10697,1862,2427,0,1323,2373,265,0,8250
2006,Chad,Djabal,1433,2086,0,1007,3522,294,0,8342,1504,2081,0,968,2022,245,0,6820
2006,Chad,Bredjing,2698,3593,0,2124,6827,578,0,15820,2696,3619,0,2221,4095,481,0,13112
2006,Togo,Zio,1,0,0,1,3,1,0,6,1,3,0,0,2,0,0,6
2006,Togo,Yoto,1,0,0,0,4,0,0,5,1,0,0,0,4,0,0,5
2006,Togo,Vo,1,4,0,2,6,1,0,14,5,4,0,2,10,1,0,22
2006,Togo,Ogou,0,0,0,1,1,1,0,3,0,0,0,0,4,0,0,4
2006,Togo,Mozen Mono,2,2,0,0,3,0,0,7,2,3,0,1,1,0,0,7
2006,Togo,Lome,91,92,0,114,433,6,0,736,89,95,0,121,723,6,0,1034
2006,Togo,Lacs,139,139,0,81,347,40,0,746,114,138,0,72,304,9,0,637
2006,Togo,Koyah,0,0,0,0,1,0,0,1,0,0,0,0,0,0,0,0
2006,Togo,Kloto,3,0,0,2,4,0,0,9,1,2,0,0,4,1,0,8
2006,Togo,Haho,0,0,0,0,0,0,0,0,0,0,0,0,1,0,0,1
2006,Togo,Golfe,56,171,0,65,56,24,0,372,75,70,0,33,181,3,0,362
2006,Thailand,Um Pium (Pob Phra),1201,1700,0,1459,4823,343,0,9526,1315,1690,0,1644,5009,280,0,9938
2006,Thailand,Tham Hin,585,726,0,671,1750,180,0,3912,624,722,0,649,1698,162,0,3855
2006,Thailand,Tak,153,299,0,264,1213,49,0,1978,154,361,0,303,1554,47,0,2419
2006,Thailand,Nu Po (Umphang),895,1111,0,1013,3145,231,0,6395,910,1162,0,1074,3391,199,0,6736
2006,Thailand,Mai Nai Soi,115,100,0,113,429,44,0,801,100,99,0,136,702,30,0,1067
2006,Thailand,Mae Ra Ma Luang (Sob Moei),886,1251,0,1039,2852,269,0,6297,899,1349,0,1113,2887,295,0,6543
2006,Thailand,Mae La Oon,1010,1268,0,1158,3180,272,0,6888,1108,1405,0,1262,3417,286,0,7478
2006,Thailand,Mae La (Thasongyang),3097,4267,0,3478,10955,937,0,22734,3215,4569,0,3625,11200,805,0,23414
2006,Thailand,Kanchanaburi,8,20,0,15,72,1,0,116,9,13,0,20,93,1,0,136
2006,Thailand,Don Yang,268,341,0,322,884,70,0,1885,286,353,0,349,760,67,0,1815
2006,Thailand,Bangkok,169,235,0,218,1798,31,0,2451,196,276,0,230,3278,50,0,4030
2006,Thailand,Ban Mai Nai Soi,1409,1619,0,1281,4027,396,0,8732,1567,1532,0,1249,4276,410,0,9034
2006,Thailand,Ban Mae Surin,233,330,0,316,846,53,0,1778,237,356,0,273,925,80,0,1871
2006,Tajikistan,Khujand,0,0,0,0,0,0,38,38,0,0,0,0,0,0,41,41
2006,Tajikistan,Khatlon,0,0,0,0,0,0,1,1,0,0,0,0,0,0,1,1
2006,Tajikistan,Dushanbe,0,0,0,2,2,0,372,376,0,0,0,1,7,0,389,397
2006,Turkmenistan,Turkmenbashy,0,0,0,0,5,4,0,9,0,0,0,1,2,0,0,3
2006,Turkmenistan,Turkmenabat,0,4,0,9,13,0,0,26,2,3,0,6,14,0,0,25
2006,Turkmenistan,Tedjen,0,0,0,0,1,0,0,1,0,0,0,1,0,0,0,1
2006,Turkmenistan,Mary,36,69,0,47,136,16,0,304,35,58,0,44,161,19,0,317
2006,Turkmenistan,Ashgabat,1,2,0,4,18,3,0,28,3,2,0,7,23,2,0,37
2006,Timor-Leste,Dili,0,0,0,0,1,0,0,1,0,0,0,0,5,0,0,5
2006,Tunisia,Tunis,2,1,0,1,28,6,0,38,4,4,0,1,97,6,0,112
2006,Tunisia,Sousse,0,0,0,0,0,0,0,0,0,0,0,0,1,0,0,1
2006,Tunisia,Sfax,1,0,0,0,1,0,0,2,1,0,0,1,1,0,0,3
2006,Tunisia,Monastir,0,0,0,0,2,0,0,2,0,0,0,0,2,0,0,2
2006,Tunisia,Bizerte,0,0,0,0,1,0,0,1,0,0,0,0,0,0,0,0
2006,Turkey,Yozgat Camp,2,1,0,1,10,0,0,14,3,2,0,2,8,0,0,15
2006,Turkey,Yozgat,3,5,0,4,10,0,0,22,0,3,0,1,18,0,0,22
2006,Turkey,Yalova,0,0,0,5,3,0,0,8,0,0,0,2,6,0,0,8
2006,Turkey,Van,15,28,0,31,174,6,0,254,13,37,0,51,486,6,0,593
2006,Turkey,Tokat,0,0,0,1,1,0,0,2,0,1,0,0,1,0,0,2
2006,Turkey,Sivas,2,4,0,0,4,0,0,10,0,0,0,2,5,0,0,7
2006,Turkey,Sirnak,1,0,0,0,4,0,0,5,0,0,0,2,6,0,0,8
2006,Turkey,Silopi,0,0,0,0,0,0,0,0,0,0,0,0,1,0,0,1
2006,Turkey,Samsun,0,0,0,0,2,0,0,2,0,0,0,0,1,0,0,1
2006,Turkey,Nigde,4,7,0,3,51,2,0,67,4,7,0,11,60,2,0,84
2006,Turkey,Nevsehir,20,32,0,39,210,6,0,307,18,45,0,42,228,7,0,340
2006,Turkey,Mugla,0,0,0,0,0,0,0,0,0,0,0,1,0,0,0,1
2006,Turkey,Mersin,1,1,0,1,1,0,0,4,0,1,0,0,2,0,0,3
2006,Turkey,Kutahya,2,6,0,1,29,0,0,38,2,7,0,7,34,0,0,50
2006,Turkey,Konya,23,37,0,34,215,1,0,310,27,38,0,23,324,3,0,415
2006,Turkey,Kirsehir,4,5,0,7,28,0,0,44,3,3,0,9,45,2,0,62
2006,Turkey,Kirklareli,0,0,0,0,3,1,0,4,0,0,0,0,4,0,0,4
2006,Turkey,Kirikkale,1,2,0,1,5,0,0,9,0,0,0,0,6,0,0,6
2006,Turkey,Kayseri,17,45,0,41,259,9,0,371,24,48,0,48,283,13,0,416
2006,Turkey,Kastamonu,2,9,0,8,43,4,0,66,5,12,0,10,60,0,0,87
2006,Turkey,Karaman,2,6,0,6,22,0,0,36,1,7,0,3,48,0,0,59
2006,Turkey,K.Maras,0,0,0,0,1,0,0,1,0,0,0,0,2,0,0,2
2006,Turkey,Izmit,0,0,0,0,9,2,0,11,0,0,0,1,8,0,0,9
2006,Turkey,Izmir,1,3,0,0,14,0,0,18,1,3,0,2,47,0,0,53
2006,Turkey,Istanbul,72,132,0,126,686,40,0,1056,83,153,0,137,839,37,0,1249
2006,Turkey,Isparta,4,7,0,12,41,0,0,64,7,9,0,6,97,1,0,120
2006,Turkey,Hatay,5,3,0,1,41,0,0,50,2,2,0,0,40,1,0,45
2006,Turkey,Hakkari,1,1,0,0,5,0,0,7,2,1,0,0,11,0,0,14
2006,Turkey,Gaziantep,4,13,0,9,38,2,0,66,11,10,0,15,69,0,0,105
2006,Turkey,Eskisehir,8,20,0,15,111,2,0,156,11,14,0,31,128,7,0,191
2006,Turkey,Edirne,0,0,0,0,3,0,0,3,0,2,0,0,7,0,0,9
2006,Turkey,Corum,2,2,0,3,9,0,0,16,0,1,0,3,11,0,0,15
2006,Turkey,Cankiri,2,2,0,4,29,1,0,38,12,7,0,9,43,1,0,72
2006,Turkey,Bursa,0,1,0,0,1,0,0,2,0,0,0,1,1,0,0,2
2006,Turkey,Burdur,2,8,0,11,31,0,0,52,2,5,0,4,58,0,0,69
2006,Turkey,Bilecik,1,1,0,2,36,3,0,43,4,3,0,3,37,2,0,49
2006,Turkey,Antalya,0,4,0,7,2,2,0,15,0,3,0,5,3,2,0,13
2006,Turkey,Ankara,9,39,0,33,162,1,0,244,26,33,0,55,257,4,0,375
2006,Turkey,Amasya,3,5,0,4,26,0,0,38,4,6,0,8,40,0,0,58
2006,Turkey,Aksaray,9,12,0,15,53,3,0,92,9,11,0,10,82,4,0,116
2006,Turkey,Agri,0,0,0,3,4,0,0,7,0,0,0,2,11,0,0,13
2006,Turkey,Afyon,6,9,0,11,58,1,0,85,1,10,0,3,98,0,0,112
2006,Turkey,Adapazari,0,0,0,0,0,0,0,0,0,0,0,0,1,0,0,1
2006,Turkey,Adana,0,0,0,0,0,0,0,0,0,0,0,0,1,0,0,1
2006,United Rep. of Tanzania,Nyarugusu,5121,5825,0,5103,11589,605,0,28243,4907,4829,0,5356,8956,422,0,24470
2006,United Rep. of Tanzania,Ngara,7,14,0,22,85,5,0,133,10,11,0,21,133,3,0,178
2006,United Rep. of Tanzania,Nduta,1568,1851,0,1334,3900,98,0,8751,1562,1620,0,1807,4173,162,0,9324
2006,United Rep. of Tanzania,Myovosi,1922,1845,0,1753,4162,153,0,9835,1994,1530,0,2300,4215,176,0,10215
2006,United Rep. of Tanzania,Mwisa,0,1,0,0,4,0,0,5,0,1,0,0,3,0,0,4
2006,United Rep. of Tanzania,Mtendeli,1457,1344,0,2200,4023,122,0,9146,1506,1250,0,2251,4255,153,0,9415
2006,United Rep. of Tanzania,Mtabila 2,2966,2085,0,3443,5946,209,0,14649,2975,3025,0,2390,5954,153,0,14497
2006,United Rep. of Tanzania,Mtabila 1,1389,1171,0,2183,3357,134,0,8234,1383,1120,0,2124,3378,133,0,8138
2006,United Rep. of Tanzania,Mkugwa,176,198,0,213,801,11,0,1399,132,201,0,231,641,9,0,1214
2006,United Rep. of Tanzania,Lukole,4541,3911,0,2956,8206,304,0,19918,4610,3315,0,3707,7712,423,0,19767
2006,United Rep. of Tanzania,Lugufu,6303,7112,0,7406,18104,820,0,39745,6064,6875,0,8000,14062,508,0,35509
2006,United Rep. of Tanzania,Kigoma,0,0,0,0,12,0,0,12,0,0,0,0,9,0,0,9
2006,United Rep. of Tanzania,Kibondo       ,0,0,0,0,10,0,0,10,0,0,0,5,16,0,0,21
2006,United Rep. of Tanzania,Kanembwa,1159,1109,0,1289,2700,150,0,6407,1168,1102,0,1241,2398,198,0,6107
2006,United Rep. of Tanzania,Chogo,220,215,0,235,486,47,0,1203,118,190,0,215,310,50,0,883
2006,Uganda,Rhino Camp,1342,2042,0,1814,3735,151,0,9084,1424,2059,0,2129,3688,109,0,9409
2006,Uganda,Palorinya,2640,3567,0,2401,7080,497,0,16185,2611,3763,0,2654,5630,246,0,14904
2006,Uganda,Oruchinga,266,292,0,155,548,22,0,1283,234,301,0,164,556,38,0,1293
2006,Uganda,Nakivale,2681,2366,0,1899,5337,169,0,12452,2691,2261,0,2065,6022,201,0,13240
2006,Uganda,Madi-Okollo,966,931,0,541,1538,121,0,4097,865,961,0,750,1291,88,0,3955
2006,Uganda,Kyangwali,1874,2110,0,1421,3757,332,0,9494,1919,2105,0,1657,3731,226,0,9638
2006,Uganda,Kyaka II,1435,1764,0,1270,3481,210,0,8160,1397,1730,0,1456,3448,219,0,8250
2006,Uganda,Kiryandongo,1335,1550,0,993,3058,484,0,7420,1358,1634,0,1190,2813,300,0,7295
2006,Uganda,Kampala,195,105,0,549,1137,24,0,2010,199,96,0,529,1803,9,0,2636
2006,Uganda,Imvepi,1504,2529,0,2212,3965,155,0,10365,1680,2822,0,3930,4454,80,0,12966
2006,Uganda,Ikafe,1226,1180,0,654,1835,114,0,5009,1245,1103,0,932,1591,72,0,4943
2006,Uganda,Adjumani,4391,5848,0,4145,12254,1035,0,27673,4482,5805,0,4404,11098,589,0,26378
2006,Uruguay,Montevideo,1,2,0,5,35,7,0,50,3,6,0,6,80,8,0,103
2006,Venezuela (Bolivarian Republic of),Zulia,129,159,0,139,383,16,0,826,144,142,0,146,484,35,0,951
2006,Venezuela (Bolivarian Republic of),Tachira,164,194,0,181,568,28,0,1135,165,212,0,205,657,34,0,1273
2006,Venezuela (Bolivarian Republic of),Caracas,17,36,0,32,197,13,0,295,23,38,0,37,334,22,0,454
2006,Venezuela (Bolivarian Republic of),Apure,167,271,0,257,644,39,0,1378,197,274,0,249,661,61,0,1442
2006,Viet Nam,Thu Duc,0,0,0,0,0,0,39,39,0,0,0,0,0,0,39,39
2006,Viet Nam,Ho Chi Minh City,0,0,0,0,0,0,3600,3600,0,0,0,0,0,0,3600,3600
2006,Viet Nam,Gia Lai,0,0,0,0,0,0,11,11,0,0,0,0,0,0,39,39
2006,Viet Nam,Dac Lac,0,0,0,0,0,0,6,6,0,0,0,0,0,0,7,7
2006,Viet Nam,Cu Chi,0,0,0,0,0,0,129,129,0,0,0,0,0,0,104,104
2006,Viet Nam,Binh Phuoc,0,0,0,0,0,0,130,130,0,0,0,0,0,0,131,131
2006,Viet Nam,Binh Duong,0,0,0,0,0,0,930,930,0,0,0,0,0,0,855,855
2006,Yemen,Taiz,59,179,0,179,690,185,0,1292,56,340,0,340,650,180,0,1566
2006,Yemen,Shabwa,15,28,0,29,151,6,0,229,12,22,0,22,171,2,0,229
2006,Yemen,Sana'a/Aden,62,51,0,52,210,18,0,393,60,66,0,65,281,9,0,481
2006,Yemen,Sana'a,483,1792,0,1788,5567,671,0,10301,422,1785,0,1783,5424,547,0,9961
2006,Yemen,Sada'a,2,8,0,8,25,4,0,47,3,15,0,15,55,5,0,93
2006,Yemen,Rida'a,29,18,0,17,56,5,0,125,25,33,0,32,62,5,0,157
2006,Yemen,Mukalla,41,81,0,81,165,33,0,401,39,76,0,76,66,34,0,291
2006,Yemen,Mahra,32,62,0,61,157,7,0,319,32,70,0,70,182,7,0,361
2006,Yemen,Hodeidah,20,40,0,41,109,24,0,234,19,55,0,55,104,19,0,252
2006,Yemen,Dhamar,18,19,0,18,78,2,0,135,17,16,0,16,47,4,0,100
2006,Yemen,AL-Kharaz,820,761,0,761,2087,14,0,4443,796,839,0,839,2353,28,0,4855
2006,Yemen,Al-Baida,8,34,0,33,86,7,0,168,14,23,0,23,92,2,0,154
2006,Yemen,Aden,233,1340,0,1339,3047,358,0,6317,293,1345,0,1345,3493,309,0,6785
2006,Zambia,Mwange,2022,1567,0,2371,4584,239,0,10783,1982,1453,0,2406,4334,221,0,10396
2006,Zambia,Meheba,1334,1048,0,1420,2941,445,0,7188,1036,870,0,1322,2841,475,0,6544
2006,Zambia,Mayukwayukwa,1463,661,0,1116,2262,361,0,5863,1098,468,0,910,2083,214,0,4773
2006,Zambia,Kala,1947,1345,0,2245,3858,159,0,9554,2130,1276,0,2228,3817,138,0,9589
2006,Zimbabwe,Tongogara,0,0,0,0,0,0,981,981,0,0,0,0,0,0,1168,1168
2006,Zimbabwe,Harare,0,0,0,0,0,0,567,567,0,0,0,0,0,0,803,803
2007,Afghanistan,Zabul,199,209,0,72,255,12,0,747,165,231,0,81,254,34,0,765
2007,Afghanistan,Wardak,118,201,0,166,419,20,0,924,129,231,0,169,390,37,0,956
2007,Afghanistan,Various,109069,179441,0,154526,631594,73096,1749513,2897239,113161,192071,0,171164,723152,66176,1931082,3196806
2007,Afghanistan,Uruzgan,92,88,0,18,100,7,0,305,74,86,0,31,97,13,0,301
2007,Afghanistan,Takhar,227,237,0,121,426,22,179,1212,234,309,0,169,583,47,186,1528
2007,Afghanistan,Saripul ,0,0,0,0,0,0,49,49,0,0,0,0,0,0,51,51
2007,Afghanistan,Sari Pul,156,219,0,61,284,18,0,738,148,217,0,117,333,28,0,843
2007,Afghanistan,Samangan,59,101,0,29,121,5,0,315,47,68,0,39,130,5,0,289
2007,Afghanistan,Parwan,361,361,0,222,622,27,0,1593,343,424,0,283,671,49,0,1770
2007,Afghanistan,Panjsher,11,13,0,10,24,1,0,59,9,23,0,14,46,4,0,96
2007,Afghanistan,Paktya,344,600,0,289,817,42,0,2092,359,562,0,345,686,71,0,2023
2007,Afghanistan,Paktika,134,174,0,65,209,10,0,592,153,211,0,82,229,13,0,688
2007,Afghanistan,Nuristan,11,8,0,0,11,0,0,30,6,7,0,7,16,0,0,36
2007,Afghanistan,Nimroz,2,4,0,5,10,1,0,22,2,9,0,4,8,2,0,25
2007,Afghanistan,Nangarhar,23781,27658,0,12963,35218,2160,0,101780,23763,29175,0,14548,33533,2496,0,103515
2007,Afghanistan,Logar,657,1012,0,577,1453,84,0,3783,679,1051,0,560,1244,144,0,3678
2007,Afghanistan,Laghman,2235,2925,0,1405,3799,206,0,10570,2267,3136,0,1721,3611,309,0,11044
2007,Afghanistan,Kunduz,1357,1658,0,791,2599,129,502,7036,1391,1776,0,889,2594,202,523,7375
2007,Afghanistan,Kunar,1066,1255,0,626,1632,94,0,4673,1036,1374,0,762,1598,143,0,4913
2007,Afghanistan,Khost,71,134,0,57,194,10,0,466,89,150,0,83,180,19,0,521
2007,Afghanistan,Kapisa,75,99,0,76,157,7,813,1227,79,117,0,73,168,21,847,1305
2007,Afghanistan,Kandahar,1959,2221,0,784,2614,198,49471,57247,1840,2381,0,947,2305,202,52909,60584
2007,Afghanistan,Kabul,2308,3351,0,2181,5857,295,912,14904,2393,3787,0,2410,5762,464,950,15766
2007,Afghanistan,Jawzjan,686,941,0,603,2233,179,67,4709,681,1067,0,632,2386,243,56,5065
2007,Afghanistan,Hirat,80,156,0,132,363,19,8946,9696,118,175,0,112,566,31,9312,10314
2007,Afghanistan,Hilmand,419,540,0,187,678,45,11122,12991,389,596,0,271,656,73,12465,14450
2007,Afghanistan,Ghor,4,9,0,7,13,1,71,105,3,13,0,9,41,4,73,143
2007,Afghanistan,Ghazni,1906,1678,0,508,2139,120,0,6351,1900,1918,0,696,2320,226,0,7060
2007,Afghanistan,Faryab,195,306,0,147,567,40,460,1715,224,289,0,207,668,67,490,1945
2007,Afghanistan,Farah,53,45,0,31,74,8,650,861,41,61,0,14,75,9,668,868
2007,Afghanistan,DayKundi,10,12,0,8,25,4,0,59,12,13,0,11,38,7,0,81
2007,Afghanistan,Bamyan,30,36,0,34,86,6,2152,2344,22,52,0,38,108,14,2240,2474
2007,Afghanistan,Balkh,343,448,0,241,845,64,497,2438,374,467,0,272,914,87,523,2637
2007,Afghanistan,Baghlan,443,665,0,299,883,59,171,2520,404,615,0,351,1018,98,179,2665
2007,Afghanistan,Badghis,30,37,0,29,74,3,2073,2246,31,47,0,31,99,11,2123,2342
2007,Afghanistan,Badakhshan,36,53,0,22,64,4,0,179,34,54,0,66,300,6,0,460
2007,Angola,Zaire Province,463,481,0,321,1165,175,0,2605,479,502,0,336,955,212,0,2484
2007,Angola,Moxico,438,296,0,606,67,1407,0,2814,413,360,0,610,123,1506,0,3012
2007,Angola,Luanda ,845,873,0,2993,3022,80,0,7813,736,714,0,2100,3578,49,0,7177
2007,Albania,Tirana,3,6,0,6,16,3,0,34,3,4,0,6,39,1,0,53
2007,Albania,Peshkopi,0,0,0,0,1,0,0,1,0,0,0,0,0,0,0,0
2007,Albania,Mamurras,1,0,0,0,1,2,0,4,2,0,0,0,2,1,0,5
2007,Albania,Fushekruje,1,0,0,0,0,0,0,1,0,0,0,0,1,0,0,1
2007,United Arab Emirates,Abu Dhabi,7,10,0,4,72,2,0,95,9,9,0,19,79,12,0,128
2007,Argentina,Rosario,0,1,0,1,5,0,0,7,1,0,0,1,4,0,0,6
2007,Argentina,Mendoza,3,0,0,3,6,0,0,12,2,1,0,2,8,2,0,15
2007,Argentina,Buenos Aires,46,82,0,96,1233,50,0,1507,51,98,0,121,2461,72,0,2803
2007,Armenia,Yerevan,21,29,0,43,575,275,0,943,26,27,0,46,638,118,0,855
2007,Armenia,Yeghvard,0,0,0,0,13,2,0,15,0,0,0,0,12,2,0,14
2007,Armenia,Vedi,0,0,0,0,19,7,0,26,0,0,0,0,8,5,0,13
2007,Armenia,Vayk,0,0,0,0,1,0,0,1,0,0,0,0,0,0,0,0
2007,Armenia,Vayits-Dzor marz,0,0,0,0,4,0,0,4,0,0,0,0,5,0,0,5
2007,Armenia,Vardenis,0,0,0,0,2,0,0,2,0,0,0,0,1,0,0,1
2007,Armenia,Vanadzor,0,0,0,0,2,1,0,3,0,0,0,0,3,0,0,3
2007,Armenia,Vagharshapat,0,0,0,0,27,11,0,38,0,0,0,0,30,5,0,35
2007,Armenia,Tsakhkadzor,0,0,0,0,0,1,0,1,0,0,0,0,0,0,0,0
2007,Armenia,Tavush marz,0,0,0,0,82,24,0,106,0,0,0,0,62,15,0,77
2007,Armenia,Tashir,0,0,0,0,3,1,0,4,0,0,0,0,7,1,0,8
2007,Armenia,Talin,0,0,0,0,13,5,0,18,0,0,0,0,10,3,0,13
2007,Armenia,Syunik marz,0,0,0,0,30,11,0,41,0,0,0,0,37,2,0,39
2007,Armenia,Stepanavan,0,0,0,0,8,2,0,10,0,0,0,0,14,0,0,14
2007,Armenia,Spitak,0,0,0,0,8,2,0,10,0,0,0,0,1,3,0,4
2007,Armenia,Sisian,0,0,0,0,1,1,0,2,0,0,0,0,0,0,0,0
2007,Armenia,Shirak marz ,0,0,0,0,7,2,0,9,0,0,0,0,7,3,0,10
2007,Armenia,Sevan,0,0,0,0,5,2,0,7,0,0,0,0,2,2,0,4
2007,Armenia,Noyemberyan,0,0,0,0,2,1,0,3,0,0,0,0,2,1,0,3
2007,Armenia,Nor Hach,0,0,0,0,21,13,0,34,0,0,0,0,15,6,0,21
2007,Armenia,Metsamor,0,0,0,0,10,10,0,20,0,0,0,1,13,3,0,17
2007,Armenia,Meghri,0,0,0,0,5,0,0,5,0,0,0,0,3,0,0,3
2007,Armenia,Masis,0,0,0,0,41,27,0,68,0,0,0,0,39,13,0,52
2007,Armenia,Martuni,0,0,0,0,2,0,0,2,0,0,0,0,0,0,0,0
2007,Armenia,Lori marz,0,0,0,0,38,12,0,50,0,0,0,0,49,7,0,56
2007,Armenia,Kotayk marz,0,0,0,0,122,64,0,186,0,0,0,1,136,31,0,168
2007,Armenia,Kapan,0,0,0,0,26,10,0,36,0,0,0,1,27,5,0,33
2007,Armenia,Kajaran,0,0,0,0,8,4,0,12,0,0,0,0,3,1,0,4
2007,Armenia,Ijevan,0,0,0,0,3,0,0,3,0,0,0,0,4,1,0,5
2007,Armenia,Hrazdan,0,0,0,1,23,6,0,30,0,0,0,0,20,4,0,24
2007,Armenia,Gyumri,0,0,0,0,14,3,0,17,0,0,0,0,21,2,0,23
2007,Armenia,Goris,0,0,0,0,19,4,0,23,0,0,0,0,28,3,0,31
2007,Armenia,Gegharkunik,0,0,0,0,62,11,0,73,0,0,0,0,96,11,0,107
2007,Armenia,Gavar ,0,0,0,0,1,1,0,2,0,0,0,0,1,0,0,1
2007,Armenia,Dilijan,0,0,0,0,5,7,0,12,0,0,0,0,4,1,0,5
2007,Armenia,Charentsavan,0,0,0,0,18,4,0,22,0,0,0,0,14,1,0,15
2007,Armenia,Chambarak,0,0,0,0,0,0,0,0,0,0,0,1,0,0,0,1
2007,Armenia,Byureghavan,0,0,0,1,20,13,0,34,0,0,0,0,24,6,0,30
2007,Armenia,Berd,0,0,0,0,1,1,0,2,0,0,0,0,2,0,0,2
2007,Armenia,Ashtarak,0,0,0,0,10,1,0,11,0,0,0,0,12,1,0,13
2007,Armenia,Artik,0,0,0,0,4,0,0,4,0,0,0,0,0,0,0,0
2007,Armenia,Artashat,0,0,0,0,26,8,0,34,0,0,0,0,16,4,0,20
2007,Armenia,Armavir marz,0,0,0,0,31,22,0,53,0,0,0,0,24,8,0,32
2007,Armenia,Armavir city,0,0,0,0,2,0,0,2,0,0,0,0,5,1,0,6
2007,Armenia,Ararat marz,0,0,0,1,239,77,0,317,0,0,0,1,254,41,0,296
2007,Armenia,Ararat city,0,0,0,0,10,3,0,13,0,0,0,0,4,0,0,4
2007,Armenia,Aragatsotn marz,0,0,0,0,26,16,0,42,0,0,0,0,21,6,0,27
2007,Armenia,Aparan,0,0,0,0,2,2,0,4,0,0,0,0,1,0,0,1
2007,Armenia,Akhtala,0,0,0,0,1,0,0,1,0,0,0,0,0,0,0,0
2007,Armenia,Agarak ,0,0,0,0,3,0,0,3,0,0,0,0,2,0,0,2
2007,Armenia,Abovyan,0,0,0,0,74,50,0,124,0,0,0,0,71,14,0,85
2007,Azerbaijan,Baku,174,246,0,156,749,39,0,1364,200,294,0,138,836,22,0,1490
2007,Burundi,Muyinga,0,0,0,0,0,0,0,0,0,0,0,0,1,0,0,1
2007,Burundi,Musasa,763,680,0,524,1234,48,0,3249,707,819,0,582,1389,18,0,3515
2007,Burundi,Gihinga,226,241,0,258,520,28,0,1273,180,286,0,258,579,26,0,1329
2007,Burundi,Giharo,29,12,0,20,52,3,0,116,22,19,0,21,43,3,0,108
2007,Burundi,Gasorwe,1066,1131,0,954,1538,83,0,4772,988,1183,0,852,1504,45,0,4572
2007,Burundi,Cibitoke,0,0,0,0,0,0,0,0,0,0,0,0,306,0,0,306
2007,Burundi,Bujumbura,675,1436,0,1395,2818,127,0,6451,697,1569,0,1356,2597,103,0,6322
2007,Benin,Kpomasse,45,49,0,41,169,1,0,305,41,43,0,44,205,3,0,336
2007,Benin,Cotonou,199,234,0,228,1006,23,0,1690,210,303,0,191,1852,29,0,2585
2007,Benin,Agame,229,252,0,199,740,26,0,1446,231,296,0,203,1053,12,0,1795
2007,Burkina Faso,Ouagadougou,33,68,0,57,256,2,0,416,16,55,0,52,589,5,0,717
2007,Bangladesh,Dhaka,7,14,0,6,61,1,0,89,4,14,0,4,126,2,0,150
2007,Bangladesh,Nayapara (Cox Bazaar),1405,2320,0,980,3762,182,0,8649,1493,2267,0,906,3177,187,0,8030
2007,Bangladesh,Kutapalong (Cox Bazaar),961,1433,0,596,2395,123,0,5508,983,1412,0,649,2044,112,0,5200
2007,Bulgaria,Sofia,0,6,0,8,91,3,0,108,6,13,0,57,791,0,0,867
2007,Bahrain,Manama,1,1,0,1,8,0,0,11,3,2,0,5,14,0,0,24
2007,Bosnia and Herzegovina,Various (Rep. Srpska),849,2893,0,2918,24397,8872,2578,42507,851,2928,0,2967,25549,6942,2399,41636
2007,Bosnia and Herzegovina,Various (Federation of BiH),855,2675,0,2746,19269,5446,980,31971,891,2738,0,2777,16716,4513,908,28543
2007,Bosnia and Herzegovina,Brcko District,14,36,0,37,383,162,371,1003,17,45,0,47,345,100,342,896
2007,Belarus,Vitebsk Region,0,0,0,0,10,3,0,13,1,3,0,4,25,1,0,34
2007,Belarus,Mogilev Region,0,2,0,3,11,0,0,16,0,0,0,2,17,1,0,20
2007,Belarus,Minsk Region,3,5,0,9,30,3,0,50,1,4,0,9,39,1,0,54
2007,Belarus,Minsk CIty,14,47,0,16,102,8,0,187,9,38,0,23,204,6,0,280
2007,Belarus,Grodno Region,1,1,0,0,5,0,0,7,0,0,0,0,7,1,0,8
2007,Belarus,Gomel Region,0,7,0,5,23,6,0,41,1,7,0,2,40,2,0,52
2007,Belarus,Brest Region,0,1,0,1,2,0,0,4,0,2,0,1,5,1,0,9
2007,Belize,Belize City,0,0,0,30,73,32,0,135,0,0,0,36,133,56,0,225
2007,Bolivia (Plurinational State of),Yapacani,2,2,0,0,2,0,0,6,1,0,0,1,2,0,0,4
2007,Bolivia (Plurinational State of),Tarija,0,0,0,0,1,0,0,1,0,0,0,0,1,0,0,1
2007,Bolivia (Plurinational State of),Sucre,0,0,0,0,0,0,0,0,0,0,0,0,1,0,0,1
2007,Bolivia (Plurinational State of),Santa Cruz,0,0,0,0,23,0,0,23,0,0,0,2,102,0,0,104
2007,Bolivia (Plurinational State of),La Paz,2,12,0,21,115,4,0,154,8,18,0,25,177,8,0,236
2007,Bolivia (Plurinational State of),Cochabamba,2,0,0,1,8,0,0,11,1,5,0,0,15,0,0,21
2007,Bolivia (Plurinational State of),Beni,0,0,0,3,0,0,0,3,0,2,0,0,1,0,0,3
2007,Central African Rep.,Vakaga,528,2036,0,1890,5450,180,0,10084,489,1916,0,2101,5280,130,0,9916
2007,Central African Rep.,Ouham ,1800,2500,0,1574,5900,180,0,11954,2000,2393,0,1621,5880,152,0,12046
2007,Central African Rep.,Molangue,12,14,0,10,21,0,0,57,10,9,0,7,27,2,0,55
2007,Central African Rep.,Mboki,18,27,0,25,45,0,0,115,15,24,0,0,46,0,0,85
2007,Central African Rep.,Bangui,390,439,0,319,1478,8,0,2634,419,443,0,373,2618,11,0,3864
2007,Central African Rep.,Sam Ouandja,320,236,0,218,552,50,0,1376,343,237,0,219,445,91,0,1335
2007,Central African Rep.,Ouham Pende,3625,4856,0,2685,13500,450,0,25116,3700,4850,0,2800,13134,400,0,24884
2007,Central African Rep.,Nana-Mambere,1900,2600,0,1300,5660,210,0,11670,4300,2500,0,1120,5280,130,0,13330
2007,Central African Rep.,Nana-Gribizi,1900,2710,0,1900,7450,186,0,14146,2015,2691,0,1800,7200,148,0,13854
2007,Central African Rep.,Haute Kotto,1500,1943,0,1304,3550,135,0,8432,1625,1944,0,1340,3560,99,0,8568
2007,Central African Rep.,Bamingui-Bangoran,500,760,0,310,2550,50,0,4170,485,770,0,360,2170,45,0,3830
2007,China,Wenchang,0,0,0,0,0,0,0,0,0,0,0,0,1,0,0,1
2007,China,Shanghai,0,0,0,0,0,0,0,0,0,0,0,0,1,0,0,1
2007,China,Nanjing,0,0,0,0,0,0,0,0,0,0,0,0,2,0,0,2
2007,China,Hangzhou,0,0,0,0,0,0,0,0,0,0,0,0,1,0,0,1
2007,China,Guangzhou,0,0,0,0,0,0,0,0,0,0,0,0,1,0,0,1
2007,China,Beijing,14,6,0,16,47,1,0,84,14,13,0,19,112,4,0,162
2007,China,Beihai,0,0,0,0,0,0,0,0,0,0,0,0,0,1,0,1
2007,Côte d'Ivoire,Yamoussoukro,0,0,0,0,0,0,26980,26980,0,0,0,0,0,0,26467,26467
2007,Côte d'Ivoire,Toulepleu,0,0,0,0,0,0,4523,4523,0,0,0,0,0,0,3820,3820
2007,Côte d'Ivoire,Tabou,1522,1428,0,812,3801,142,0,7705,1558,1397,0,633,2956,140,0,6684
2007,Côte d'Ivoire,Odienne,0,0,0,0,0,0,0,0,1,0,0,0,1,0,0,2
2007,Côte d'Ivoire,Man,1,2,0,0,1,0,0,4,0,0,0,0,0,0,0,0
2007,Côte d'Ivoire,Guiglo,587,776,0,450,1939,135,0,3887,616,787,0,420,1339,101,0,3263
2007,Côte d'Ivoire,Duekoue,0,0,0,0,0,0,35386,35386,0,0,0,0,0,0,34278,34278
2007,Côte d'Ivoire,Daloa,0,0,0,0,0,0,42418,42418,0,0,0,0,0,0,39393,39393
2007,Côte d'Ivoire,Bouake,1,0,0,1,1,0,95,98,0,0,0,0,0,0,85,85
2007,Côte d'Ivoire,Bassam,0,0,0,0,0,0,0,0,0,0,0,0,1,0,0,1
2007,Côte d'Ivoire,Abidjan,232,294,0,246,1377,34,257847,260030,252,352,0,274,1801,39,237936,240654
2007,Cameroon,Yaounde,0,0,0,0,0,1,0,1,0,0,0,0,5,1,0,6
2007,Cameroon,"Douala, Yaounde",487,770,0,875,3621,58,0,5811,459,803,0,868,5829,108,0,8067
2007,Cameroon,Adamaoua/Nordouest province,190,314,0,298,691,36,0,1529,221,354,0,242,464,61,0,1342
2007,Cameroon,Adamaoua/Est province,4048,6265,0,3059,9804,417,0,23593,4062,6518,0,2700,7835,830,0,21945
2007,Dem. Rep. of the Congo,Zomfi,3,3,0,2,5,0,0,13,2,2,0,2,4,0,0,10
2007,Dem. Rep. of the Congo,Uvira,354,280,0,300,880,55,0,1869,300,300,0,232,551,48,0,1431
2007,Dem. Rep. of the Congo,Nkondo,42,50,0,60,145,17,0,314,44,60,0,70,90,5,0,269
2007,Dem. Rep. of the Congo,Mfuiki,15,22,0,18,30,1,0,86,20,10,0,15,48,2,0,95
2007,Dem. Rep. of the Congo,Lusuku,2,41,0,13,102,7,0,165,3,40,0,12,80,5,0,140
2007,Dem. Rep. of the Congo,Lume,79,50,0,46,145,160,0,480,122,43,0,50,124,150,0,489
2007,Dem. Rep. of the Congo,Kimaza,48,40,0,41,125,2,0,256,56,52,0,50,215,9,0,382
2007,Dem. Rep. of the Congo,Isiro,4,3,0,7,14,1,0,29,2,5,0,5,18,0,0,30
2007,Dem. Rep. of the Congo,Goma,17,10,0,10,30,1,0,68,9,10,0,16,28,1,0,64
2007,Dem. Rep. of the Congo,Divuma,11,26,0,20,41,6,0,104,18,23,0,30,46,8,0,125
2007,Dem. Rep. of the Congo,Buta,3,5,0,5,12,0,0,25,4,4,0,2,11,1,0,22
2007,Dem. Rep. of the Congo,Bukavu,13,11,0,10,58,3,0,95,24,20,0,22,55,2,0,123
2007,Dem. Rep. of the Congo,Tshimbumbulu,19,14,0,13,42,12,0,100,10,15,0,19,41,13,0,98
2007,Dem. Rep. of the Congo,Tshifwameso,4,9,0,10,22,0,0,45,6,10,0,10,13,0,0,39
2007,Dem. Rep. of the Congo,Tshabobo,4,68,0,19,116,3,0,210,6,63,0,11,164,6,0,250
2007,Dem. Rep. of the Congo,Tseke-Zole,57,66,0,66,141,2,0,332,58,48,0,50,156,14,0,326
2007,Dem. Rep. of the Congo,Sud Kivu (Uvira & Fizi),2702,2356,0,2350,4260,243,0,11911,2784,2269,0,2350,5649,372,0,13424
2007,Dem. Rep. of the Congo,Sadi-Zulu,1,2,0,3,3,0,0,9,1,2,0,1,11,0,0,15
2007,Dem. Rep. of the Congo,Rugetsi,312,180,0,183,283,250,0,1208,309,136,0,95,315,296,0,1151
2007,Dem. Rep. of the Congo,Plaine Semliki,47,20,0,26,61,49,0,203,178,37,0,38,74,55,0,382
2007,Dem. Rep. of the Congo,North Kivu (Goma),11,150,0,125,250,0,0,536,12,214,0,457,569,145,0,1397
2007,Dem. Rep. of the Congo,North Katanga (Pweto),195,178,0,178,385,18,0,954,199,165,0,165,285,24,0,838
2007,Dem. Rep. of the Congo,North Katanga (Moba),401,414,0,395,800,93,0,2103,408,442,0,413,665,80,0,2008
2007,Dem. Rep. of the Congo,North Katanga (Kalemie),506,653,0,467,1178,56,0,2860,505,641,0,483,994,57,0,2680
2007,Dem. Rep. of the Congo,Nlundu Matende,17,32,0,30,75,6,0,160,19,24,0,30,73,11,0,157
2007,Dem. Rep. of the Congo,Napassa,14,12,0,12,24,1,0,63,6,13,0,12,7,0,0,38
2007,Dem. Rep. of the Congo,Mutwanga Centre,110,31,0,28,102,98,0,369,109,125,0,135,131,141,0,641
2007,Dem. Rep. of the Congo,Mbujimayi,0,0,0,0,3,0,0,3,0,0,0,0,9,1,0,10
2007,Dem. Rep. of the Congo,Masambo,263,50,0,59,116,102,0,590,141,90,0,94,189,100,0,614
2007,Dem. Rep. of the Congo,Lubumbashi,49,50,0,40,98,9,0,246,55,50,0,40,122,2,0,269
2007,Dem. Rep. of the Congo,Kulindji,35,49,0,49,77,16,0,226,21,54,0,54,16,3,0,148
2007,Dem. Rep. of the Congo,Kisenge,11,20,0,31,51,5,0,118,14,24,0,20,57,9,0,124
2007,Dem. Rep. of the Congo,Kisanga,220,81,0,76,110,92,0,579,147,100,0,78,126,107,0,558
2007,Dem. Rep. of the Congo,Kinshasa (sp. intalled),1127,1500,0,1615,6417,1232,0,11891,1119,1500,0,1678,5909,1066,0,11272
2007,Dem. Rep. of the Congo,Kinshasa,176,237,0,223,610,57,0,1303,157,207,0,176,578,78,0,1196
2007,Dem. Rep. of the Congo,Kinsalulu,11,10,0,10,26,1,0,58,13,14,0,15,10,0,0,52
2007,Dem. Rep. of the Congo,Kinsafu,7,11,0,11,15,1,0,45,5,7,0,7,9,0,0,28
2007,Dem. Rep. of the Congo,Kinahasa,4,3,0,8,8,1,0,24,1,3,0,4,40,0,0,48
2007,Dem. Rep. of the Congo,Kimpindi,4,4,0,4,9,2,0,23,7,7,0,8,3,0,0,25
2007,Dem. Rep. of the Congo,Kimfwakata,9,7,0,8,12,0,0,36,6,10,0,7,7,0,0,30
2007,Dem. Rep. of the Congo,Kimbianga,18,21,0,25,61,6,0,131,19,20,0,22,68,9,0,138
2007,Dem. Rep. of the Congo,Kilueka,64,125,0,126,319,35,0,669,62,146,0,147,245,27,0,627
2007,Dem. Rep. of the Congo,Kikingi-Kikura,178,101,0,93,150,102,0,624,158,75,0,110,131,118,0,592
2007,Dem. Rep. of the Congo,Katshia,7,74,0,16,131,8,0,236,8,67,0,15,160,15,0,265
2007,Dem. Rep. of the Congo,Kasindi Port,59,29,0,27,98,56,0,269,121,41,0,41,68,47,0,318
2007,Dem. Rep. of the Congo,Kamango,312,329,0,200,474,144,0,1459,176,149,0,150,177,99,0,751
2007,Dem. Rep. of the Congo,Kainama,365,202,0,270,427,278,0,1542,311,141,0,130,246,243,0,1071
2007,Dem. Rep. of the Congo,Ingbokolo,110,105,0,100,327,15,0,657,94,96,0,100,278,19,0,587
2007,Dem. Rep. of the Congo,Fizi (Baraka),114,93,0,100,341,41,0,689,110,100,0,97,247,26,0,580
2007,Dem. Rep. of the Congo,Equateur,2237,1863,0,1879,3977,498,0,10454,2336,1856,0,1845,3170,367,0,9574
2007,Dem. Rep. of the Congo,Dungu (centre),2,0,0,2,2,0,0,6,1,0,0,0,5,0,0,6
2007,Dem. Rep. of the Congo,Doruma-Centre,8,0,0,5,8,3,0,24,2,0,0,4,7,2,0,15
2007,Dem. Rep. of the Congo,Doruma-Bangalu,14,10,0,13,29,7,0,73,10,11,0,12,16,13,0,62
2007,Dem. Rep. of the Congo,Doruma-Bangadi,5,10,0,2,12,5,0,34,2,8,0,4,11,6,0,31
2007,Dem. Rep. of the Congo,Bas-Congo,6368,6530,0,6552,21332,2839,0,43621,6159,6898,0,6898,17240,2105,0,39300
2007,Dem. Rep. of the Congo,Aru-Centre,13,3,0,4,22,0,0,42,9,4,0,5,3,1,0,22
2007,Dem. Rep. of the Congo,Ariwara,7,41,0,41,120,57,0,266,51,77,0,65,236,96,0,525
2007,Dem. Rep. of the Congo,Aba-centre,0,0,0,0,2,0,0,2,0,0,0,0,3,0,0,3
2007,Congo,Tchitanzi,14,16,0,23,79,5,0,137,27,31,0,38,92,3,0,191
2007,Congo,Tchiamba-Nzassi,48,42,0,54,115,3,0,262,47,52,0,41,142,2,0,284
2007,Congo,Sangha,27,98,0,107,251,1,0,484,21,88,0,121,366,3,0,599
2007,Congo,Pointe-Noire,12,14,0,24,115,4,0,169,11,21,0,41,173,3,0,249
2007,Congo,Oyo,11,9,0,18,43,0,0,81,14,22,0,16,62,0,0,114
2007,Congo,Owando,0,0,0,0,3,0,0,3,0,0,0,1,6,0,0,7
2007,Congo,Ollombo,0,0,0,1,1,0,0,2,0,1,0,2,2,0,0,5
2007,Congo,Okoyo,1,0,0,0,4,0,0,5,1,0,0,0,3,0,0,4
2007,Congo,Ngo,19,41,0,50,86,0,0,196,17,57,0,74,138,0,0,286
2007,Congo,Ndzoundou & L,37,74,0,81,133,19,0,344,47,57,0,61,135,21,0,321
2007,Congo,Mpouya,0,2,0,1,0,0,0,3,0,0,0,0,1,0,0,1
2007,Congo,Malolo & Loudima,14,42,0,66,110,5,0,237,11,38,0,44,134,2,0,229
2007,Congo,Makoua,0,1,0,3,4,0,0,8,1,0,0,2,11,0,0,14
2007,Congo,Makotipoko,3,2,0,6,9,0,0,20,1,1,0,4,17,0,0,23
2007,Congo,Loukolela,171,165,0,183,510,13,0,1042,133,174,0,204,721,14,0,1246
2007,Congo,Kondi M,21,49,0,68,212,4,0,354,38,71,0,84,188,2,0,383
2007,Congo,Komi,7,12,0,18,47,1,0,85,9,11,0,15,58,3,0,96
2007,Congo,Kintele & environ,29,84,0,108,402,2,0,625,34,129,0,163,520,17,0,863
2007,Congo,Impfondo,1805,2004,0,2287,5287,365,0,11748,1629,1600,0,2092,4944,476,0,10741
2007,Congo,Gamboma,0,1,0,0,4,0,0,5,0,1,0,2,4,0,0,7
2007,Congo,Dolisie & environ,7,14,0,23,51,2,0,97,9,16,0,17,41,3,0,86
2007,Congo,Djambala,3,3,0,5,9,0,0,20,4,3,0,4,15,0,0,26
2007,Congo,Brazzaville,73,286,0,386,987,8,0,1740,141,318,0,362,1222,54,0,2097
2007,Congo,Boundji/Obouya,1,0,0,2,3,0,0,6,0,0,0,1,3,0,0,4
2007,Congo,Bouemba,1,0,0,2,7,0,0,10,0,1,0,3,14,0,0,18
2007,Congo,Betou,367,297,0,312,405,146,0,1527,284,288,0,359,350,87,0,1368
2007,Colombia,Tulua,0,0,0,0,0,0,0,0,0,0,0,0,1,0,0,1
2007,Colombia,San Andres,0,0,0,0,2,0,0,2,0,0,0,1,1,0,0,2
2007,Colombia,Pasto,0,0,0,0,0,0,0,0,0,0,0,0,2,0,0,2
2007,Colombia,Medellin,0,0,0,0,0,1,0,1,0,0,0,0,1,0,0,1
2007,Colombia,Maicao,0,0,0,0,1,0,0,1,0,0,0,0,0,0,0,0
2007,Colombia,Ibague,0,0,0,0,1,0,0,1,0,0,0,0,1,0,0,1
2007,Colombia,Duitama,0,0,0,0,1,0,0,1,0,0,0,0,0,0,0,0
2007,Colombia,Cucuta,1,0,0,0,9,0,0,10,1,0,0,1,11,0,0,13
2007,Colombia,Charala,0,0,0,0,0,0,0,0,0,0,0,0,0,1,0,1
2007,Colombia,Cartagena,0,0,0,0,1,0,0,1,0,0,0,0,10,0,0,10
2007,Colombia,Cali,0,0,0,0,1,0,0,1,0,0,0,0,2,1,0,3
2007,Colombia,Buenaventura,0,1,0,2,2,0,0,5,0,3,0,0,1,0,0,4
2007,Colombia,Bucaramanga,0,0,0,0,1,0,0,1,0,0,0,0,1,0,0,1
2007,Colombia,Bogota,3,1,0,6,27,8,0,45,3,4,0,4,92,7,0,110
2007,Colombia,"Barcelona, Q",0,0,0,2,1,0,0,3,0,0,0,0,1,0,0,1
2007,Cuba,Villaclara,0,0,0,0,1,0,0,1,0,0,0,0,29,0,0,29
2007,Cuba,Santiago de Cuba,0,0,0,0,0,0,0,0,0,0,0,0,6,0,0,6
2007,Cuba,Sancti Spiritus,0,0,0,0,0,0,0,0,0,0,0,0,10,0,0,10
2007,Cuba,Pinar del Río,0,0,0,0,0,0,0,0,0,0,0,0,34,0,0,34
2007,Cuba,Matanzas,0,0,0,0,0,0,0,0,0,0,0,0,20,0,0,20
2007,Cuba,Las Tunas,0,0,0,0,0,0,0,0,0,0,0,0,25,0,0,25
2007,Cuba,La Habana,0,0,0,0,0,0,0,0,0,0,0,0,3,0,0,3
2007,Cuba,Isla de la Juventud,0,0,0,0,0,0,0,0,0,0,0,47,265,0,0,312
2007,Cuba,Holguín,0,0,0,0,0,0,0,0,0,0,0,0,42,0,0,42
2007,Cuba,Guantánamo,0,0,0,0,0,0,0,0,0,0,0,0,17,0,0,17
2007,Cuba,Granma,0,0,0,0,0,0,0,0,0,0,0,0,16,0,0,16
2007,Cuba,Ciudad de La Habana,1,1,0,1,15,0,0,18,0,2,0,0,33,0,0,35
2007,Cuba,Cienfuegos,0,0,0,0,0,0,0,0,0,0,0,0,17,0,0,17
2007,Cuba,Camagüey,0,0,0,0,1,0,0,1,0,0,0,0,43,0,0,43
2007,Czech Rep.,Zastavka u Brna,0,0,0,0,0,0,68,68,0,0,0,0,0,0,107,107
2007,Czech Rep.,Vysni Lhoty,0,0,0,0,0,0,27,27,0,0,0,0,0,0,80,80
2007,Czech Rep.,Velke Prilepy,0,0,0,0,0,0,0,0,0,0,0,0,0,0,75,75
2007,Czech Rep.,Straz pod Ralskem,0,0,0,0,0,0,25,25,0,0,0,0,0,0,29,29
2007,Czech Rep.,Praha Ruzyne,0,0,0,0,0,0,14,14,0,0,0,0,0,0,39,39
2007,Czech Rep.,IAS Predlice,0,0,0,0,0,0,21,21,0,0,0,0,0,0,16,16
2007,Czech Rep.,IAS Jaromer,0,0,0,0,0,0,8,8,0,0,0,0,0,0,14,14
2007,Czech Rep.,IAS Havirov,0,0,0,0,0,0,6,6,0,0,0,0,0,0,11,11
2007,Czech Rep.,Havirov,0,0,0,0,0,0,41,41,0,0,0,0,0,0,51,51
2007,Czech Rep.,Bela Jezova,0,0,0,0,0,0,11,11,0,0,0,0,0,0,36,36
2007,Czech Rep.,Kostelec nad Orlici,0,0,0,0,0,0,104,104,0,0,0,0,0,0,100,100
2007,Czech Rep.,IAS Zastavka u Brna,0,0,0,0,0,0,21,21,0,0,0,0,0,0,21,21
2007,Czech Rep.,IAS Straz pod Ralskem,0,0,0,0,0,0,21,21,0,0,0,0,0,0,17,17
2007,Djibouti,Djibouti,11,29,0,0,94,0,0,134,14,31,0,0,96,0,0,141
2007,Djibouti,Ali-Addeh,529,870,0,0,1812,68,0,3279,573,948,0,0,1488,88,0,3097
2007,Egypt,Cairo,7923,10839,0,6948,23840,1365,0,50915,8748,8203,0,12116,31529,1004,0,61600
2007,Eritrea,Emkulu,501,409,0,183,761,33,0,1887,568,393,0,277,1128,33,0,2399
2007,Eritrea,Elit,54,59,0,45,95,3,0,256,75,80,0,27,338,16,0,536
2007,Eritrea,Dekemhare,1,0,0,0,1,0,0,2,1,0,0,0,9,0,0,10
2007,Eritrea,Asmara,130,150,0,99,541,54,0,974,142,168,0,85,573,28,0,996
2007,Eritrea,Afabet,0,0,0,0,0,0,0,0,0,0,0,0,1,0,0,1
2007,Estonia,Illuka,0,0,0,0,0,0,0,0,0,0,0,0,3,0,0,3
2007,Ethiopia,Teferiber,873,1230,0,697,1763,96,0,4659,838,1206,0,644,1184,50,0,3922
2007,Ethiopia,Sherkole (Assosa),863,1065,0,586,1893,54,0,4461,910,1262,0,643,1675,38,0,4528
2007,Ethiopia,Kebribeyah (Jijiga),1584,2026,0,1172,3697,140,0,8619,1634,2006,0,1262,3150,208,0,8260
2007,Ethiopia,Fugnido (Gambella),1825,0,0,3746,4531,126,0,10228,2005,441,0,3926,2090,36,0,8498
2007,Ethiopia,Dimma (Gambella),304,250,0,191,582,16,0,1343,340,320,0,232,379,11,0,1282
2007,Ethiopia,Borena,241,0,0,568,504,84,0,1397,269,0,0,450,450,78,0,1247
2007,Ethiopia,Bonga (Gambella),642,0,0,1021,1125,28,0,2816,671,0,0,1022,751,20,0,2464
2007,Ethiopia,Afar,257,652,0,994,43,0,0,1946,304,0,0,766,1435,122,0,2627
2007,Ethiopia,Addis Ababa,42,88,0,60,243,13,0,446,50,84,0,61,366,7,0,568
2007,Ethiopia,Shimelba (Shire/Shiraro),534,556,0,532,1906,168,0,3696,552,597,0,632,10360,220,0,12361
2007,Fiji,Suva,0,0,0,0,0,0,0,0,0,0,0,0,1,0,0,1
2007,Micronesia (Federated States of),Yapp,0,0,0,0,0,0,0,0,0,0,0,0,2,0,0,2
2007,Gabon,Voungou/Pont,1,6,0,4,14,3,0,28,5,7,0,3,16,0,0,31
2007,Gabon,Tchibanga,137,150,0,87,434,14,0,822,133,128,0,80,415,10,0,766
2007,Gabon,Sindara,0,0,0,0,0,0,0,0,0,0,0,0,1,0,0,1
2007,Gabon,Rinanzala,5,15,0,5,23,2,0,50,3,15,0,6,26,2,0,52
2007,Gabon,Rébé,0,0,0,0,1,0,0,1,0,0,0,0,0,0,0,0
2007,Gabon,Port-Gentil,20,24,0,21,106,0,0,171,33,30,0,12,199,7,0,281
2007,Gabon,Pana/Dienga,0,0,0,0,1,0,0,1,0,0,0,1,6,0,0,7
2007,Gabon,Oyem,1,0,0,2,3,0,0,6,0,2,0,2,14,0,0,18
2007,Gabon,Okondja,3,3,0,0,4,0,0,10,0,2,0,2,40,0,0,44
2007,Gabon,Nzinga,1,5,0,3,8,2,0,19,3,2,0,4,5,1,0,15
2007,Gabon,Ntoum,0,1,0,0,2,0,0,3,1,0,0,0,1,0,0,2
2007,Gabon,Ngouoni,2,0,0,0,2,0,0,4,0,0,0,0,16,0,0,16
2007,Gabon,Ndjolé,1,1,0,1,2,0,0,5,0,2,0,1,6,0,0,9
2007,Gabon,Ndendé,21,41,0,28,111,7,0,208,19,38,0,25,89,0,0,171
2007,Gabon,Mounana,4,14,0,9,36,1,0,64,10,11,0,8,88,1,0,118
2007,Gabon,Moulengui-Binza Commune,18,40,0,26,81,15,0,180,24,46,0,37,68,6,0,181
2007,Gabon,Mouila,17,62,0,39,165,4,0,287,53,67,0,32,203,1,0,356
2007,Gabon,Moanda,61,145,0,119,441,19,0,785,47,151,0,102,561,14,0,875
2007,Gabon,Mitzic,0,0,0,0,1,0,0,1,0,0,0,0,3,0,0,3
2007,Gabon,Mékambo,0,0,0,0,0,0,0,0,0,0,0,0,2,3,0,5
2007,Gabon,Mayumba,1,3,0,2,14,0,0,20,2,1,0,0,18,0,0,21
2007,Gabon,Makokou,2,6,0,7,20,0,0,35,2,4,0,2,37,1,0,46
2007,Gabon,Mabanda,7,9,0,5,22,2,0,45,5,8,0,5,27,4,0,49
2007,Gabon,Lope,1,0,0,3,2,0,0,6,0,1,0,0,5,0,0,6
2007,Gabon,Libreville,172,262,0,233,932,23,0,1622,124,266,0,230,1777,70,0,2467
2007,Gabon,Lékindou,1,5,0,4,11,0,0,21,0,0,0,1,4,2,0,7
2007,Gabon,Lébamba,7,11,0,7,19,1,0,45,2,6,0,5,16,2,0,31
2007,Gabon,Lastourville,3,10,0,10,25,1,0,49,3,9,0,7,43,1,0,63
2007,Gabon,Lambarené,2,1,0,0,11,0,0,14,6,3,0,3,25,1,0,38
2007,Gabon,Koumou-Doussala,2,2,0,4,3,3,0,14,0,2,0,2,2,1,0,7
2007,Gabon,Koulamoutou,8,20,0,19,45,1,0,93,11,18,0,13,108,4,0,154
2007,Gabon,Gamba,4,21,0,12,69,0,0,106,14,15,0,1,82,0,0,112
2007,Gabon,Franceville,48,125,0,82,433,11,0,699,53,137,0,85,783,18,0,1076
2007,Gabon,Four place,0,0,0,1,1,0,0,2,0,2,0,1,0,0,0,3
2007,Gabon,Fougamou,1,0,0,0,3,0,0,4,0,1,0,0,4,0,0,5
2007,Gabon,Doussala,1,2,0,1,6,1,0,11,2,6,0,3,3,0,0,14
2007,Gabon,Dilemba,16,27,0,27,77,10,0,157,16,30,0,30,65,10,0,151
2007,Gabon,Boumango,4,15,0,12,18,2,0,51,2,10,0,9,21,3,0,45
2007,Gabon,Booué,1,0,0,1,3,0,0,5,1,0,0,0,9,0,0,10
2007,Gabon,Bongoville,0,2,0,0,1,0,0,3,0,0,0,0,3,0,0,3
2007,Gabon,Bitam,0,0,0,0,2,0,0,2,1,0,0,0,6,0,0,7
2007,Gabon,Bibora,4,0,0,5,11,2,0,22,2,0,0,6,7,2,0,17
2007,Gabon,Banda-Mamba,1,6,0,1,9,2,0,19,1,2,0,2,1,4,0,10
2007,Gabon,Bakoumba,5,18,0,7,24,1,0,55,7,9,0,4,12,0,0,32
2007,Gabon,Akiéni,0,0,0,2,2,0,0,4,2,0,0,2,8,0,0,12
2007,Georgia,Tbilisi,0,0,0,1,6,2,0,9,0,1,0,2,9,0,0,12
2007,Ghana,Volta,515,556,0,287,1568,118,0,3044,494,525,0,295,1232,52,0,2598
2007,Ghana,Krisan,106,90,0,44,237,9,0,486,89,72,0,40,738,5,0,944
2007,Ghana,Buduburam,811,2995,0,2205,7575,315,0,13901,703,2615,0,2083,6707,170,0,12278
2007,Ghana,Accra,119,160,0,139,523,41,0,982,128,168,0,128,723,22,0,1169
2007,Guinea,Nzerekore,58,2,0,180,197,7,0,444,66,2,0,166,108,8,0,350
2007,Guinea,Laine,227,715,0,494,1262,62,0,2760,273,660,0,492,951,49,0,2425
2007,Guinea,Kountaya,59,203,0,112,393,29,0,796,56,165,0,105,304,18,0,648
2007,Guinea,Kouankan 2,202,450,0,286,633,48,0,1619,151,448,0,315,454,35,0,1403
2007,Guinea,Kouankan,210,476,0,343,859,41,0,1929,227,461,0,330,707,38,0,1763
2007,Guinea,Conakry,321,916,0,1120,3490,64,0,5911,374,971,0,1382,4538,128,0,7393
2007,Guinea,Boreah,42,180,0,125,406,28,0,781,53,192,0,137,599,48,0,1029
2007,Gambia,Border villages ,524,787,0,1520,610,200,0,3641,524,687,0,700,610,236,0,2757
2007,Guinea-Bissau,Jolmette,53,78,0,41,124,9,0,305,55,29,0,84,99,14,0,281
2007,Guinea-Bissau,Frontiere Sn,634,1382,0,921,525,110,0,3572,667,571,0,769,1165,158,0,3330
2007,Guinea-Bissau,Bissau,30,33,0,36,133,4,0,236,42,80,0,60,280,17,0,479
2007,Guatemala,Guatemala City,0,0,0,0,185,27,0,212,0,0,0,4,138,27,0,169
2007,"China, Hong Kong SAR","Hong Kong, SAR China",15,13,0,3,315,1,0,347,20,17,0,11,1625,1,0,1674
2007,Honduras,Tegucigalpa,0,0,0,0,0,0,0,0,0,0,0,2,34,1,0,37
2007,Honduras,"San Pedro,Sula",0,0,0,0,0,0,0,0,0,0,0,0,2,0,0,2
2007,Honduras,Islas de la Bahia,0,0,0,0,3,0,0,3,0,0,0,0,1,0,0,1
2007,Croatia,Kutina,4,5,0,0,6,0,0,15,1,2,0,3,18,0,0,24
2007,Croatia,Jezevo,0,0,0,0,0,0,0,0,0,0,0,0,15,0,0,15
2007,Haiti,Port au Prince,0,0,0,0,0,0,0,0,0,0,0,0,2,0,0,2
2007,Indonesia,Mataram,0,0,0,0,0,0,0,0,0,0,0,0,66,0,0,66
2007,Indonesia,Jakarta,21,18,0,16,62,2,0,119,17,28,0,28,255,2,0,330
2007,Indonesia,Belawan,0,0,0,0,0,0,0,0,0,0,0,1,10,0,0,11
2007,India,Tamil Nadu,0,0,0,0,0,0,35845,35845,0,0,0,0,0,0,37089,37089
2007,India,New Delhi,438,658,0,1201,4322,347,0,6966,460,835,0,1265,3950,359,0,6869
2007,Iraq,Wassit-Kut,2,6,0,8,18,0,0,34,2,5,0,3,13,1,0,24
2007,Iraq,Wassit-Dijaila,0,3,0,2,8,0,0,13,0,1,0,2,7,1,0,11
2007,Iraq,Unkown,0,1,0,2,2,0,0,5,0,1,0,2,4,0,0,7
2007,Iraq,Trebil,16,49,0,27,78,4,0,174,19,30,0,27,102,3,0,181
2007,Iraq,Sulaymaniyah-Khaniqen,0,0,0,1,8,2,0,11,0,0,0,0,7,1,0,8
2007,Iraq,Sulaymaniyah-Kalar,0,0,0,1,9,0,0,10,0,2,0,2,3,0,0,7
2007,Iraq,Sulaymaniyah-Barika,0,0,0,1,3,0,0,4,0,0,0,1,2,0,0,3
2007,Iraq,Sulaymaniyah ,195,598,0,530,1785,144,0,3252,211,618,0,640,1856,187,0,3512
2007,Iraq,Sulaimaniya,0,0,0,0,0,0,89,89,0,0,0,0,0,0,118,118
2007,Iraq,Salahudin-Beji,0,0,0,0,0,0,0,0,0,0,0,0,1,0,0,1
2007,Iraq,Salahudin,0,2,0,3,18,1,0,24,0,5,0,5,13,1,0,24
2007,Iraq,Qadisyia-Dewaniya,1,4,0,1,13,0,0,19,0,2,0,1,11,2,0,16
2007,Iraq,Qadisiya-Diwaniya,7,16,0,12,39,1,0,75,5,11,0,9,30,1,0,56
2007,Iraq,Ninewal-Makhmour,4,4,0,1,15,0,0,24,3,6,0,1,26,0,0,36
2007,Iraq,Ninewa-Makhmour,610,1008,0,979,2653,258,0,5508,660,1064,0,971,2329,196,0,5220
2007,Iraq,Mousil,4,15,0,27,76,4,0,126,11,18,0,14,72,5,0,120
2007,Iraq,Missan-Ammara,13,17,0,29,75,9,0,143,7,19,0,24,58,12,0,120
2007,Iraq,Missan - Ali-Al-Gharbi,0,1,0,0,1,0,0,2,0,0,0,1,1,0,0,2
2007,Iraq,Kiruk,0,0,0,0,3,0,0,3,0,0,0,1,1,0,0,2
2007,Iraq,Kirkuk,0,0,0,0,1,0,0,1,0,0,0,0,0,0,0,0
2007,Iraq,Karbala,0,0,0,2,10,0,0,12,0,0,0,1,2,3,0,6
2007,Iraq,Erbil-Koya,0,4,0,2,16,0,0,22,0,2,0,3,17,3,0,25
2007,Iraq,Erbil-Kawa,49,129,0,122,368,30,0,698,40,152,0,135,360,36,0,723
2007,Iraq,Erbil-Hareer,7,30,0,33,71,7,0,148,10,32,0,22,61,3,0,128
2007,Iraq,Erbil-Degala,0,0,0,0,3,0,0,3,0,0,0,1,3,0,0,4
2007,Iraq,Erbil,1,62,0,42,193,12,372,682,2,39,0,48,290,21,490,890
2007,Iraq,Dohuk-Balqus Camp,0,3,0,4,10,0,0,17,2,6,0,0,11,0,0,19
2007,Iraq,Dohuk- Dohuk,1,4,0,0,3,0,0,8,1,2,0,0,5,0,0,8
2007,Iraq,Dohuk,0,0,0,0,0,0,548,548,0,0,0,0,0,0,724,724
2007,Iraq,Diyala-Ashraf,0,0,0,0,0,0,0,0,0,0,0,0,0,0,12,12
2007,Iraq,Diyala- Ashraf Camp,0,0,0,0,2,0,0,2,1,0,0,0,30,3,0,34
2007,Iraq,Diala-Khalis,2,12,0,13,51,6,0,84,0,14,0,12,38,6,0,70
2007,Iraq,Diala-Baquba,1,0,0,2,3,0,0,6,1,0,0,0,1,1,0,3
2007,Iraq,Dahuk- Zakho,30,99,0,69,159,5,0,362,37,117,0,70,149,4,0,377
2007,Iraq,Dahuk- Teldif,1,6,0,7,15,1,0,30,1,3,0,3,12,1,0,20
2007,Iraq,Dahuk- Sumeil,3,3,0,4,14,1,0,25,1,3,0,3,21,0,0,28
2007,Iraq,Dahuk- Sersink,2,2,0,4,13,1,0,22,1,6,0,5,14,0,0,26
2007,Iraq,Dahuk- Mesirike,24,110,0,89,258,40,0,521,40,121,0,72,242,20,0,495
2007,Iraq,Dahuk- Malaparwan,6,17,0,13,22,2,0,60,6,16,0,7,23,0,0,52
2007,Iraq,Dahuk- Kure Gavana,0,2,0,4,12,1,0,19,0,0,0,3,16,1,0,20
2007,Iraq,Dahuk- Hussainiya,19,65,0,44,116,19,0,263,20,76,0,40,113,15,0,264
2007,Iraq,Dahuk- Grey Gewry,29,102,0,53,178,7,0,369,37,120,0,53,167,11,0,388
2007,Iraq,Dahuk- Dohuk,34,68,0,41,175,7,0,325,37,92,0,53,166,3,0,351
2007,Iraq,Dahuk- Daratoo,11,49,0,36,123,6,0,225,15,74,0,48,123,7,0,267
2007,Iraq,Dahuk- Balqus Camp,5,14,0,10,19,3,0,51,5,16,0,11,25,0,0,57
2007,Iraq,Dahuk,0,0,0,0,0,0,0,0,0,0,0,0,1,0,0,1
2007,Iraq,Basrah-Alzubair,1,11,0,4,21,5,0,42,2,17,0,8,20,1,0,48
2007,Iraq,Basrah-Altanuma,1,9,0,5,13,3,0,31,1,13,0,7,12,0,0,33
2007,Iraq,Basrah-Alshuaba,0,10,0,7,25,6,0,48,1,16,0,7,40,5,0,69
2007,Iraq,Basrah-Alchabasi,2,10,0,11,44,6,0,73,3,17,0,10,33,7,0,70
2007,Iraq,Basrah-AbulKhasib,1,14,0,9,35,5,0,64,4,18,0,3,32,3,0,60
2007,Iraq,Basrah,19,71,0,31,123,9,0,253,14,52,0,36,109,4,0,215
2007,Iraq,Baghdad,290,603,0,475,1182,4079,0,6629,304,614,0,533,4297,643,0,6391
2007,Iraq,Babylon-Hilla,0,2,0,3,16,2,0,23,1,1,0,3,19,7,0,31
2007,Iraq,Anbar-Rutbah,6,6,0,2,10,0,0,24,4,8,0,2,98,1,0,113
2007,Iraq,Anbar-Ramadi,1,8,0,3,20,3,0,35,0,2,0,2,19,4,0,27
2007,Iraq,Anbar-AlWaleed,95,115,0,102,381,38,0,731,93,127,0,118,537,40,0,915
2007,Iraq,Anbar-AlTash,0,0,0,0,0,0,0,0,0,0,0,0,6,0,0,6
2007,Iraq,Anbar-Al Tash Camp,5,22,0,21,52,4,0,104,4,14,0,21,60,3,0,102
2007,Iraq,Anbar-Al Tash,0,1,0,1,0,0,0,2,0,1,0,0,0,1,0,2
2007,Iraq,Anbar-Al Tanf,2,1,0,4,8,0,0,15,0,2,0,4,9,0,0,15
2007,Iraq,Anbar,0,15,0,12,30,4,0,61,1,14,0,9,28,4,0,56
2007,Kazakhstan,Kazakhstan,0,0,0,0,0,0,3900,3900,0,0,0,0,0,0,3956,3956
2007,Kazakhstan,Almaty,40,50,0,31,140,12,0,273,46,27,0,62,253,2,0,390
2007,Kenya,Nairobi,731,2198,0,2052,9180,199,0,14360,967,2599,0,2483,13784,890,0,20723
2007,Kenya,Kakuma,3673,5326,0,3683,12880,551,0,26113,3893,6190,0,5428,20500,373,0,36384
2007,Kenya,Ifo (Dadaab),4152,5562,0,3884,15514,915,0,30027,4420,5935,0,4684,15791,975,0,31805
2007,Kenya,Hagadera (Dadaab),4859,6377,0,4192,17823,988,0,34239,4989,6997,0,4822,18274,1091,0,36173
2007,Kenya,Dagahaley (Dadaab),2932,3998,0,2373,9440,605,0,19348,3118,4234,0,2963,9267,696,0,20278
2007,Kenya,Dadaab,127,149,0,128,468,17,0,889,130,176,0,113,716,20,0,1155
2007,Kyrgyzstan,Talas region,0,0,0,0,0,0,130,130,0,0,0,0,0,0,90,90
2007,Kyrgyzstan,Osh region,0,0,0,1,3,0,60,64,0,0,0,1,2,0,20,23
2007,Kyrgyzstan,Osh city,6,10,0,6,23,0,60,105,8,14,0,4,27,1,70,124
2007,Kyrgyzstan,Issyk-Kul region,1,0,0,0,4,0,180,185,1,0,0,1,2,0,150,154
2007,Kyrgyzstan,Djalalabat region,0,1,0,1,1,0,200,203,0,0,0,0,1,0,160,161
2007,Kyrgyzstan,Chui region,5,12,0,29,148,15,3080,3289,9,14,0,34,144,6,2960,3167
2007,Kyrgyzstan,Bishkek city,25,38,0,55,175,9,1000,1302,17,32,0,64,372,11,1070,1566
2007,Kyrgyzstan,Batken region,0,0,0,0,0,0,130,130,0,0,0,0,0,0,120,120
2007,Cambodia,Phnom Penh,10,13,0,26,92,0,0,141,10,26,0,19,220,2,0,277
2007,Rep. of Korea,Daejeon,0,0,0,0,0,0,0,0,0,0,0,0,2,0,0,2
2007,Rep. of Korea,Daegu,0,0,0,0,7,0,0,7,1,0,0,0,39,0,0,40
2007,Rep. of Korea,Cheongju,0,0,0,0,0,0,0,0,0,0,0,0,1,0,0,1
2007,Rep. of Korea,Busan,0,0,0,0,0,0,0,0,0,0,0,0,3,0,0,3
2007,Rep. of Korea,Seoul/Kyunggi Province,11,2,0,1,206,12,0,232,10,4,0,1,971,2,0,988
2007,Kuwait,Kuwait,30,48,0,68,225,5,0,376,27,43,0,48,356,10,0,484
2007,Liberia,Voa,101,127,0,148,393,25,0,794,111,202,0,197,515,29,0,1054
2007,Liberia,Sinoe,0,0,0,0,0,0,98,98,0,0,0,0,0,0,89,89
2007,Liberia,Samukai,62,88,0,64,190,8,0,412,61,79,0,67,304,7,0,518
2007,Liberia,Saclepea,36,114,0,106,337,25,0,618,74,86,0,109,394,37,0,700
2007,Liberia,River Gee,0,0,0,0,0,0,91,91,0,0,0,0,0,0,98,98
2007,Liberia,River Cess,0,0,0,0,0,0,5,5,0,0,0,0,0,0,4,4
2007,Liberia,Nimba,21,41,0,79,617,30,1390,2178,22,44,0,90,653,37,1351,2197
2007,Liberia,Montserrado,0,0,0,0,0,0,7471,7471,0,0,0,0,0,0,7251,7251
2007,Liberia,Monrovia,4,11,0,26,37,0,0,78,3,10,0,12,157,0,0,182
2007,Liberia,Maryland,14,67,0,51,211,16,1297,1656,19,45,0,67,223,6,1152,1512
2007,Liberia,Margibi,0,0,0,0,0,0,140,140,0,0,0,0,0,0,161,161
2007,Liberia,Lofa,0,0,0,0,0,0,5334,5334,0,0,0,0,0,0,5012,5012
2007,Liberia,Grand Kru,0,0,0,0,0,0,141,141,0,0,0,0,0,0,95,95
2007,Liberia,Grand Gedeh,53,79,0,101,1306,41,2118,3698,88,65,0,96,1246,61,1706,3262
2007,Liberia,Grand Cape Mountain,0,0,0,0,0,0,1314,1314,0,0,0,0,0,0,1270,1270
2007,Liberia,Grand Bassa,0,0,0,0,0,0,29,29,0,0,0,0,0,0,26,26
2007,Liberia,Gbarpolu,0,0,0,0,0,0,147,147,0,0,0,0,0,0,200,200
2007,Liberia,Bong,0,0,0,0,0,0,935,935,0,0,0,0,0,0,1001,1001
2007,Liberia,Bomi,0,0,0,0,0,0,131,131,0,0,0,0,0,0,117,117
2007,Liberia,Banjor,11,80,0,76,199,1,0,367,20,78,0,83,164,4,0,349
2007,Saint Lucia,Castries,0,0,0,0,0,0,0,0,0,0,0,0,3,0,0,3
2007,Sri Lanka,Vavuniya,0,0,0,0,0,0,18869,18869,0,0,0,0,0,0,18131,18131
2007,Sri Lanka,Trincomalee,0,0,0,0,0,0,6120,6120,0,0,0,0,0,0,5880,5880
2007,Sri Lanka,Puttalam,3421,6007,0,3209,17152,1591,1452,32832,3569,6390,0,3196,17191,1419,1470,33235
2007,Sri Lanka,Mullaitivu,0,0,0,0,0,0,44676,44676,0,0,0,0,0,0,42924,42924
2007,Sri Lanka,Mannar,0,0,0,0,0,0,20655,20655,0,0,0,0,0,0,19845,19845
2007,Sri Lanka,Kurunegala,0,0,0,0,0,0,184,184,0,0,0,0,0,0,187,187
2007,Sri Lanka,Kilinochchi,0,0,0,0,0,0,30141,30141,0,0,0,0,0,0,28959,28959
2007,Sri Lanka,Jaffna,0,0,0,0,0,0,45330,45330,0,0,0,0,0,0,44070,44070
2007,Sri Lanka,Colombo,23,31,0,22,98,6,293,473,14,34,0,23,126,3,299,499
2007,Sri Lanka,Batticaloa,0,0,0,0,0,0,18360,18360,0,0,0,0,0,0,17640,17640
2007,Sri Lanka,Anuradhapura,0,0,0,0,0,0,5641,5641,0,0,0,0,0,0,5459,5459
2007,Sri Lanka,Ampara,0,0,0,0,0,0,2856,2856,0,0,0,0,0,0,2744,2744
2007,Lithuania,Vilnius,0,0,0,0,0,0,3,3,0,0,0,0,0,0,0,0
2007,Lithuania,Ukmergė,0,0,0,0,0,0,4,4,0,0,0,0,0,0,4,4
2007,Lithuania,Telšiai,0,0,0,0,0,0,1,1,0,0,0,0,0,0,5,5
2007,Lithuania,Refugee reception center,0,0,0,0,0,0,34,34,0,0,0,0,0,0,33,33
2007,Lithuania,Pabradė,0,0,0,0,0,0,3,3,0,0,0,0,0,0,3,3
2007,Lithuania,Marijampolė,0,0,0,0,0,0,5,5,0,0,0,0,0,0,2,2
2007,Lithuania,Lentvaris,0,0,0,0,0,0,3,3,0,0,0,0,0,0,1,1
2007,Lithuania,Klaipėda,0,0,0,0,0,0,26,26,0,0,0,0,0,0,15,15
2007,Lithuania,Kaunas,0,0,0,0,0,0,45,45,0,0,0,0,0,0,47,47
2007,Lithuania,Jonava,0,0,0,0,0,0,4,4,0,0,0,0,0,0,6,6
2007,Lithuania,Elektrėnai,0,0,0,0,0,0,7,7,0,0,0,0,0,0,15,15
2007,Lithuania,Alytus,0,0,0,0,0,0,10,10,0,0,0,0,0,0,6,6
2007,Latvia,Salaspils,0,0,0,0,0,0,0,0,0,0,0,0,1,0,0,1
2007,Latvia,Riga district,0,0,0,0,2,0,0,2,1,0,0,0,17,0,0,18
2007,Latvia,Riga,0,0,0,1,3,0,0,4,1,1,0,1,13,0,0,16
2007,Latvia,Jurmala,0,0,0,1,1,0,0,2,0,0,0,0,1,0,0,1
2007,Latvia,Jelgava,0,0,0,0,0,0,0,0,0,0,0,0,1,0,0,1
2007,Morocco,Rabat,54,48,0,55,283,3,0,443,60,36,0,53,857,8,0,1014
2007,Mexico,Mexico City,3,0,0,36,519,85,0,643,7,1,0,56,870,88,0,1022
2007,The former Yugoslav Republic of Macedonia,Veles,0,0,0,0,0,0,0,0,0,0,0,0,1,0,0,1
2007,The former Yugoslav Republic of Macedonia,Valandovo,1,1,0,1,5,0,0,8,0,2,0,0,4,1,0,7
2007,The former Yugoslav Republic of Macedonia,Tetovo,3,5,0,3,13,1,0,25,0,4,0,8,15,1,0,28
2007,The former Yugoslav Republic of Macedonia,Sv.Nikole,0,0,0,0,0,1,0,1,0,0,0,0,0,0,0,0
2007,The former Yugoslav Republic of Macedonia,Strumica,0,0,0,0,1,0,0,1,0,0,0,0,0,0,0,0
2007,The former Yugoslav Republic of Macedonia,Skopje,102,151,0,136,436,34,0,859,114,159,0,106,437,26,0,842
2007,The former Yugoslav Republic of Macedonia,Prilep,0,0,0,0,1,0,0,1,0,0,0,0,4,0,0,4
2007,The former Yugoslav Republic of Macedonia,"Panada, Skopje",0,0,0,0,0,0,0,0,0,0,0,0,1,0,0,1
2007,The former Yugoslav Republic of Macedonia,Ohrid,0,0,0,0,0,0,0,0,0,0,0,0,1,0,0,1
2007,The former Yugoslav Republic of Macedonia,Ohird,1,1,0,1,1,0,0,4,0,0,0,2,0,0,0,2
2007,The former Yugoslav Republic of Macedonia,Kumanovo,0,2,0,6,14,0,0,22,0,1,0,10,10,1,0,22
2007,The former Yugoslav Republic of Macedonia,Krusevo,0,0,0,0,0,0,0,0,0,0,0,0,0,1,0,1
2007,The former Yugoslav Republic of Macedonia,Kicevo,0,0,0,0,1,0,0,1,0,0,0,0,0,0,0,0
2007,The former Yugoslav Republic of Macedonia,Kavadarci,0,0,0,0,2,0,0,2,0,0,0,0,0,0,0,0
2007,The former Yugoslav Republic of Macedonia,Gostivar,0,1,0,0,4,0,0,5,0,0,0,0,0,0,0,0
2007,The former Yugoslav Republic of Macedonia,Gevgelija,0,0,0,0,2,0,0,2,0,0,0,0,1,0,0,1
2007,The former Yugoslav Republic of Macedonia,Geriatric clinic,0,0,0,0,0,1,0,1,0,0,0,0,0,0,0,0
2007,The former Yugoslav Republic of Macedonia,"Elder.home, Kumanovo",0,0,0,0,0,1,0,1,0,0,0,0,0,0,0,0
2007,The former Yugoslav Republic of Macedonia,Cicino selo,1,2,0,0,2,0,0,5,3,1,0,0,7,0,0,11
2007,The former Yugoslav Republic of Macedonia,Berovo,0,0,0,0,1,0,0,1,0,0,0,0,0,0,0,0
2007,Mali,Sikasso,0,0,0,0,0,0,0,0,0,0,0,0,5,0,0,5
2007,Mali,Kayes,819,731,0,425,571,90,0,2636,349,623,0,1214,1217,126,0,3529
2007,Mali,Faragouana,5,6,0,0,15,1,0,27,6,6,0,4,10,1,0,27
2007,Mali,Bamako,155,218,0,171,1116,23,0,1683,172,259,0,204,2534,37,0,3206
2007,Malta,Ta Kandja,0,0,0,0,0,0,0,0,0,0,0,0,62,0,0,62
2007,Malta,Safi Barracks,0,0,0,0,0,0,0,0,0,0,0,0,824,0,0,824
2007,Malta,Peace Lab,0,0,0,0,3,0,0,3,0,0,0,0,21,0,0,21
2007,Malta,MEC Balzan Renting ,0,0,0,0,0,0,0,0,0,0,0,0,5,0,0,5
2007,Malta,MEC Balzan ,0,1,0,0,11,0,0,12,0,2,0,0,81,0,0,83
2007,Malta,Marsa Open Centre ,0,0,0,0,0,0,0,0,0,0,0,0,794,0,0,794
2007,Malta,Lyster Barracks,1,0,0,0,124,0,0,125,0,0,0,0,627,0,0,627
2007,Malta,Hal Far Tent Viilage ,0,12,0,0,73,0,0,85,0,22,0,0,655,0,0,677
2007,Malta,Hal Far Oiwas,0,0,0,0,18,0,0,18,0,0,0,0,127,0,0,127
2007,Malta,Dar Is-Sliem,0,0,0,0,4,0,0,4,0,0,0,0,26,0,0,26
2007,Malta,Dar Il-Qawsalla,0,0,0,0,5,0,0,5,0,2,0,0,34,0,0,36
2007,Malta,Dar Il-Liedna,0,0,0,0,7,0,0,7,0,2,0,0,45,0,0,47
2007,Malta,Community,4,7,0,0,37,0,0,48,6,13,0,0,94,0,0,113
2007,Malta,Malta Emigrants Commission ,0,1,0,0,8,0,0,9,0,2,0,0,61,0,0,63
2007,Myanmar,Maungdaw,30669,49352,0,37531,99177,8563,0,225292,36937,52958,0,44498,82007,9014,0,225414
2007,Myanmar,Buthidaung,15851,27303,0,18101,52103,4395,0,117753,17115,29210,0,21930,44440,5023,0,117718
2007,Montenegro,Zabljak,0,0,0,5,6,0,0,11,1,2,0,0,4,1,0,8
2007,Montenegro,Ulcinj,11,22,0,34,154,64,0,285,4,41,0,30,138,48,0,261
2007,Montenegro,Tivat,10,52,0,52,334,135,0,583,10,52,0,83,290,98,0,533
2007,Montenegro,Savnik,0,0,0,0,2,2,0,4,0,1,0,1,3,2,0,7
2007,Montenegro,Rozaje,2,37,0,44,131,24,0,238,10,48,0,36,116,21,0,231
2007,Montenegro,Podgorica,255,592,0,493,2412,561,0,4313,311,620,0,574,2090,400,0,3995
2007,Montenegro,Pluzine,0,0,0,0,10,3,0,13,0,0,0,0,6,3,0,9
2007,Montenegro,Pljevlja,1,12,0,23,126,33,0,195,3,10,0,10,87,22,0,132
2007,Montenegro,Plav,5,38,0,51,274,85,0,453,10,58,0,56,217,75,0,416
2007,Montenegro,Niksic,14,61,0,91,452,118,0,736,12,77,0,94,324,66,0,573
2007,Montenegro,Nepoznata,3,0,0,2,2,0,0,7,1,1,0,0,3,0,0,5
2007,Montenegro,Mojkovac,2,5,0,8,35,10,0,60,1,7,0,2,27,8,0,45
2007,Montenegro,Kotor,2,16,0,13,140,68,0,239,0,18,0,26,152,47,0,243
2007,Montenegro,Kolasin,2,12,0,5,82,35,0,136,1,9,0,15,85,27,0,137
2007,Montenegro,Herceg-Novi,8,49,0,78,779,346,0,1260,11,73,0,76,634,260,0,1054
2007,Montenegro,Danilovgrad,2,11,0,34,156,71,0,274,4,26,0,39,121,46,0,236
2007,Montenegro,Cetinje,1,2,0,3,26,10,0,42,0,5,0,1,14,6,0,26
2007,Montenegro,Budva,7,44,0,50,378,128,0,607,7,62,0,53,363,99,0,584
2007,Montenegro,Bijelo Polje,3,37,0,29,170,34,0,273,0,44,0,32,118,27,0,221
2007,Montenegro,Berane,44,191,0,162,707,217,0,1321,67,159,0,182,612,132,0,1152
2007,Montenegro,Bar,34,161,0,178,945,364,0,1682,32,164,0,201,886,269,0,1552
2007,Montenegro,Andrijevica,2,40,0,38,145,52,0,277,3,37,0,36,138,42,0,256
2007,Mongolia,Ulaanbaatar,0,0,0,0,2,0,0,2,0,0,0,0,6,0,0,6
2007,Mozambique,Zambezi,3,0,0,1,6,0,0,10,4,3,0,0,12,0,0,19
2007,Mozambique,Tete,2,0,0,3,6,0,0,11,0,1,0,1,8,0,0,10
2007,Mozambique,Sofala,2,1,0,2,8,0,0,13,3,1,0,1,12,0,0,17
2007,Mozambique,Niassa,7,20,0,6,20,0,0,53,11,15,0,8,35,0,0,69
2007,Mozambique,Nampula,32,43,0,20,80,4,0,179,43,54,0,26,186,5,0,314
2007,Mozambique,Maratane,400,546,0,244,838,17,0,2045,422,584,0,276,1273,3,0,2558
2007,Mozambique,Maputo,110,167,0,77,316,8,0,678,94,142,0,80,511,11,0,838
2007,Mozambique,Manica,2,1,0,2,8,0,0,13,2,0,0,2,14,0,0,18
2007,Mozambique,Inhambane,2,2,0,1,7,0,0,12,2,5,0,2,10,0,0,19
2007,Mozambique,Gaza,2,4,0,1,8,0,0,15,6,4,0,3,14,0,0,27
2007,Mozambique,Cabo Delegado,3,1,0,0,0,0,0,4,0,1,0,0,5,0,0,6
2007,Mauritania,Nouakchott/Nouadhibou,48,41,0,23,227,10,0,349,47,54,0,33,500,13,0,647
2007,Malawi,Lilongwe,59,82,0,68,211,6,0,426,76,98,0,59,359,3,0,595
2007,Malawi,Dzaleka,758,1040,0,525,1659,29,0,4011,806,980,0,651,2210,32,0,4679
2007,Malaysia,Kuala Lumpur,1224,1469,0,1244,7561,158,0,11656,1358,1601,0,1755,22892,248,0,27854
2007,Namibia,Osire,563,776,0,598,1511,55,0,3503,560,811,0,605,2192,59,0,4227
2007,Namibia,Dukwe,2,15,0,3,13,0,0,33,6,6,0,5,3,0,0,20
2007,Niger,Niamey,7,25,0,11,49,1,0,93,7,17,0,6,94,0,0,124
2007,Niger,Goure,2,12,0,14,29,4,0,61,5,8,0,11,31,5,0,60
2007,Nigeria,Oru Camp,84,305,0,275,1606,98,0,2368,81,266,0,350,2366,67,0,3130
2007,Nigeria,Lagos,85,125,0,130,1081,0,0,1421,97,194,0,157,1616,7,0,2071
2007,Nigeria,Ijebu-Ode,15,5,0,5,38,0,0,63,11,8,0,1,87,0,0,107
2007,Nicaragua,Managua City,0,0,0,3,118,2,0,123,0,0,0,4,67,15,0,86
2007,Nepal,Timai,426,695,0,670,2984,334,0,5109,458,707,0,757,3029,361,0,5312
2007,Nepal,Sanischare,841,1413,0,1315,6297,683,0,10549,908,1481,0,1312,6371,765,0,10837
2007,Nepal,Out of Camp,2,4,0,3,29,3,0,41,1,2,0,6,62,4,0,75
2007,Nepal,Khudunabari,425,851,0,943,3938,426,0,6583,488,792,0,901,3912,550,0,6643
2007,Nepal,Kathmandu,20,11,0,8,58,1,0,98,20,17,0,27,137,2,0,203
2007,Nepal,Goldhap,358,541,0,599,2897,319,0,4714,390,552,0,605,3059,374,0,4980
2007,Nepal,Eastern Region,39,89,0,104,379,46,0,657,32,101,0,116,594,50,0,893
2007,Nepal,Beldangi 2 Extension,451,725,0,718,3414,380,0,5688,485,822,0,706,3488,425,0,5926
2007,Nepal,Beldangi 2,789,1339,0,1400,6918,755,0,11201,822,1428,0,1521,6825,873,0,11469
2007,Nepal,Beldangi 1,795,1227,0,1253,5362,570,0,9207,759,1329,0,1258,5461,669,0,9476
2007,Oman,Maskat,2,0,0,4,14,0,0,20,3,0,0,8,13,4,0,28
2007,Pakistan,Zar Karez,249,767,0,409,1061,71,0,2557,256,869,0,494,1200,136,0,2955
2007,Pakistan,Zangal Patai,323,1033,0,610,1470,86,0,3522,726,1070,0,697,1489,161,0,4143
2007,Pakistan,Zafarabad,232,765,0,323,1024,51,0,2395,225,829,0,578,1340,128,0,3100
2007,Pakistan,Yakaghund,262,713,0,420,969,68,0,2432,238,751,0,417,970,127,0,2503
2007,Pakistan,Utmanzai,225,736,0,461,997,41,0,2460,241,735,0,489,948,134,0,2547
2007,Pakistan,Urguch,5,9,0,5,9,1,0,29,3,7,0,8,22,0,0,40
2007,Pakistan,Toor,396,931,0,511,1376,56,0,3270,394,960,0,546,1531,126,0,3557
2007,Pakistan,Timer,826,1949,0,1090,2757,114,0,6736,896,2108,0,1148,2785,246,0,7183
2007,Pakistan,Thall,796,2305,0,1332,3651,289,0,8373,797,2422,0,1470,3646,558,0,8893
2007,Pakistan,Surkhab,581,1486,0,782,2373,175,0,5397,618,1654,0,1060,3157,339,0,6828
2007,Pakistan,Sund Rawal,33,115,0,62,130,13,0,353,39,129,0,56,176,20,0,420
2007,Pakistan,Sindh,3922,10555,0,6315,17656,827,0,39275,4194,10760,0,8095,23412,2043,0,48504
2007,Pakistan,Shindand,70,236,0,151,303,17,0,777,71,244,0,151,337,44,0,847
2007,Pakistan,Shaikh Abad,280,862,0,546,1128,85,0,2901,291,877,0,603,1234,124,0,3129
2007,Pakistan,Saranan,1029,3317,0,1747,4897,312,0,11302,1076,3511,0,2243,5750,743,0,13323
2007,Pakistan,Rata Kulachi,38,101,0,40,122,0,0,301,330,105,0,69,144,21,0,669
2007,Pakistan,Rakh Zandani,1,1,0,2,2,7,0,13,29,4,0,4,5,0,0,42
2007,Pakistan,Quetta,4,6,0,15,26,0,0,51,3,6,0,15,23,2,0,49
2007,Pakistan,Pusha Pul,57,180,0,78,256,14,0,585,55,218,0,144,321,31,0,769
2007,Pakistan,Punjab,8379,21896,0,12164,35486,2005,0,79930,8894,23452,0,15810,48574,4007,0,100737
2007,Pakistan,Posti,12,26,0,12,40,3,0,93,11,25,0,17,60,5,0,118
2007,Pakistan,Pir Alizai,632,2246,0,1242,3043,161,0,7324,622,2468,0,1756,3942,451,0,9239
2007,Pakistan,Peshawar,2,0,0,11,8,7,0,28,1,0,0,7,17,0,0,25
2007,Pakistan,Panian,2911,8930,0,5470,13397,685,0,31393,3049,9167,0,5893,14103,1428,0,33640
2007,Pakistan,Palai,279,609,0,345,962,65,0,2260,276,638,0,363,1046,91,0,2414
2007,Pakistan,Padhana,492,1436,0,839,2106,141,0,5014,504,1560,0,926,2300,260,0,5550
2007,Pakistan,Old Shamshatoo,2981,8829,0,5880,14900,641,0,33231,170,9340,0,6627,15876,1312,0,33325
2007,Pakistan,Old Akora,1711,5695,0,3344,8680,314,0,19744,1867,5886,0,3851,9346,953,0,21903
2007,Pakistan,Oblan,536,1584,0,948,2294,134,0,5496,591,1717,0,1123,2346,291,0,6068
2007,Pakistan,North West Frontier Province,22683,64069,0,41037,112003,5874,0,245666,23831,68499,0,46324,120177,11486,0,270317
2007,Pakistan,New Akora,3,12,0,8,51,1,0,75,3,17,0,20,46,6,0,92
2007,Pakistan,Naurang,93,309,0,181,484,21,0,1088,90,388,0,190,478,62,0,1208
2007,Pakistan,Naguman,186,578,0,343,791,42,0,1940,201,661,0,360,805,101,0,2128
2007,Pakistan,Nagar,12,36,0,21,52,1,0,122,14,32,0,11,93,5,0,155
2007,Pakistan,Munda,628,1872,0,1160,2749,142,0,6551,591,1903,0,1201,2700,328,0,6723
2007,Pakistan,Mohammad Kheil,288,731,0,395,1035,67,0,2516,258,861,0,569,1241,193,0,3122
2007,Pakistan,Michni,11,32,0,23,53,4,0,123,7,35,0,22,70,8,0,142
2007,Pakistan,Mera Kachori,308,940,0,546,1442,83,0,3319,303,1005,0,576,1514,139,0,3537
2007,Pakistan,Mayar,145,462,0,252,652,35,0,1546,142,422,0,295,727,64,0,1650
2007,Pakistan,Malgagai,291,924,0,496,1443,118,0,3272,322,992,0,682,1691,235,0,3922
2007,Pakistan,Lejay Karez,44,160,0,99,249,24,0,576,30,155,0,135,330,49,0,699
2007,Pakistan,Lakti Banda,394,1140,0,688,1763,187,0,4172,423,1149,0,749,1821,307,0,4449
2007,Pakistan,Kund/Khairabad,728,1744,0,882,2444,146,0,5944,3092,1846,0,1087,2413,292,0,8730
2007,Pakistan,Kotwai,330,1120,0,599,1498,132,0,3679,356,1255,0,688,1570,215,0,4084
2007,Pakistan,Kotkai,235,789,0,491,1190,103,0,2808,274,772,0,581,1121,174,0,2922
2007,Pakistan,Kot Chandna,691,2095,0,1342,3067,185,0,7380,717,2140,0,1357,3201,335,0,7750
2007,Pakistan,Koga,556,1492,0,890,2255,136,0,5329,565,1587,0,941,2122,222,0,5437
2007,Pakistan,Khurasan,271,858,0,599,1838,107,0,3673,275,940,0,621,1955,157,0,3948
2007,Pakistan,Khoughani,119,402,0,278,655,19,0,1473,108,413,0,274,610,46,0,1451
2007,Pakistan,Kheshki,32,95,0,47,135,7,0,316,27,106,0,60,143,17,0,353
2007,Pakistan,Khazana,325,1077,0,581,1521,85,0,3589,361,1193,0,716,1637,151,0,4058
2007,Pakistan,Khaki,736,2222,0,1508,3218,205,0,7889,797,2319,0,1712,3206,344,0,8378
2007,Pakistan,Kesu,48,109,0,93,196,8,0,454,54,164,0,86,231,14,0,549
2007,Pakistan,Kata Kanri,372,948,0,609,1432,117,0,3478,397,983,0,609,1449,201,0,3639
2007,Pakistan,Karachi,1,0,0,7,10,0,0,18,0,0,0,4,4,0,0,8
2007,Pakistan,Kalatak,63,179,0,98,279,10,0,629,77,217,0,141,375,27,0,837
2007,Pakistan,Kaghan,142,311,0,180,463,20,0,1116,157,353,0,202,464,39,0,1215
2007,Pakistan,Kacha Gari,978,3175,0,1958,5545,264,0,11920,981,3550,0,2442,7356,472,0,14801
2007,Pakistan,Kababian,612,2022,0,1234,3088,96,0,7052,637,2090,0,1335,3323,292,0,7677
2007,Pakistan,Jerma,54,156,0,92,260,18,0,580,48,181,0,147,319,29,0,724
2007,Pakistan,Jalozai,3619,10918,0,6918,17693,834,0,39982,4028,11154,0,7519,19166,1767,0,43634
2007,Pakistan,Jalala,707,2134,0,1276,3362,189,0,7668,781,2296,0,1512,3542,361,0,8492
2007,Pakistan,Islamabad,1564,4081,0,2471,7365,405,0,15886,1604,4429,0,3109,9185,828,0,19155
2007,Pakistan,Ichirian,357,999,0,602,1543,97,0,3598,353,965,0,693,1813,182,0,4006
2007,Pakistan,Girsal,0,2,0,0,3,0,0,5,0,4,0,0,4,0,0,8
2007,Pakistan,Girdi Jungle,1455,3449,0,1619,5552,807,0,12882,1320,3531,0,2396,8543,1111,0,16901
2007,Pakistan,Ghulam Banda,394,1106,0,736,1695,79,0,4010,393,1237,0,762,1913,209,0,4514
2007,Pakistan,Ghiljo,84,283,0,183,445,17,0,1012,140,306,0,196,451,48,0,1141
2007,Pakistan,Ghazi,13,48,0,13,68,5,0,147,22,56,0,26,74,8,0,186
2007,Pakistan,Ghazgai Minara,112,338,0,162,441,34,0,1087,103,394,0,240,535,67,0,1339
2007,Pakistan,Gandhi Khan Khel,171,541,0,299,798,54,0,1863,0,570,0,334,785,107,0,1796
2007,Pakistan,Gandaf,692,1781,0,1141,2675,173,0,6462,674,1986,0,1164,3037,286,0,7147
2007,Pakistan,Gamkol,1626,5004,0,2814,7369,413,0,17226,1679,5217,0,3606,8933,801,0,20236
2007,Pakistan,Gambila,80,293,0,113,436,20,0,942,74,308,0,180,456,65,0,1083
2007,Pakistan,Domshivgar,13,25,0,19,39,2,0,98,3,30,0,21,55,6,0,115
2007,Pakistan,Dodpa,22,43,0,16,59,3,0,143,13,47,0,28,74,5,0,167
2007,Pakistan,Doaba,339,1090,0,604,1787,145,0,3965,363,1103,0,702,2002,265,0,4435
2007,Pakistan,Darsamand,291,747,0,445,1361,112,0,2956,296,821,0,511,1562,198,0,3388
2007,Pakistan,Daraban,4,10,0,6,16,0,0,36,5,10,0,4,19,2,0,40
2007,Pakistan,Dabara,98,365,0,148,570,32,0,1213,141,455,0,303,1026,87,0,2012
2007,Pakistan,Chichana,152,538,0,310,885,59,0,1944,167,526,0,411,1166,134,0,2404
2007,Pakistan,Chakdara,1067,2408,0,1447,3255,194,0,8371,1184,2478,0,1524,3552,311,0,9049
2007,Pakistan,Chagai,16,33,0,21,59,5,0,134,16,39,0,31,68,6,0,160
2007,Pakistan,Bizen Khel,46,216,0,127,322,15,0,726,66,255,0,144,355,49,0,869
2007,Pakistan,Basu Mera,267,817,0,502,1255,60,0,2901,280,870,0,518,1248,154,0,3070
2007,Pakistan,Barawal,13,54,0,26,74,5,0,172,21,56,0,21,91,7,0,196
2007,Pakistan,Barary,358,1066,0,717,1558,106,0,3805,389,1096,0,773,1732,171,0,4161
2007,Pakistan,Barari,10,37,0,28,57,3,0,135,14,41,0,21,66,6,0,148
2007,Pakistan,Barakai,1256,4243,0,2554,6327,323,0,14703,1392,4391,0,2892,6184,704,0,15563
2007,Pakistan,Balochistan,14291,41056,0,21799,65115,4724,0,146985,14971,44523,0,28038,78907,9374,0,175813
2007,Pakistan,Bakka Khel,30,127,0,51,176,11,0,395,41,160,0,88,259,27,0,575
2007,Pakistan,Baghicha,29,109,0,78,170,16,0,402,32,109,0,62,207,23,0,433
2007,Pakistan,Badaber,1704,5355,0,2990,7436,342,0,17827,1788,5381,0,3272,7567,779,0,18787
2007,Pakistan,Azakhel,1180,3496,0,2082,5293,231,0,12282,1208,3784,0,2394,5514,467,0,13367
2007,Pakistan,Azad Kashmir,279,822,0,475,1278,50,0,2904,298,869,0,626,1680,141,0,3614
2007,Panama,Panama City,33,28,0,35,425,88,0,609,48,42,0,30,696,103,0,919
2007,Panama,Kuna Yala,5,13,0,16,25,1,0,60,4,12,0,14,29,1,0,60
2007,Panama,Darien,68,72,0,74,159,14,0,387,68,58,0,63,173,25,0,387
2007,Philippines,Visayas,0,0,0,0,0,0,0,0,0,0,0,0,1,0,0,1
2007,Philippines,"NCR, Visayas",1,0,0,0,1,0,0,2,0,0,0,0,4,0,0,4
2007,Philippines,"NCR, Mindanao",0,0,0,1,1,0,0,2,0,1,0,1,21,0,0,23
2007,Philippines,"NCR, Luzon",0,0,0,0,0,0,0,0,0,0,0,0,12,0,0,12
2007,Philippines,Luzon,0,0,0,2,2,0,0,4,0,0,0,1,2,1,0,4
2007,Philippines,"NCR, Visayas, Luzon",0,0,0,0,0,0,0,0,0,0,0,0,20,0,0,20
2007,Philippines,"NCR, Luzon, Mindanao, Visayas",0,1,0,0,1,0,0,2,0,1,0,1,16,0,0,18
2007,Philippines,National Capital Region,0,0,0,0,3,0,0,3,0,2,0,0,40,0,0,42
2007,Papua New Guinea,Vanimo ,0,0,0,0,0,0,0,0,0,1,0,5,0,0,0,6
2007,Papua New Guinea,Port Moresby,0,0,0,0,0,0,0,0,0,0,0,3,0,0,0,3
2007,Papua New Guinea,East Arwin,142,391,0,618,46,0,0,1197,142,449,0,661,51,0,0,1303
2007,Papua New Guinea,Daru,0,0,0,0,0,0,0,0,0,0,0,3,0,0,0,3
2007,Paraguay,Asunción,0,0,0,6,24,1,0,31,0,1,0,3,40,1,0,45
2007,Qatar,Doha,0,0,0,8,14,0,0,22,1,2,0,5,56,4,0,68
2007,Russian Federation,Moscow,113,204,0,107,479,13,0,916,108,165,0,136,1216,18,0,1643
2007,Russian Federation,St. Petersburg,12,30,0,21,64,0,0,127,11,21,0,13,161,1,0,207
2007,Rwanda,Umutara,0,0,0,0,0,0,0,0,0,0,0,2,2,0,0,4
2007,Rwanda,Ruhengeri,114,114,0,30,346,5,0,609,105,82,0,29,200,0,0,416
2007,Rwanda,Nyagatare(Cyangugu),265,258,0,229,510,22,0,1284,264,231,0,252,360,12,0,1119
2007,Rwanda,Nyabiheke (Byumba),921,1139,0,778,1927,111,0,4876,843,1126,0,674,993,70,0,3706
2007,Rwanda,Nkamira (Gisenyi),203,208,0,196,456,11,0,1074,200,192,0,137,143,9,0,681
2007,Rwanda,Kiziba (Kibuye),2076,2082,0,1784,3707,355,0,10004,1947,2070,0,1562,2258,289,0,8126
2007,Rwanda,Kigeme (Gikongoro),239,194,0,151,439,18,0,1041,241,209,0,148,375,16,0,989
2007,Rwanda,Kigali Ville,7,8,0,2,27,3,0,47,8,7,0,5,36,0,0,56
2007,Rwanda,Kigali Ngali,37,37,0,5,85,0,0,164,29,18,0,9,35,2,0,93
2007,Rwanda,Kigali,177,401,0,313,758,16,0,1665,171,412,0,333,729,14,0,1659
2007,Rwanda,Kibuye,73,50,0,22,174,5,0,324,58,39,0,15,98,1,0,211
2007,Rwanda,Kibungo,14,14,0,4,28,1,0,61,10,10,0,6,37,0,0,63
2007,Rwanda,Gitarama,11,8,0,6,41,0,0,66,9,17,0,4,43,0,0,73
2007,Rwanda,Gisenyi,254,199,0,44,632,12,0,1141,214,141,0,47,337,8,0,747
2007,Rwanda,Gikongoro,6,5,0,0,17,0,0,28,5,3,0,0,18,0,0,26
2007,Rwanda,Gihembe (Byumba),1974,2160,0,1767,3728,343,0,9972,1949,2061,0,1529,2379,191,0,8109
2007,Rwanda,Cyangugu,879,998,0,538,688,123,0,3226,371,565,0,431,445,97,0,1909
2007,Rwanda,Byumba,6,7,0,5,16,0,0,34,5,1,0,1,16,0,0,23
2007,Rwanda,Butare,9,8,0,3,35,0,0,55,10,11,0,4,58,0,0,83
2007,Saudi Arabia,Riyadh,8,48,0,35,102,5,0,198,9,51,0,49,178,10,0,297
2007,Saudi Arabia,Rafha ,8,14,0,12,26,3,0,63,10,12,0,7,116,1,0,146
2007,Saudi Arabia,Madina,1,1,0,0,1,0,0,3,0,0,0,0,3,0,0,3
2007,Saudi Arabia,Khobar,0,2,0,2,2,0,0,6,0,1,0,1,10,0,0,12
2007,Saudi Arabia,Jeddah,13,21,0,27,45,2,0,108,9,29,0,19,82,5,0,144
2007,Saudi Arabia,Gizan,0,0,0,0,0,0,0,0,0,0,0,0,28,0,0,28
2007,Saudi Arabia,Arar,0,0,0,0,0,0,0,0,0,0,0,0,1,0,0,1
2007,Saudi Arabia,Al-Qateef,1,2,0,0,1,0,0,4,0,0,0,4,1,0,0,5
2007,Saudi Arabia,Al-Ihsa,0,0,0,0,0,0,0,0,0,0,0,0,1,0,0,1
2007,Sudan,White Nile,0,0,0,0,0,0,6,6,0,0,0,0,0,0,6,6
2007,Sudan,Western Equatoria State,425,511,0,782,1397,77,0,3192,450,511,0,817,1352,117,0,3247
2007,Sudan,West Darfur State,0,0,0,0,0,0,235570,235570,0,0,0,0,0,0,235568,235568
2007,Sudan,Warrab,7,42,0,25,23,0,0,97,6,51,0,78,127,2,0,264
2007,Sudan,Wad Sherife,1108,3513,0,2993,8814,1559,1710,19697,874,2771,0,2360,6952,1230,2545,16732
2007,Sudan,Wad El Hileau,0,0,0,0,0,0,1500,1500,0,0,0,0,0,0,1500,1500
2007,Sudan,Upper Nile State,711,398,0,1440,1575,49,0,4173,716,380,0,1677,999,22,0,3794
2007,Sudan,Unity State,61,0,0,118,113,2,0,294,56,2,0,138,122,3,0,321
2007,Sudan,Um Shalaya,0,0,0,0,0,0,2952,2952,0,0,0,0,0,0,2952,2952
2007,Sudan,Um Sagata,0,0,0,0,0,0,3500,3500,0,0,0,0,0,0,3500,3500
2007,Sudan,Um Gulja/Um Rakuba,0,0,0,0,0,0,1200,1200,0,0,0,0,0,0,1200,1200
2007,Sudan,Um Gargur,2,8,0,10,38,3,0,61,3,11,0,5,27,7,0,53
2007,Sudan,Um Ali,0,0,0,0,0,0,200,200,0,0,0,0,0,0,200,200
2007,Sudan,Sudan,0,0,0,0,0,0,8406,8406,0,0,0,0,0,0,7454,7454
2007,Sudan,Southern Kordofan,0,0,0,0,0,0,4,4,0,0,0,16,1,0,0,17
2007,Sudan,"Shagrabs 1, 2 & 3",1599,2147,0,1829,4873,789,0,11237,1677,1717,0,1464,5855,756,0,11469
2007,Sudan,Shagarab I  ,0,0,0,0,0,0,68,68,0,0,0,0,0,0,273,273
2007,Sudan,Senna State,0,0,0,0,0,0,3,3,0,0,0,0,0,0,3,3
2007,Sudan,Red Sea State,0,0,0,0,0,0,2,2,0,0,0,0,1,0,0,1
2007,Sudan,Port Sudan,0,0,0,0,0,0,2751,2751,0,0,0,0,0,0,2751,2751
2007,Sudan,Pochalla,0,0,0,0,0,0,3604,3604,0,0,0,0,0,0,3196,3196
2007,Sudan,Pibor,0,0,0,0,0,0,171,171,0,0,0,0,0,0,245,245
2007,Sudan,Northern Kordofan,0,0,0,0,0,0,2,2,0,0,0,0,0,0,5,5
2007,Sudan,Northern Baragazal,12,2,0,42,102,1,0,159,13,85,0,32,47,1,0,178
2007,Sudan,Nile,0,0,0,0,0,0,4,4,0,0,0,0,0,0,4,4
2007,Sudan,Mukjar,0,0,0,0,0,0,241,241,0,0,0,0,0,0,240,240
2007,Sudan,Malakal,0,0,0,0,0,0,37,37,0,0,0,0,0,0,105,105
2007,Sudan,Lologo,0,0,0,0,0,0,517,517,0,0,0,0,0,0,517,517
2007,Sudan,Lakes State,28,32,0,52,51,3,0,166,26,34,0,105,168,4,0,337
2007,Sudan,Laffa-Gulsa,0,0,0,0,0,0,4750,4750,0,0,0,0,0,0,4750,4750
2007,Sudan,Kordofan,0,0,0,0,0,0,60,60,0,0,0,0,0,0,54,54
2007,Sudan,Khartoum,334,276,0,3951,9878,327,439400,454166,339,226,0,3975,13863,330,439400,458133
2007,Sudan,Kassala,0,0,0,0,0,0,3011,3011,0,9,0,0,1,0,3000,3010
2007,Sudan,Karkora,0,0,0,0,0,0,1500,1500,0,0,0,0,0,0,1500,1500
2007,Sudan,Juba,0,0,0,0,0,0,447,447,0,0,0,0,0,0,302,302
2007,Sudan,Jonglei,205,21,0,402,544,45,0,1217,147,6,0,474,226,24,0,877
2007,Sudan,Jezeera,0,0,0,0,0,0,16,16,0,0,0,0,0,0,19,19
2007,Sudan,Girba,442,711,0,606,2707,110,0,4576,420,656,0,559,2774,96,0,4505
2007,Sudan,Gedarif,0,0,0,0,0,0,1250,1250,0,0,0,0,0,0,1250,1250
2007,Sudan,Fau 5,87,35,0,31,583,27,0,763,75,30,0,27,505,23,0,660
2007,Sudan,Ezo,0,0,0,0,0,0,1113,1113,0,0,0,0,0,0,987,987
2007,Sudan,El Miri,0,0,0,0,0,0,0,0,0,0,0,0,1,0,0,1
2007,Sudan,Eastern Equatoria State,906,36,0,1557,1611,177,0,4287,898,39,0,1641,1135,118,0,3831
2007,Sudan,Central Equatoria State,1085,53,0,2372,2651,192,0,6353,1042,127,0,2409,1521,132,0,5231
2007,Sudan,Blue Nile State,1169,3,0,1920,2929,70,12500,18591,1149,15,0,2773,1329,90,12500,17856
2007,Sudan,Abuda,220,292,0,250,1043,170,0,1975,226,300,0,257,1072,175,0,2030
2007,Sudan,Abu Rakham area,0,0,0,0,0,0,1550,1550,0,0,0,0,0,0,1550,1550
2007,Senegal,Podor,940,1425,0,819,1325,239,0,4748,624,972,0,517,870,159,0,3142
2007,Senegal,Matam,935,1129,0,1112,1322,240,0,4738,633,750,0,732,885,160,0,3160
2007,Senegal,Dakar,40,47,0,70,842,23,0,1022,53,88,0,70,2190,33,0,2434
2007,Senegal,Dagana,228,169,0,371,314,57,0,1139,153,154,0,204,217,38,0,766
2007,Senegal,Bakel,217,228,0,279,308,54,0,1086,145,212,0,132,199,36,0,724
2007,Singapore,Singapore,0,0,0,0,4,0,0,4,0,0,0,4,26,0,0,30
2007,Sierra Leone,Tobanda,32,78,0,45,149,7,0,311,35,60,0,44,120,6,0,265
2007,Sierra Leone,Taiama,36,89,0,37,142,8,0,312,48,63,0,54,221,3,0,389
2007,Sierra Leone,Largo,26,50,0,31,96,6,0,209,33,39,0,29,73,5,0,179
2007,Sierra Leone,Kenema,80,191,0,194,499,17,0,981,67,158,0,204,537,41,0,1007
2007,Sierra Leone,Jimmi Bagbo,37,40,0,46,95,0,0,218,32,42,0,48,138,5,0,265
2007,Sierra Leone,Jembe,26,61,0,35,105,3,0,230,25,75,0,41,117,3,0,261
2007,Sierra Leone,Gondama,72,157,0,107,304,6,0,646,86,174,0,104,293,9,0,666
2007,Sierra Leone,Gerihun,25,53,0,26,87,5,0,196,17,38,0,44,99,6,0,204
2007,Sierra Leone,Freetown,31,102,0,128,461,20,0,742,30,97,0,133,668,16,0,944
2007,Sierra Leone,Bo,21,51,0,70,225,8,0,375,22,48,0,62,181,8,0,321
2007,Sierra Leone,Bandajuma,22,31,0,29,66,2,0,150,20,34,0,27,66,6,0,153
2007,El Salvador,San Salvador,0,0,0,0,2,0,0,2,0,0,0,0,12,1,0,13
2007,El Salvador,San Miguel,0,0,0,0,0,0,0,0,0,0,0,0,1,0,0,1
2007,El Salvador,La Union,0,0,0,0,7,1,0,8,0,0,0,0,14,3,0,17
2007,El Salvador,Cuscatlan,0,0,0,0,1,0,0,1,0,1,0,0,1,0,0,2
2007,Somalia,South/Center Somaila,92000,87200,0,56000,159200,14400,0,408800,86400,89600,0,56800,145600,12800,0,391200
2007,Somalia,North/West Somalia,8234,7835,0,5078,14693,1296,0,37136,7766,8037,0,5144,13362,1153,0,35462
2007,Somalia,North/East Somalia,15011,14190,0,9114,25992,2344,0,66651,14092,14583,0,9253,23822,2081,0,63831
2007,Serbia and Kosovo (S/RES/1244 (1999)),Vojvodina,101,1716,0,2322,16581,9880,0,30600,110,1853,0,2531,19490,5993,0,29977
2007,Serbia and Kosovo (S/RES/1244 (1999)),Kosovo,96,164,0,136,550,99,9743,10788,90,162,0,133,557,107,11585,12634
2007,Serbia and Kosovo (S/RES/1244 (1999)),Central/Southern Serbia,115,5494,0,6589,36631,12501,0,61330,137,5808,0,6889,37046,10084,0,59964
2007,Serbia and Kosovo (S/RES/1244 (1999)),Belgrade area/West Serbia,187,4634,0,5999,35680,15495,0,61995,201,4927,0,6416,37452,10482,0,59478
2007,Serbia and Kosovo (S/RES/1244 (1999)),Belgrade,0,5,0,4,17,2,0,28,4,11,0,6,36,2,0,59
2007,Slovakia,Zvolen,1,0,0,0,1,0,0,2,0,0,0,0,1,0,0,1
2007,Slovakia,Lucenec,1,0,0,0,0,0,0,1,0,0,0,0,0,0,0,0
2007,Slovakia,Kosice,1,0,0,0,0,0,0,1,0,0,0,0,2,0,0,2
2007,Slovakia,Gabcikovo,0,0,0,0,1,0,0,1,0,0,0,0,3,0,0,3
2007,Slovakia,Bratislava,0,0,0,0,1,0,0,1,0,0,0,0,1,0,0,1
2007,Slovenia,Ljubljana,0,1,0,1,72,0,0,74,0,0,0,28,312,0,0,340
2007,Swaziland,Malindza,8,7,0,8,14,0,0,37,8,10,0,11,25,0,0,54
2007,Syrian Arab Rep.,Al-Tanf,39,70,0,39,163,13,0,324,30,54,0,42,188,18,0,332
2007,Syrian Arab Rep.,Al-Hol,29,23,0,14,71,3,0,140,27,30,0,19,91,2,0,169
2007,Chad,Yaroungou,1261,1859,0,899,2940,223,0,7182,1209,1867,0,867,2071,156,0,6170
2007,Chad,Treguine,1618,1890,0,1117,3601,308,0,8534,1680,1926,0,1169,2122,287,0,7184
2007,Chad,Touloum,1840,4103,0,2052,4890,589,0,13474,1853,3588,0,1718,2196,302,0,9657
2007,Chad,Oure-Cassoni,2377,5192,0,2192,6506,615,0,16882,2463,4469,0,1619,2319,283,0,11153
2007,Chad,Mile,1424,2643,0,1144,3614,375,0,9200,1501,2336,0,1030,1848,287,0,7002
2007,Chad,Kounongou,1144,2259,0,965,3063,230,0,7661,1127,2166,0,928,1406,212,0,5839
2007,Chad,Iridimi,1555,3185,0,1453,3717,529,0,10439,1613,2964,0,1345,1615,293,0,7830
2007,Chad,Goz Amer,2010,2541,0,1322,4603,450,0,10926,2097,2598,0,1321,2761,394,0,9171
2007,Chad,Gondje,1264,2016,0,849,2524,85,0,6738,1214,2042,0,822,1780,68,0,5926
2007,Chad,Gaga,1966,2409,0,1003,4038,291,0,9707,1814,2450,0,1157,2348,232,0,8001
2007,Chad,Farchana,1869,2669,0,1476,4776,347,0,11137,1864,2606,0,1456,2480,272,0,8678
2007,Chad,Dosseye,677,995,0,436,1235,69,0,3412,684,911,0,361,719,71,0,2746
2007,Chad,Djabal,1489,2067,0,1157,3616,274,0,8603,1534,2130,0,1065,2033,237,0,6999
2007,Chad,Bredjing,2762,3735,0,2254,6973,655,0,16379,2837,3763,0,2303,4289,506,0,13698
2007,Chad,Amnabak,1950,2499,0,1494,3878,413,0,10234,2000,2177,0,719,1329,242,0,6467
2007,Chad,Amboko,1082,2095,0,912,2234,107,0,6430,1007,1967,0,1003,1476,119,0,5572
2007,Togo,Zone maritime,146,183,0,114,544,23,0,1010,146,179,0,103,623,5,0,1056
2007,Togo,Zone de danyi,38,42,0,14,65,4,0,163,34,29,0,14,52,3,0,132
2007,Togo,Zone de badou,113,108,0,37,260,31,0,549,129,122,0,53,172,11,0,487
2007,Togo,Lome,79,91,0,113,377,4,0,664,81,74,0,107,530,4,0,796
2007,Thailand,Umpium,1202,1673,0,1420,4871,335,0,9501,1278,1691,0,1577,5069,281,0,9896
2007,Thailand,Tham Hin,444,572,0,524,1368,136,0,3044,487,555,0,510,1278,133,0,2963
2007,Thailand,Tak,157,311,0,272,1260,49,0,2049,160,363,0,314,1660,49,0,2546
2007,Thailand,Nu Po,891,1127,0,986,3252,237,0,6493,970,1121,0,1070,3522,201,0,6884
2007,Thailand,Mai Nai Soi,1383,1742,0,1340,4396,432,0,9293,1595,1693,0,1315,4767,440,0,9810
2007,Thailand,Mae Ra Ma Luang,802,1088,0,931,2608,243,0,5672,797,1150,0,974,2698,287,0,5906
2007,Thailand,Mae La Oon,930,1211,0,1017,3070,257,0,6485,1035,1324,0,1115,3212,279,0,6965
2007,Thailand,Mae La,2632,3497,0,2909,9053,877,0,18968,2715,3714,0,3030,8968,735,0,19162
2007,Thailand,Bangkok,152,221,0,211,1697,32,0,2313,177,262,0,224,3393,55,0,4111
2007,Thailand,Ban Mae Surin,228,283,0,269,830,52,0,1662,215,339,0,244,875,73,0,1746
2007,Thailand,Ban Don Yang,279,324,0,307,872,72,0,1854,305,333,0,320,778,68,0,1804
2007,Tajikistan,Dushanbe,0,0,0,1,1,0,0,2,0,0,0,1,3,1,0,5
2007,Turkmenistan,Turkmenbashi,0,0,0,0,6,1,0,7,0,0,0,1,1,0,0,2
2007,Turkmenistan,Turkmenabad,0,5,0,7,11,0,0,23,2,4,0,6,7,0,0,19
2007,Turkmenistan,Tedjen,0,0,0,0,1,0,0,1,0,0,0,1,0,0,0,1
2007,Turkmenistan,Ashgabat,6,7,0,2,23,5,0,43,6,6,0,4,28,1,0,45
2007,Timor-Leste,Dili,0,0,0,0,0,0,0,0,0,0,0,0,5,0,0,5
2007,Trinidad and Tobago,Port of Spain,1,0,0,1,6,0,0,8,0,4,0,1,111,1,0,117
2007,Tunisia,Tunis,2,1,0,1,31,6,0,41,1,4,0,1,92,4,0,102
2007,Tunisia,Sousse,0,0,0,0,1,0,0,1,0,0,0,0,1,0,0,1
2007,Tunisia,Sfax,1,0,0,0,1,0,0,2,1,0,0,1,1,0,0,3
2007,Tunisia,Monastir,0,0,0,0,2,0,0,2,0,0,0,0,2,0,0,2
2007,Tunisia,Bizerte,0,0,0,0,1,0,0,1,0,0,0,0,0,0,0,0
2007,Turkey,Yozgat Camp,2,1,0,2,13,0,0,18,2,1,0,6,7,0,0,16
2007,Turkey,Yozgat,3,4,0,5,15,0,0,27,0,3,0,1,18,0,0,22
2007,Turkey,Yalova,0,0,0,4,2,0,0,6,0,0,0,2,5,0,0,7
2007,Turkey,Van,42,63,0,52,292,3,3,455,42,71,0,91,655,5,0,864
2007,Turkey,Urfa,1,0,0,0,2,0,0,3,0,0,0,0,2,0,0,2
2007,Turkey,Tokat,4,7,0,6,17,1,0,35,7,12,0,3,33,2,0,57
2007,Turkey,Sivas,3,10,0,7,24,3,0,47,3,9,0,5,31,1,0,49
2007,Turkey,Sirnak,3,2,0,0,11,0,0,16,3,0,0,2,35,1,0,41
2007,Turkey,Samsun,0,0,0,0,2,0,0,2,0,0,0,0,1,0,0,1
2007,Turkey,Nigde,10,19,0,7,70,0,4,110,7,15,0,12,58,2,0,94
2007,Turkey,Nevsehir,10,17,0,16,108,3,2,156,10,23,0,13,141,3,0,190
2007,Turkey,Mugla,0,0,0,0,0,0,0,0,0,0,0,0,1,0,0,1
2007,Turkey,Mersin,6,7,0,8,46,0,0,67,5,6,0,8,47,2,0,68
2007,Turkey,Mardin,0,4,0,0,3,0,0,7,2,2,0,1,3,0,0,8
2007,Turkey,Kutahya,10,16,0,7,66,0,0,99,5,20,0,12,77,0,0,114
2007,Turkey,Konya,37,47,0,46,201,3,0,334,34,58,0,39,256,2,0,389
2007,Turkey,Kocaeli,0,0,0,0,0,0,0,0,0,0,0,0,1,0,0,1
2007,Turkey,Kirsehir,14,22,0,15,73,1,0,125,12,23,0,23,151,3,0,212
2007,Turkey,Kirklareli,0,0,0,0,3,1,0,4,0,0,0,0,4,0,0,4
2007,Turkey,Kirikkale,1,3,0,0,8,0,0,12,1,1,0,0,8,0,0,10
2007,Turkey,Kilis,2,8,0,1,13,0,0,24,0,1,0,0,4,0,0,5
2007,Turkey,Kayseri,14,40,0,58,308,6,14,440,16,49,0,55,317,20,0,457
2007,Turkey,Kastamonu,8,9,0,6,52,1,3,79,5,11,0,14,70,1,0,101
2007,Turkey,Karaman,5,10,0,9,69,0,0,93,1,16,0,5,120,0,0,142
2007,Turkey,K.Maras,0,0,0,0,0,0,0,0,0,0,0,0,1,0,0,1
2007,Turkey,Izmit,0,0,0,0,9,2,0,11,0,0,0,1,9,0,0,10
2007,Turkey,Izmir,1,7,0,4,52,0,0,64,6,3,0,8,104,0,0,121
2007,Turkey,Istanbul,120,158,0,122,711,38,8,1157,143,196,0,152,1079,45,0,1615
2007,Turkey,Isparta,6,12,0,15,79,0,0,112,8,14,0,18,145,1,0,186
2007,Turkey,Hatay,14,9,0,12,88,1,1,125,10,9,0,8,126,1,0,154
2007,Turkey,Hakkari,1,1,0,0,5,0,0,7,3,0,0,0,18,0,0,21
2007,Turkey,Gaziantep,32,40,0,27,132,4,0,235,33,40,0,39,253,2,0,367
2007,Turkey,Eskisehir,8,28,0,14,109,3,1,163,18,25,0,26,135,7,0,211
2007,Turkey,Edirne,0,0,0,0,1,0,0,1,0,0,0,0,14,0,0,14
2007,Turkey,Corum,4,10,0,7,35,1,0,57,11,10,0,9,78,1,0,109
2007,Turkey,Cankiri,15,14,0,15,72,2,0,118,12,19,0,17,135,3,0,186
2007,Turkey,Bursa,0,1,0,0,2,0,0,3,0,0,0,2,5,0,0,7
2007,Turkey,Burdur,15,23,0,18,118,3,0,177,15,22,0,16,163,1,0,217
2007,Turkey,Bilecik,4,11,0,11,43,3,0,72,4,10,0,11,41,2,0,68
2007,Turkey,Antalya,0,0,0,0,5,1,0,6,0,0,0,1,5,1,0,7
2007,Turkey,Ankara,10,31,0,29,174,4,0,248,23,29,0,69,283,9,0,413
2007,Turkey,Amasya,12,19,0,16,76,2,0,125,14,21,0,19,120,2,0,176
2007,Turkey,Aksaray,10,17,0,18,83,2,1,131,13,25,0,19,121,4,0,182
2007,Turkey,Agri,0,0,0,2,3,0,0,5,0,0,0,3,12,0,0,15
2007,Turkey,Afyon,9,13,0,14,93,2,2,133,5,11,0,12,153,2,0,183
2007,Turkey,Adapazari,1,1,0,0,4,0,0,6,0,3,0,0,5,0,0,8
2007,Turkey,Adana,0,2,0,0,8,1,0,11,1,1,0,2,11,2,0,17
2007,United Rep. of Tanzania,Nduta,47,55,0,91,279,13,0,485,57,170,0,228,219,10,0,684
2007,United Rep. of Tanzania,Chogo,225,250,0,310,440,41,0,1266,94,103,0,230,355,45,0,827
2007,United Rep. of Tanzania,Nyarugusu,3686,5117,0,5835,11509,541,0,26688,3569,4645,0,6215,9299,425,0,24153
2007,United Rep. of Tanzania,Mtabila,7643,6953,0,10528,19021,645,0,44790,7962,8210,0,9471,19514,733,0,45890
2007,United Rep. of Tanzania,Lukole ,2824,2500,0,2044,5154,188,0,12710,2933,2505,0,2142,4936,264,0,12780
2007,United Rep. of Tanzania,Lugufu,4293,3852,0,5001,9741,426,0,23313,4216,4505,0,4557,8417,300,0,21995
2007,United Rep. of Tanzania,Kigoma,0,0,0,4,13,0,0,17,2,3,0,5,13,0,0,23
2007,United Rep. of Tanzania,Kibondo,4,8,0,6,52,0,0,70,5,10,0,15,54,0,0,84
2007,United Rep. of Tanzania,Kasulu,5,7,0,5,19,0,0,36,3,2,0,3,12,0,0,20
2007,United Rep. of Tanzania,Kanembwa,135,102,0,223,300,4,0,764,145,100,0,161,695,8,0,1109
2007,Uganda,Rhino Camp,773,1550,0,1252,3139,114,0,6828,761,1484,0,1547,3628,80,0,7500
2007,Uganda,Palorinya,2109,3367,0,2222,6627,447,0,14772,2140,3481,0,2422,5544,235,0,13822
2007,Uganda,Oruchinga,307,310,0,130,543,23,0,1313,260,301,0,161,551,37,0,1310
2007,Uganda,Nakivale,3889,3610,0,1737,6745,206,0,16187,3854,3587,0,1883,7444,221,0,16989
2007,Uganda,Madi-Okollo,705,739,0,596,1343,104,0,3487,687,708,0,747,1257,62,0,3461
2007,Uganda,Kyangwali,1559,2349,0,1588,4136,365,0,9997,1602,2401,0,1660,4210,239,0,10112
2007,Uganda,Kyaka II,1889,2058,0,1230,3696,229,0,9102,1828,2019,0,1452,3599,229,0,9127
2007,Uganda,Kiryandongo,848,1320,0,830,2536,391,0,5925,892,1338,0,947,2437,227,0,5841
2007,Uganda,Kampala,270,458,0,431,1154,30,0,2343,280,455,0,399,1498,11,0,2643
2007,Uganda,Impevi,962,2407,0,1943,4178,156,0,9646,1137,2763,0,2895,5543,77,0,12415
2007,Uganda,Ikafe,790,909,0,737,1643,93,0,4172,827,824,0,870,1598,58,0,4177
2007,Uganda,Adjumani,3751,5600,0,4069,12487,1049,0,26956,3770,5630,0,4299,11518,611,0,25828
2007,Uruguay,Montevideo,0,2,0,6,34,7,0,49,3,5,0,5,104,8,0,125
2007,Uruguay,Las Piedras,0,0,0,0,2,0,0,2,0,0,0,0,1,0,0,1
2007,Venezuela (Bolivarian Republic of),Zulia,179,202,0,179,526,34,0,1120,207,220,0,195,724,50,0,1396
2007,Venezuela (Bolivarian Republic of),Tachira,207,260,0,234,758,36,0,1495,230,300,0,263,886,42,0,1721
2007,Venezuela (Bolivarian Republic of),Caracas,22,40,0,39,194,15,0,310,34,53,0,40,397,26,0,550
2007,Venezuela (Bolivarian Republic of),Apure,175,290,0,268,685,49,0,1467,215,290,0,266,708,64,0,1543
2007,Viet Nam,Thu Duc,0,0,0,0,0,0,39,39,0,0,0,0,0,0,39,39
2007,Viet Nam,Kon Tum,0,0,0,0,0,0,0,0,0,0,0,0,0,0,1,1
2007,Viet Nam,Ho Chi Minh City,0,0,0,0,0,0,3600,3600,0,0,0,0,0,0,3600,3600
2007,Viet Nam,Gia Lai,0,0,0,0,0,0,6,6,0,0,0,0,0,0,45,45
2007,Viet Nam,Dak Nong,0,0,0,0,0,0,0,0,0,0,0,0,0,0,10,10
2007,Viet Nam,Dak Lak,0,0,0,0,0,0,0,0,0,0,0,0,0,0,1,1
2007,Viet Nam,Cu Chi,0,0,0,0,0,0,129,129,0,0,0,0,0,0,104,104
2007,Viet Nam,Binh Phuoc,0,0,0,0,0,0,130,130,0,0,0,0,0,0,131,131
2007,Viet Nam,Binh Duong,0,0,0,0,0,0,930,930,0,0,0,0,0,0,855,855
2007,Vanuatu,Port Vila,0,0,0,0,1,0,0,1,0,0,0,0,0,0,0,0
2007,Yemen,Taiz,59,179,0,179,690,185,0,1292,56,340,0,340,650,180,0,1566
2007,Yemen,Shabwa,15,28,0,29,151,6,0,229,12,22,0,22,171,2,0,229
2007,Yemen,Sana'a/Aden,25,11,0,11,69,0,0,116,24,14,0,15,106,0,0,159
2007,Yemen,Sana'a,588,1993,0,1931,6425,726,0,11663,551,2006,0,1933,6388,638,0,11516
2007,Yemen,Sada'a,2,8,0,8,25,4,0,47,3,15,0,15,55,5,0,93
2007,Yemen,Sa'dah,8637,9971,0,4769,19539,434,0,43350,8002,8076,0,4375,12860,337,0,33650
2007,Yemen,Rida'a,29,18,0,17,56,5,0,125,25,33,0,32,62,5,0,157
2007,Yemen,Mukalla,79,371,0,318,556,33,0,1357,53,264,0,424,514,34,0,1289
2007,Yemen,Mahra,32,62,0,61,157,7,0,319,32,70,0,70,182,7,0,361
2007,Yemen,Hodeidah,20,40,0,41,109,24,0,234,19,55,0,55,104,19,0,252
2007,Yemen,Dhamar,18,19,0,18,78,2,0,135,17,16,0,16,47,4,0,100
2007,Yemen,AL-Kharaz,969,1105,0,528,2164,48,0,4814,1017,1150,0,583,1874,53,0,4677
2007,Yemen,Al-Baida,8,34,0,33,86,7,0,168,14,23,0,23,92,2,0,154
2007,Yemen,Aden,262,1600,0,1312,3328,387,0,6889,318,1406,0,1526,3669,326,0,7245
2007,Zambia,Mwange,1403,1177,0,2181,3967,229,0,8957,1482,1331,0,1807,4113,221,0,8954
2007,Zambia,Meheba,1350,1068,0,1428,2961,435,0,7242,1058,895,0,1351,2864,482,0,6650
2007,Zambia,Mayukwayukwa,1457,664,0,1102,2259,364,0,5846,1068,469,0,957,2096,224,0,4814
2007,Zambia,Kala,1427,1280,0,2346,3235,134,0,8422,1460,1187,0,2272,3398,138,0,8455
2007,Zimbabwe,Tongogara,246,296,0,150,521,9,0,1222,251,320,0,165,925,9,0,1670
2008,Afghanistan,Zabul,52,76,0,40,115,10,34,327,67,100,0,48,92,11,32,350
2008,Afghanistan,Wardak,129,174,0,149,345,13,0,810,101,170,0,142,391,31,0,835
2008,Afghanistan,Various,92594,151415,0,129430,553176,71540,2379549,3377704,95969,161318,0,141472,636026,62321,2486032,3583138
2008,Afghanistan,Uruzgan,6,14,0,7,19,1,0,47,6,13,0,6,16,2,0,43
2008,Afghanistan,Takhar,415,549,0,242,696,23,260,2185,413,516,0,310,850,60,270,2419
2008,Afghanistan,Sari Pul,90,130,0,61,193,12,0,486,89,142,0,53,210,19,0,513
2008,Afghanistan,Sare Pul ,0,0,0,0,0,0,86,86,0,0,0,0,0,0,89,89
2008,Afghanistan,Samangan,123,196,0,78,238,11,179,825,127,196,0,96,256,22,187,884
2008,Afghanistan,Parwan,116,182,0,145,353,17,0,813,134,173,0,163,426,27,0,923
2008,Afghanistan,Panjsher,5,8,0,8,19,0,0,40,2,8,0,6,19,1,0,36
2008,Afghanistan,Paktya,664,1095,0,647,1738,79,372,4595,714,1179,0,740,1438,185,387,4643
2008,Afghanistan,Paktika,4,14,0,11,22,1,747,799,9,24,0,10,26,0,777,846
2008,Afghanistan,Nuristan,11,11,0,5,23,1,0,51,6,12,0,9,20,1,0,48
2008,Afghanistan,Nimroz,3,9,0,7,10,3,0,32,3,7,0,2,18,3,0,33
2008,Afghanistan,Nangarhar,9843,15612,0,8520,21077,818,19375,75245,9903,16634,0,9482,21445,1916,20165,79545
2008,Afghanistan,Logar,751,1283,0,783,1905,91,3,4816,789,1345,0,820,1699,190,2,4845
2008,Afghanistan,Laghman,1925,3107,0,1798,4091,184,2428,13533,2022,3114,0,1889,4218,368,2528,14139
2008,Afghanistan,Kunduz,1729,2444,0,1216,3267,142,504,9302,1862,2602,0,1461,3325,259,522,10031
2008,Afghanistan,Kunar,2900,4347,0,2398,5762,234,5580,21221,3001,4636,0,2640,5749,520,5808,22354
2008,Afghanistan,Khost,132,201,0,101,340,22,6047,6843,139,228,0,158,300,53,6294,7172
2008,Afghanistan,Kapisa,55,88,0,42,105,4,0,294,52,74,0,51,121,8,0,306
2008,Afghanistan,Kandahar,550,764,0,370,982,53,46202,48921,585,912,0,502,1051,101,48032,51183
2008,Afghanistan,Kabul,2487,4060,0,2627,6944,346,2532,18996,2576,4296,0,2774,6828,636,2634,19744
2008,Afghanistan,Jawzjan,241,331,0,213,601,42,429,1857,239,326,0,179,780,69,412,2005
2008,Afghanistan,Hirat,51,61,0,45,201,13,15441,15812,55,67,0,48,602,24,16059,16855
2008,Afghanistan,Hilmand,142,222,0,97,280,13,11518,12272,161,258,0,124,281,35,11988,12847
2008,Afghanistan,Ghor,4,5,0,3,7,1,73,93,2,8,0,5,21,1,71,108
2008,Afghanistan,Ghazni,76,112,0,61,175,14,1022,1460,68,106,0,63,175,25,1063,1500
2008,Afghanistan,Faryab,186,252,0,132,448,31,423,1472,205,258,0,189,525,61,424,1662
2008,Afghanistan,Farah,8,8,0,5,16,1,632,670,11,9,0,6,15,1,633,675
2008,Afghanistan,Daykundi,5,5,0,1,15,0,0,26,10,4,0,3,21,1,0,39
2008,Afghanistan,Bamyan,19,24,0,12,57,2,0,114,16,36,0,35,73,6,0,166
2008,Afghanistan,Balkh,345,488,0,241,719,37,316,2146,335,509,0,291,787,81,312,2315
2008,Afghanistan,Baghlan,401,594,0,350,897,38,179,2459,406,634,0,424,979,101,172,2716
2008,Afghanistan,Badghis,19,17,0,14,32,2,1939,2023,14,19,0,16,44,2,1944,2039
2008,Afghanistan,Badakhshan,7,16,0,8,36,2,0,69,10,15,0,59,291,6,0,381
2008,Angola,Zaire,0,0,0,0,0,0,1562,1562,0,0,0,0,0,0,1637,1637
2008,Angola,Ugie,726,912,0,786,1103,0,0,3527,523,909,0,771,1004,0,0,3207
2008,Angola,Moxico,0,0,0,0,0,0,980,980,0,0,0,0,0,0,1173,1173
2008,Angola,Luanda ,1005,1020,0,3260,2889,87,0,8261,670,683,0,2173,4050,58,0,7634
2008,Angola,Cabinda,62,51,0,39,195,0,0,347,58,31,0,34,214,0,0,337
2008,Albania,Tirana,3,2,0,5,16,2,0,28,3,5,0,8,31,1,0,48
2008,Albania,Peshkopi,0,0,0,0,1,0,0,1,0,0,0,0,0,0,0,0
2008,Albania,Mamurras,1,0,0,0,1,2,0,4,2,0,0,0,1,1,0,4
2008,Albania,Fushe-Kruje,1,0,0,0,0,0,0,1,0,0,0,0,1,0,0,1
2008,Armenia,Yerevan,23,38,0,58,596,239,0,954,33,40,0,56,661,117,0,907
2008,Armenia,Yeghvard,0,0,0,0,13,2,0,15,0,0,0,0,12,2,0,14
2008,Armenia,Vedi,0,0,0,0,19,7,0,26,0,0,0,0,8,5,0,13
2008,Armenia,Vayots Dzor marz,0,0,0,0,4,0,0,4,0,0,0,0,4,0,0,4
2008,Armenia,Vayk,0,0,0,0,1,0,0,1,0,0,0,0,0,0,0,0
2008,Armenia,Vardenis,0,0,0,0,2,0,0,2,0,0,0,0,1,0,0,1
2008,Armenia,Vanadzor,0,0,0,0,1,1,0,2,0,0,0,0,2,0,0,2
2008,Armenia,Vagharshapat,0,0,0,0,27,11,0,38,0,0,0,0,30,5,0,35
2008,Armenia,Tsakhkadzor,0,0,0,0,0,1,0,1,0,0,0,0,0,0,0,0
2008,Armenia,Tavush marz,0,0,0,0,52,23,0,75,0,0,0,0,42,15,0,57
2008,Armenia,Tashir,0,0,0,0,0,1,0,1,0,0,0,0,1,1,0,2
2008,Armenia,Talin,0,0,0,0,13,5,0,18,0,0,0,0,10,3,0,13
2008,Armenia,Syunik marz,0,0,0,0,30,11,0,41,0,0,0,0,37,2,0,39
2008,Armenia,Stepanavan,0,0,0,0,7,2,0,9,0,0,0,0,13,0,0,13
2008,Armenia,Spitak,0,0,0,0,8,2,0,10,0,0,0,0,1,3,0,4
2008,Armenia,Sisian,0,0,0,0,1,1,0,2,0,0,0,0,0,0,0,0
2008,Armenia,Shirak marz,0,0,0,0,7,2,0,9,0,0,0,0,7,3,0,10
2008,Armenia,Sevan,0,0,0,0,5,2,0,7,0,0,0,0,2,2,0,4
2008,Armenia,Noyemberyan,0,0,0,0,1,1,0,2,0,0,0,0,1,1,0,2
2008,Armenia,Nor Hach,0,0,0,0,21,13,0,34,0,0,0,0,15,6,0,21
2008,Armenia,Metsamor,0,0,0,0,10,10,0,20,0,0,0,1,12,3,0,16
2008,Armenia,Meghri,0,0,0,0,5,0,0,5,0,0,0,0,3,0,0,3
2008,Armenia,Masis,0,0,0,0,11,2,0,13,0,0,0,0,9,1,0,10
2008,Armenia,Martuni,0,0,0,0,2,0,0,2,0,0,0,0,0,0,0,0
2008,Armenia,Lori marz,0,0,0,0,34,12,0,46,0,0,0,0,45,7,0,52
2008,Armenia,Kotayk marz,0,0,0,0,101,64,0,165,0,0,0,1,126,31,0,158
2008,Armenia,Kapan,0,0,0,0,25,9,0,34,0,0,0,1,26,5,0,32
2008,Armenia,Kajaran,0,0,0,0,8,4,0,12,0,0,0,0,3,1,0,4
2008,Armenia,Ijevan,0,0,0,0,2,0,0,2,0,0,0,0,2,1,0,3
2008,Armenia,Hrazdan,0,0,0,0,10,1,0,11,0,0,0,0,10,4,0,14
2008,Armenia,Gyumri,0,0,0,0,12,3,0,15,0,0,0,0,19,2,0,21
2008,Armenia,Goris,0,0,0,0,14,4,0,18,0,0,0,0,17,3,0,20
2008,Armenia,Gegharkunik marz,0,0,0,0,42,11,0,53,0,0,0,0,76,11,0,87
2008,Armenia,Gavar,0,0,0,0,1,1,0,2,0,0,0,0,1,0,0,1
2008,Armenia,Dilijan,0,0,0,0,4,7,0,11,0,0,0,0,4,1,0,5
2008,Armenia,Charentsavan,0,0,0,0,4,1,0,5,0,0,0,0,4,0,0,4
2008,Armenia,Chambarak,0,0,0,0,0,0,0,0,0,0,0,1,0,0,0,1
2008,Armenia,Byureghavan,0,0,0,1,20,13,0,34,0,0,0,0,24,6,0,30
2008,Armenia,Berd,0,0,0,0,1,1,0,2,0,0,0,0,2,0,0,2
2008,Armenia,Ashtarak,0,0,0,0,10,1,0,11,0,0,0,0,12,1,0,13
2008,Armenia,Artik,0,0,0,0,2,0,0,2,0,0,0,0,0,0,0,0
2008,Armenia,Artashat,0,0,0,0,20,8,0,28,0,0,0,0,15,4,0,19
2008,Armenia,Armavir marz,0,0,0,0,28,20,0,48,0,0,0,0,20,8,0,28
2008,Armenia,Armavir city,0,0,0,0,2,0,0,2,0,0,0,0,2,1,0,3
2008,Armenia,Ararat marz,0,0,0,1,185,47,0,233,0,0,0,1,190,36,0,227
2008,Armenia,Ararat city,0,0,0,0,10,3,0,13,0,0,0,0,4,0,0,4
2008,Armenia,Aragatsotn marz,0,0,0,0,22,16,0,38,0,0,0,0,20,6,0,26
2008,Armenia,Aparan,0,0,0,0,2,2,0,4,0,0,0,0,1,0,0,1
2008,Armenia,Akhtala,0,0,0,0,1,0,0,1,0,0,0,0,0,0,0,0
2008,Armenia,Agarak,0,0,0,0,3,0,0,3,0,0,0,0,2,0,0,2
2008,Armenia,Abovyan,0,0,0,0,44,30,0,74,0,0,0,0,31,8,0,39
2008,Burundi,Musasa,639,753,0,453,1211,48,0,3104,565,805,0,466,1026,18,0,2880
2008,Burundi,Kinama,799,1145,0,652,1745,90,0,4431,814,1139,0,706,1303,54,0,4016
2008,Burundi,Gihinga,183,230,0,198,551,34,0,1196,171,253,0,204,536,33,0,1197
2008,Burundi,Giharo,35,11,0,17,53,3,0,119,26,18,0,18,47,3,0,112
2008,Burundi,Bujumbura,497,983,0,926,2277,101,0,4784,506,1051,0,953,1929,84,0,4523
2008,Benin,Kpomasse,16,20,0,21,116,2,0,175,18,36,0,24,120,3,0,201
2008,Benin,Cotonou,207,225,0,213,885,20,0,1550,206,267,0,182,1564,24,0,2243
2008,Benin,Agame,276,222,0,177,634,25,0,1334,251,256,0,186,940,9,0,1642
2008,Burkina Faso,Ouagadougou,37,71,0,60,257,2,0,427,26,55,0,53,595,5,0,734
2008,Bangladesh,Nayapara,1604,2183,0,1283,3673,158,0,8901,1602,2189,0,1185,3031,168,0,8175
2008,Bangladesh,Kutupalong,1068,1382,0,768,2342,114,0,5674,1090,1365,0,825,1993,100,0,5373
2008,Bangladesh,Dhaka,11,11,0,8,66,2,0,98,9,9,0,7,141,5,0,171
2008,Bulgaria,Sofia,4,12,0,12,129,1,0,158,22,32,0,40,493,1,0,588
2008,Bahrain,Manama,4,6,0,1,26,1,0,38,5,9,0,1,41,3,0,59
2008,Bosnia and Herzegovina,Brcko District,1,1,0,1,12,2,0,17,0,1,0,2,11,2,0,16
2008,Bosnia and Herzegovina,Various (Rep. Srpska),13,187,0,256,2496,584,1758,5294,10,165,0,272,2519,535,1524,5025
2008,Bosnia and Herzegovina,Various (Federation of BiH),36,74,0,44,144,16,4287,4601,38,75,0,46,184,10,4112,4465
2008,Belarus,Vitebsk Region,1,0,0,0,13,2,0,16,3,5,0,2,27,1,0,38
2008,Belarus,Mogilev Region,0,2,0,3,12,0,0,17,0,0,0,3,20,1,0,24
2008,Belarus,Minsk Region,2,4,0,7,27,2,0,42,0,6,0,5,37,2,0,50
2008,Belarus,Minsk CIty,6,32,0,31,77,10,0,156,11,25,0,25,176,4,0,241
2008,Belarus,Grodno Region,1,1,0,0,5,0,0,7,0,0,0,0,10,0,0,10
2008,Belarus,Gomel Region,0,5,0,5,23,8,0,41,6,2,0,5,38,2,0,53
2008,Belarus,Brest Region,0,0,0,0,2,0,0,2,0,1,0,1,6,1,0,9
2008,Belize,Dangriga,0,0,0,0,1,0,0,1,1,0,0,0,1,0,0,2
2008,Belize,Belize City,0,0,0,0,1,0,0,1,1,0,0,0,2,0,0,3
2008,Bolivia (Plurinational State of),Yapacani,1,2,0,2,3,0,0,8,1,1,0,2,3,0,0,7
2008,Bolivia (Plurinational State of),Tarija,0,0,0,0,1,0,0,1,0,0,0,0,1,0,0,1
2008,Bolivia (Plurinational State of),Sucre,0,0,0,0,0,0,0,0,0,0,0,0,1,0,0,1
2008,Bolivia (Plurinational State of),Santa Cruz,0,1,0,0,9,0,0,10,0,1,0,3,83,0,0,87
2008,Bolivia (Plurinational State of),Palos Blanco,1,0,0,0,2,0,0,3,0,1,0,0,2,0,0,3
2008,Bolivia (Plurinational State of),La Paz,2,11,0,20,105,4,0,142,7,17,0,26,162,7,0,219
2008,Bolivia (Plurinational State of),Cochabamba,1,2,0,3,8,0,0,14,0,3,0,2,22,0,0,27
2008,Bolivia (Plurinational State of),Beni,0,0,0,3,0,0,0,3,0,2,0,0,1,0,0,3
2008,Botswana,Dukwi,167,256,0,160,493,29,0,1105,169,238,0,149,1198,35,0,1789
2008,Central African Rep.,Vakaga,1400,2200,0,1200,4600,200,0,9600,2400,2800,0,1000,4000,200,0,10400
2008,Central African Rep.,Sam Ouandja,443,363,0,174,617,50,0,1647,444,379,0,183,500,91,0,1597
2008,Central African Rep.,Ouham Pende,3500,5500,0,3000,11500,500,0,24000,6000,7000,0,2500,10000,500,0,26000
2008,Central African Rep.,Ouham ,1680,2640,0,1440,5520,240,0,11520,2880,3360,0,1200,4800,240,0,12480
2008,Central African Rep.,Nomadic herders,1750,2750,0,1500,5750,250,0,12000,3000,3500,0,1250,5000,250,0,13000
2008,Central African Rep.,Nana -Mambere,1750,2750,0,1500,5750,250,0,12000,3000,3500,0,1250,5000,250,0,13000
2008,Central African Rep.,Nana -Gribizi,1960,3080,0,1680,6440,280,0,13440,3360,3920,0,1400,5600,280,0,14560
2008,Central African Rep.,Molangue,12,14,0,10,21,0,0,57,10,9,0,7,27,2,0,55
2008,Central African Rep.,Mboki,18,27,0,25,45,0,0,115,15,24,0,0,46,0,0,85
2008,Central African Rep.,Haute Kotto,1190,1870,0,1020,3910,170,0,8160,2040,2380,0,850,3400,170,0,8840
2008,Central African Rep.,Bangui,272,352,0,335,1037,7,0,2003,318,387,0,329,2289,10,0,3333
2008,Central African Rep.,Bamingui-Bangoran,560,880,0,480,1840,80,0,3840,960,1120,0,400,1600,80,0,4160
2008,China,Yiwu,0,0,0,0,1,0,0,1,0,0,0,0,0,0,0,0
2008,China,Yanjiao,2,3,0,0,8,0,0,13,3,2,0,3,14,0,0,22
2008,China,Xiamen,0,0,0,0,0,0,0,0,0,0,0,0,1,0,0,1
2008,China,Wuhan,2,0,0,1,1,0,0,4,0,1,0,0,1,0,0,2
2008,China,Wenchang,0,0,0,0,0,0,0,0,0,0,0,0,1,1,0,2
2008,China,Shanghai,0,0,0,0,0,0,0,0,0,0,0,0,3,0,0,3
2008,China,Qingdao,0,0,0,0,0,0,0,0,0,0,0,0,1,0,0,1
2008,China,Nanjing,0,0,0,0,0,0,0,0,0,0,0,0,1,0,0,1
2008,China,Langfang,0,0,0,0,0,0,0,0,0,0,0,0,1,0,0,1
2008,China,Guangzhou,2,0,0,3,1,0,0,6,0,1,0,0,7,0,0,8
2008,China,Beijing,4,0,0,1,2,0,0,7,0,2,0,1,15,0,0,18
2008,China,Bazhou,0,0,0,0,1,1,0,2,0,2,0,0,1,1,0,4
2008,Côte d'Ivoire,Tabou,1174,1527,0,812,4041,149,0,7703,1172,1537,0,689,3108,150,0,6656
2008,Côte d'Ivoire,San Pedro,0,0,0,0,0,0,0,0,0,0,0,0,1,0,0,1
2008,Côte d'Ivoire,Man,0,0,0,0,0,0,0,0,0,0,0,0,1,0,0,1
2008,Côte d'Ivoire,Guiglo,500,800,0,448,2028,139,0,3915,493,860,0,413,1400,107,0,3273
2008,Côte d'Ivoire,Gagnoa,0,0,0,0,0,0,0,0,0,0,0,0,1,0,0,1
2008,Côte d'Ivoire,Danane,0,0,0,0,0,0,0,0,0,0,0,0,1,0,0,1
2008,Côte d'Ivoire,Daloa,0,0,0,0,0,0,0,0,0,0,0,0,1,0,0,1
2008,Côte d'Ivoire,Bouake,0,0,0,0,0,0,0,0,0,0,0,0,1,0,0,1
2008,Côte d'Ivoire,Abidjan,183,266,0,185,1052,33,0,1719,200,327,0,172,1131,36,0,1866
2008,Côte d'Ivoire,Zou/Dieouzon/Duekoue,0,0,0,0,0,0,12706,12706,0,0,0,0,0,0,12386,12386
2008,Cameroon,Yaoundé,3,3,0,5,34,1,0,46,3,3,0,6,162,5,0,179
2008,Cameroon,Langui,396,479,0,193,965,95,0,2128,418,446,0,174,1209,52,0,2299
2008,Cameroon,Kribi,0,1,0,1,1,0,0,3,0,1,0,1,1,0,0,3
2008,Cameroon,"Garoua,Yaoundé",95,137,0,282,1259,21,0,1794,86,142,0,313,2053,45,0,2639
2008,Cameroon,"Douala,Yaoundé",536,620,0,457,2016,25,0,3654,492,625,0,397,3175,44,0,4733
2008,Cameroon,Adamaoua/Nordouest province,178,326,0,298,691,36,0,1529,207,368,0,242,464,61,0,1342
2008,Cameroon,Adamaoua/Est province,6011,8908,0,4097,13461,592,0,33069,6272,9124,0,3577,9820,1057,0,29850
2008,Dem. Rep. of the Congo,Sud kivu(Uvira & Fizi),20,21,0,10,28,0,0,79,11,33,0,9,60,0,0,113
2008,Dem. Rep. of the Congo,South Kivu(Uvira/Fizi),468,373,0,400,1221,96,0,2558,410,400,0,329,798,74,0,2011
2008,Dem. Rep. of the Congo,Orientale(Province),166,177,0,179,548,88,0,1158,175,205,0,197,588,138,0,1303
2008,Dem. Rep. of the Congo,North katanga( Moba),513,400,0,401,880,60,0,2254,444,400,0,353,692,49,0,1938
2008,Dem. Rep. of the Congo,North Katanga (Pweto),623,500,0,490,1118,55,0,2786,602,500,0,518,873,41,0,2534
2008,Dem. Rep. of the Congo,Mbujimayi,0,0,0,0,3,0,0,3,0,0,0,0,9,1,0,10
2008,Dem. Rep. of the Congo,Kinahasa,2,0,0,0,3,0,0,5,0,1,0,0,7,0,0,8
2008,Dem. Rep. of the Congo,Katanga (Kisenge),41,60,0,64,134,23,0,322,42,62,0,69,144,30,0,347
2008,Dem. Rep. of the Congo,Goma,17,10,0,10,30,1,0,68,9,10,0,16,28,1,0,64
2008,Dem. Rep. of the Congo,Equateur,1602,1661,0,932,2531,250,0,6976,1661,1625,0,941,1947,150,0,6324
2008,Dem. Rep. of the Congo,Bukavu,11,10,0,10,56,3,0,90,24,18,0,20,50,2,0,114
2008,Dem. Rep. of the Congo,Bas-Congo( Kimaza),42,36,0,34,115,0,0,227,48,48,0,43,207,5,0,351
2008,Dem. Rep. of the Congo,Bandundu(Province),53,70,0,71,123,17,0,334,33,77,0,76,36,3,0,225
2008,Dem. Rep. of the Congo,Sud kivu( Uvira & Fizi),1557,1682,0,925,188,3235,0,7587,1517,1643,0,1035,2621,148,0,6964
2008,Dem. Rep. of the Congo,North Katanga( Kalemie),156,117,0,130,268,21,0,692,136,136,0,128,258,22,0,680
2008,Dem. Rep. of the Congo,Lubumbashi,71,65,0,62,138,13,0,349,74,78,0,59,143,2,0,356
2008,Dem. Rep. of the Congo,Kinshasa,1279,1734,0,1812,7051,1292,0,13168,1244,1725,0,1843,6524,1128,0,12464
2008,Dem. Rep. of the Congo,Kasai orientale(Province),13,183,0,48,349,18,0,611,17,170,0,38,404,26,0,655
2008,Dem. Rep. of the Congo,Bas-Congo( Spontaneous Installed),6368,6530,0,6552,21332,2839,0,43621,6159,6898,0,6898,17240,2105,0,39300
2008,Dem. Rep. of the Congo,Bas-Congo( Lukaya District),35,37,0,38,70,4,0,184,34,42,0,40,44,0,0,160
2008,Dem. Rep. of the Congo,Bas-Congo( Cataractes District),70,123,0,126,312,34,0,665,71,141,0,145,223,21,0,601
2008,Dem. Rep. of the Congo,Bas-Congo( Bas Fleuve District),67,87,0,53,174,24,0,405,83,99,0,53,223,47,0,505
2008,Congo,Tchitanzi,4,19,0,26,81,7,0,137,16,33,0,43,95,4,0,191
2008,Congo,Tchiamba-Nza,32,48,0,59,119,4,0,262,31,58,0,45,147,3,0,284
2008,Congo,Sangha,6,101,0,113,260,4,0,484,8,92,0,127,369,3,0,599
2008,Congo,Pointe-Noire,0,10,0,21,124,7,0,162,5,14,0,30,182,4,0,235
2008,Congo,Oyo,4,7,0,20,49,1,0,81,7,22,0,18,67,0,0,114
2008,Congo,Owando,0,0,0,0,3,0,0,3,0,0,0,1,6,0,0,7
2008,Congo,Ollombo,0,0,0,0,2,0,0,2,0,0,0,1,4,0,0,5
2008,Congo,Okoyo,0,1,0,0,4,0,0,5,0,1,0,0,3,0,0,4
2008,Congo,Ngo,6,44,0,56,89,1,0,196,7,61,0,76,142,0,0,286
2008,Congo,Ndzoundou & L,21,77,0,84,139,22,0,343,30,60,0,64,139,27,0,320
2008,Congo,Mpouya,0,0,0,2,1,0,0,3,0,0,0,0,1,0,0,1
2008,Congo,Malolo & Loud,2,46,0,69,114,6,0,237,3,40,0,47,137,2,0,229
2008,Congo,Makoua,0,0,0,2,6,0,0,8,0,1,0,1,12,0,0,14
2008,Congo,Makotipoko,1,1,0,7,11,0,0,20,0,1,0,3,19,0,0,23
2008,Congo,Loukolela,98,179,0,206,537,22,0,1042,79,184,0,223,743,19,0,1248
2008,Congo,Kondi M,5,53,0,70,217,9,0,354,18,76,0,88,194,7,0,383
2008,Congo,Komi,1,14,0,20,48,2,0,85,3,12,0,17,59,5,0,96
2008,Congo,Kintele & environ,16,89,0,109,408,3,0,625,17,131,0,169,529,17,0,863
2008,Congo,Impfondo,564,809,0,948,2010,231,0,4562,532,556,0,962,1886,276,0,4212
2008,Congo,Gamboma,0,0,0,0,5,0,0,5,0,1,0,1,5,0,0,7
2008,Congo,Dolisie & environ,1,15,0,25,53,3,0,97,3,17,0,19,44,3,0,86
2008,Congo,Djambala,0,2,0,6,12,0,0,20,0,2,0,6,18,0,0,26
2008,Congo,Brazzaville/Point-Noire,35,200,0,231,906,2,0,1374,19,340,0,359,1197,16,0,1931
2008,Congo,Brazzaville,32,291,0,396,1000,13,0,1732,77,351,0,383,1276,61,0,2148
2008,Congo,Boundji,0,1,0,1,4,0,0,6,0,0,0,0,4,0,0,4
2008,Congo,Bouemba,0,1,0,0,9,0,0,10,0,0,0,2,16,0,0,18
2008,Congo,Betou,308,321,0,321,429,146,0,1525,221,299,0,381,379,90,0,1370
2008,Colombia,Tunja,0,0,0,0,1,0,0,1,0,0,0,0,0,0,0,0
2008,Colombia,Tulua,0,0,0,0,0,0,0,0,0,0,0,0,1,0,0,1
2008,Colombia,Sta. Marta,0,0,0,0,0,0,0,0,0,0,0,0,1,0,0,1
2008,Colombia,San Andres,0,0,0,0,2,0,0,2,0,0,0,1,1,0,0,2
2008,Colombia,Neiva,0,0,0,0,1,0,0,1,0,0,0,0,0,0,0,0
2008,Colombia,Medellin,1,0,0,0,2,0,0,3,0,1,0,2,1,0,0,4
2008,Colombia,Maicao,0,0,0,0,1,0,0,1,0,0,0,0,0,0,0,0
2008,Colombia,Ibague,0,0,0,0,1,0,0,1,0,0,0,0,1,0,0,1
2008,Colombia,Duitama,0,0,0,0,1,0,0,1,0,0,0,0,0,0,0,0
2008,Colombia,Dosquebradas,0,0,0,1,1,0,0,2,0,1,0,0,1,0,0,2
2008,Colombia,Cucuta,1,0,0,0,4,0,0,5,1,1,0,1,6,0,0,9
2008,Colombia,Charala,0,0,0,0,0,0,0,0,0,0,0,0,0,1,0,1
2008,Colombia,Cartagena,0,0,0,0,1,0,0,1,0,0,0,0,10,1,0,11
2008,Colombia,Cali,0,0,0,0,2,0,0,2,0,2,0,0,2,1,0,5
2008,Colombia,Buenaventura,0,1,0,2,2,0,0,5,0,3,0,0,1,0,0,4
2008,Colombia,Bucaramanga,0,0,0,0,0,0,0,0,0,0,0,0,1,0,0,1
2008,Colombia,Bogota,3,3,0,7,29,8,0,50,3,8,0,5,132,7,0,155
2008,Colombia,Barranquilla,0,0,0,0,0,0,0,0,0,0,0,0,1,0,0,1
2008,Colombia,"Barcelona, Q",0,0,0,2,1,0,0,3,0,0,0,0,1,0,0,1
2008,Cuba,Villaclara,0,0,0,0,1,0,0,1,0,0,0,0,27,0,0,27
2008,Cuba,Santiago de Cuba,0,0,0,0,0,0,0,0,0,0,0,1,16,0,0,17
2008,Cuba,Sancti Spiritus,0,0,0,0,0,0,0,0,0,0,0,0,22,0,0,22
2008,Cuba,Pinar del Río,0,0,0,0,0,0,0,0,0,0,0,0,44,0,0,44
2008,Cuba,Matanzas,0,0,0,0,0,0,0,0,0,0,0,0,17,0,0,17
2008,Cuba,Las Tunas,0,0,0,0,0,0,0,0,0,0,0,0,34,0,0,34
2008,Cuba,La Habana,0,0,0,0,0,0,0,0,0,0,0,0,3,0,0,3
2008,Cuba,Isla de la Juventud,0,0,0,0,0,0,0,0,0,0,0,21,152,0,0,173
2008,Cuba,Holguín,0,0,0,0,0,0,0,0,0,0,0,0,41,0,0,41
2008,Cuba,Guantánamo,0,0,0,0,0,0,0,0,0,0,0,0,28,0,0,28
2008,Cuba,Granma,0,0,0,0,0,0,0,0,0,0,0,0,28,0,0,28
2008,Cuba,Ciudad de La Habana,2,0,0,0,7,0,0,9,0,2,0,0,19,0,0,21
2008,Cuba,Cienfuegos,0,0,0,0,0,0,0,0,0,0,0,0,21,0,0,21
2008,Cuba,Ciego de Avila,0,0,0,0,0,0,0,0,0,0,0,0,3,0,0,3
2008,Cuba,Camagüey,0,0,0,0,1,0,0,1,0,0,0,0,45,0,0,45
2008,Czech Rep.,Private Accommodation,9,20,0,36,338,226,14887,15516,13,29,0,49,252,113,13202,13658
2008,Djibouti,Djibouti,7,10,0,9,80,0,0,106,12,15,0,10,162,1,0,200
2008,Djibouti,Ali-Addeh,650,899,0,471,2448,102,0,4570,704,951,0,486,2096,117,0,4354
2008,Algeria,Algiers,38,11,0,3,202,0,0,254,50,15,0,2,665,0,0,732
2008,Egypt,Cairo,7873,10953,0,6957,24068,1394,0,51245,8593,8294,0,12113,31348,1012,0,61360
2008,Eritrea,Emkulu,631,428,0,186,814,32,0,2091,722,397,0,281,1275,37,0,2712
2008,Eritrea,Elit,5,7,0,1,10,0,0,23,5,8,0,4,69,2,0,88
2008,Eritrea,Asmara,8,7,0,3,15,0,0,33,8,11,0,1,24,0,0,44
2008,Eritrea,Afabet,0,0,0,0,0,0,0,0,0,0,0,0,1,0,0,1
2008,Estonia,Tallinn,0,0,0,0,1,0,0,1,0,0,0,0,1,0,0,1
2008,Estonia,Illuka,0,2,0,0,0,0,0,2,0,0,0,0,7,0,0,7
2008,Ethiopia,Teferiber,1099,1253,0,1205,2264,124,0,5945,1078,1264,0,1209,1480,69,0,5100
2008,Ethiopia,Shimelba (Shire/Shiraro),645,527,0,450,1747,171,0,3540,652,589,0,573,5102,192,0,7108
2008,Ethiopia,Sherkole (Assosa),258,572,0,250,950,16,0,2046,302,623,0,355,1427,14,0,2721
2008,Ethiopia,Sherkole,0,0,0,0,1,0,0,1,1,0,0,0,3,0,0,4
2008,Ethiopia,Sheder,620,802,0,577,1395,77,0,3471,665,830,0,535,1027,39,0,3096
2008,Ethiopia,Mai-Ayni,33,25,0,24,361,4,0,447,44,41,0,119,2835,22,0,3061
2008,Ethiopia,Kebribeyah (Jijiga),1722,1927,0,1137,3292,144,0,8222,1759,1995,0,1180,2777,199,0,7910
2008,Ethiopia,Fugnido (Gambella),2052,2895,0,1470,5206,145,0,11768,2234,2836,0,1697,2723,50,0,9540
2008,Ethiopia,Borena,241,0,0,568,504,84,0,1397,269,0,0,450,451,78,0,1248
2008,Ethiopia,Afar,311,715,0,327,1515,74,0,2942,390,794,0,509,2291,172,0,4156
2008,Ethiopia,Addis Ababa,97,124,0,91,341,12,0,665,82,128,0,86,539,27,0,862
2008,Fiji,Suva,0,0,0,0,0,0,0,0,0,0,0,0,2,0,0,2
2008,Fiji,Lami,0,1,0,0,1,0,0,2,0,1,0,0,1,0,0,2
2008,Micronesia (Federated States of),Yap,0,0,0,0,0,0,0,0,0,0,0,0,1,0,0,1
2008,Gabon,Voungou/Pont,1,6,0,4,14,3,0,28,5,6,0,4,16,0,0,31
2008,Gabon,Tchibanga,68,144,0,142,346,20,0,720,61,168,0,103,429,29,0,790
2008,Gabon,Sindara,0,0,0,0,0,0,0,0,0,0,0,0,1,0,0,1
2008,Gabon,Rinanzala,2,17,0,6,23,1,0,49,0,18,0,5,27,2,0,52
2008,Gabon,Rébé,1,0,0,0,1,0,0,2,0,0,0,0,0,0,0,0
2008,Gabon,Port-Gentil,1,15,0,16,74,1,0,107,5,16,0,13,181,11,0,226
2008,Gabon,Pana/Dienga,0,0,0,0,1,0,0,1,0,0,0,1,6,0,0,7
2008,Gabon,Oyem,0,1,0,2,3,0,0,6,0,2,0,0,16,0,0,18
2008,Gabon,Okondja,3,3,0,0,4,0,0,10,0,2,0,1,41,0,0,44
2008,Gabon,Nzinga,0,4,0,4,9,2,0,19,2,3,0,3,6,0,0,14
2008,Gabon,Ntoum,0,1,0,0,2,0,0,3,0,1,0,0,1,0,0,2
2008,Gabon,Ngouoni,1,0,0,0,1,0,0,2,0,0,0,0,15,0,0,15
2008,Gabon,Ndjolé,1,1,0,1,2,0,0,5,0,1,0,2,6,0,0,9
2008,Gabon,Ndendé,15,43,0,27,108,6,0,199,7,40,0,25,81,0,0,153
2008,Gabon,Mounana,3,11,0,9,37,1,0,61,6,13,0,7,85,2,0,113
2008,Gabon,Moulengui-Binza Commune,10,40,0,26,86,15,0,177,12,49,0,35,74,7,0,177
2008,Gabon,Mouila,16,61,0,37,161,4,0,279,45,68,0,23,197,2,0,335
2008,Gabon,Moanda,48,142,0,113,444,23,0,770,34,147,0,103,493,15,0,792
2008,Gabon,Mitzic,0,0,0,0,1,0,0,1,0,0,0,0,3,0,0,3
2008,Gabon,Mékambo,0,0,0,0,0,0,0,0,0,0,0,0,1,2,0,3
2008,Gabon,Mayumba,1,3,0,2,14,0,0,20,2,1,0,0,18,0,0,21
2008,Gabon,Makokou,0,0,0,1,2,0,0,3,0,1,0,0,16,0,0,17
2008,Gabon,Mabanda,4,10,0,5,23,3,0,45,3,10,0,4,27,4,0,48
2008,Gabon,Lope,1,0,0,3,2,0,0,6,0,1,0,0,5,0,0,6
2008,Gabon,Libreville,84,302,0,251,1046,29,0,1712,63,282,0,251,1931,93,0,2620
2008,Gabon,Lékindou,1,5,0,3,9,0,0,18,0,0,0,1,4,2,0,7
2008,Gabon,Lébamba,7,11,0,7,19,1,0,45,2,6,0,5,16,2,0,31
2008,Gabon,Lastourville,2,9,0,9,30,1,0,51,1,11,0,7,47,3,0,69
2008,Gabon,Lambarené,1,1,0,1,11,0,0,14,1,7,0,2,22,1,0,33
2008,Gabon,Koumou-Doussala,0,3,0,5,3,3,0,14,0,2,0,2,2,1,0,7
2008,Gabon,Koulamoutou,4,24,0,22,60,1,0,111,6,21,0,9,133,4,0,173
2008,Gabon,Gamba,4,19,0,12,66,0,0,101,8,14,0,2,78,2,0,104
2008,Gabon,Franceville,75,169,0,104,533,14,0,895,102,169,0,109,932,22,0,1334
2008,Gabon,Fougamou,1,0,0,0,2,0,0,3,0,1,0,0,4,0,0,5
2008,Gabon,Doussala,1,2,0,1,6,1,0,11,2,6,0,3,3,0,0,14
2008,Gabon,Dilemba,9,29,0,24,77,11,0,150,8,32,0,28,64,10,0,142
2008,Gabon,Boumango,4,15,0,12,18,2,0,51,2,10,0,9,21,3,0,45
2008,Gabon,Booué,1,0,0,0,3,0,0,4,0,1,0,0,8,1,0,10
2008,Gabon,Bongoville,0,0,0,0,0,0,0,0,0,0,0,0,3,0,0,3
2008,Gabon,Bitam,0,0,0,0,2,0,0,2,1,0,0,0,6,0,0,7
2008,Gabon,Bibora,0,0,0,0,1,0,0,1,0,0,0,0,0,0,0,0
2008,Gabon,Banda-Mamba,1,6,0,1,9,2,0,19,1,1,0,3,1,4,0,10
2008,Gabon,Bakoumba,2,17,0,9,24,1,0,53,3,13,0,5,11,0,0,32
2008,Gabon,Akiéni,0,1,0,1,2,0,0,4,1,3,0,0,8,0,0,12
2008,Georgia,Tbilisi,0,2,0,0,5,0,0,7,0,2,0,1,16,2,0,21
2008,Ghana,Volta,91,99,0,87,306,21,0,604,99,57,0,94,396,14,0,660
2008,Ghana,Krisan,18,68,0,39,250,11,0,386,27,62,0,35,638,9,0,771
2008,Ghana,Buduburam,633,1248,0,850,4400,159,0,7290,735,1253,0,803,4834,77,0,7702
2008,Ghana,Accra,39,84,0,72,190,63,0,448,41,88,0,60,629,17,0,835
2008,Guinea,Nzerekore,3,5,0,10,31,0,0,49,3,8,0,18,37,0,0,66
2008,Guinea,Laine,138,559,0,400,1128,57,0,2282,178,516,0,409,840,38,0,1981
2008,Guinea,Kouankan 2,200,474,0,316,708,49,0,1747,155,433,0,340,584,39,0,1551
2008,Guinea,Kouankan,142,433,0,303,806,39,0,1723,151,413,0,297,659,37,0,1557
2008,Guinea,Conakry,266,559,0,582,2188,31,0,3626,281,552,0,624,2821,41,0,4319
2008,Guinea,Boreah,94,357,0,224,837,47,0,1559,98,339,0,237,914,71,0,1659
2008,Gambia,Border villages ,524,787,0,1520,610,200,0,3641,524,687,0,700,610,236,0,2757
2008,Guinea-Bissau,Jolmette,53,78,0,42,125,9,0,307,55,29,0,85,100,14,0,283
2008,Guinea-Bissau,Frontiere Sn,634,1382,0,921,525,110,0,3572,667,571,0,769,1165,158,0,3330
2008,Guinea-Bissau,Bissau,28,30,0,37,135,4,0,234,42,80,0,63,283,17,0,485
2008,Guatemala,Guatemala City,0,0,0,0,58,9,0,67,0,0,0,0,61,7,0,68
2008,"China, Hong Kong SAR","Hong Kong SAR, China",24,13,0,1,319,3,0,360,21,12,0,6,815,1,0,855
2008,Honduras,Tegucigalpa,0,0,0,0,0,0,0,0,0,0,0,0,0,17,1,18
2008,Honduras,"San Pedro, Sula",0,0,0,0,0,0,0,0,0,0,0,0,0,2,0,2
2008,Honduras,Isla de la Bahia,0,0,0,0,3,0,0,3,0,0,0,0,0,1,0,1
2008,Croatia,Zagreb,0,1,0,0,2,0,0,3,0,2,0,1,3,0,0,6
2008,Croatia,Zadarska,0,1,0,0,1,0,0,2,0,0,0,1,1,0,0,2
2008,Croatia,Vukovarsko-Srijemska,9,14,0,12,275,169,0,479,8,9,0,15,255,126,0,413
2008,Croatia,Split,0,0,0,0,0,0,0,0,0,0,0,0,1,0,0,1
2008,Croatia,Osjecko-Baranjska,1,3,0,16,209,147,0,376,0,4,0,11,218,138,0,371
2008,Croatia,Kutina,1,5,0,1,4,0,0,11,0,3,0,5,22,0,0,30
2008,Croatia,Jezevo,0,0,0,0,0,0,0,0,0,0,0,0,12,0,0,12
2008,Croatia,Collective accommodation,5,5,0,10,90,126,0,236,5,11,0,35,137,77,0,265
2008,Haiti,Port au Prince,0,0,0,0,0,0,0,0,0,0,0,0,3,0,0,3
2008,Hungary,Budapest,0,16,0,0,27,0,0,43,0,25,0,41,114,0,0,180
2008,Hungary,"Békéscsaba, Bicske, Debrecen",0,467,0,91,753,17,0,1328,0,678,0,295,3528,9,0,4510
2008,Indonesia,Mataram,6,8,0,4,18,0,0,36,9,10,0,6,88,0,0,113
2008,Indonesia,Jakarta,15,15,0,14,75,2,0,121,12,38,0,39,363,3,0,455
2008,India,Tamil Nadu,0,0,0,0,0,0,35901,35901,0,0,0,0,0,0,37385,37385
2008,India,New Delhi,808,740,0,1181,4522,346,0,7597,788,833,0,1348,4166,310,0,7445
2008,Iraq,Wassit/Kut,1,6,0,7,29,1,0,44,2,9,0,5,20,2,0,38
2008,Iraq,Wassit/Dijaila,0,3,0,2,7,0,0,12,0,1,0,2,7,1,0,11
2008,Iraq,Sulymania/Khaniqen,0,0,0,1,8,2,0,11,0,0,0,0,7,1,0,8
2008,Iraq,Sulymania/Kalar,0,0,0,1,9,0,0,10,0,1,0,3,3,0,0,7
2008,Iraq,Sulymania/Barika,0,0,0,1,3,0,0,4,0,0,0,1,2,0,0,3
2008,Iraq,Sulymania,226,543,0,521,1728,145,0,3163,193,581,0,646,1834,180,0,3434
2008,Iraq,Salah Al-Din/Beji,0,0,0,0,0,0,0,0,0,0,0,0,1,0,0,1
2008,Iraq,Salah Al-Din,0,1,0,4,17,2,0,24,0,4,0,4,15,1,0,24
2008,Iraq,Ninewa/Zumer,1,0,0,0,1,0,0,2,1,0,0,0,1,0,0,2
2008,Iraq,Ninewa/Mousl,8,22,0,28,85,5,0,148,13,20,0,18,90,9,0,150
2008,Iraq,Ninewa/Makhmour,555,1020,0,921,2831,276,0,5603,577,1083,0,905,2533,211,0,5309
2008,Iraq,Ninew/Makhmour,0,1,0,0,1,0,0,2,1,1,0,0,1,0,0,3
2008,Iraq,Najaf,1,1,0,0,0,0,0,2,0,0,0,0,1,0,0,1
2008,Iraq,Nainawa/Makhmour,4,4,0,5,11,0,0,24,5,6,0,2,22,0,0,35
2008,Iraq,Missan/Ammara,10,18,0,27,78,10,0,143,7,21,0,20,59,13,0,120
2008,Iraq,Missan/Ali-Algharbi,0,1,0,0,1,0,0,2,0,0,0,1,1,0,0,2
2008,Iraq,Kirkuk,0,0,0,0,3,0,0,3,0,0,0,1,1,1,0,3
2008,Iraq,Kerbala,0,0,0,2,9,0,0,11,0,0,0,0,3,3,0,6
2008,Iraq,Erbil/Soran,0,0,0,0,0,0,0,0,0,0,0,0,2,0,0,2
2008,Iraq,Erbil/Koysnjaq,1,2,0,6,9,0,0,18,0,1,0,2,12,0,0,15
2008,Iraq,Erbil/Koya,0,6,0,2,17,0,0,25,3,2,0,4,17,3,0,29
2008,Iraq,Erbil/Kawa,63,127,0,118,385,29,0,722,46,143,0,132,371,35,0,727
2008,Iraq,Erbil/Kasnazan,0,0,0,0,4,0,0,4,0,0,0,0,5,0,0,5
2008,Iraq,Erbil/Hareer,2,31,0,25,83,7,0,148,2,33,0,21,69,3,0,128
2008,Iraq,Erbil/Degala,0,0,0,0,3,0,0,3,0,0,0,1,3,0,0,4
2008,Iraq,Erbil/Bahrka,0,1,0,0,5,0,0,6,0,0,0,0,4,0,0,4
2008,Iraq,Erbil/Ainkawa,1,1,0,0,10,0,0,12,0,0,0,0,1,0,0,1
2008,Iraq,Erbil,33,90,0,85,294,11,0,513,48,66,0,67,525,27,0,733
2008,Iraq,Diyala/Baqoba,2,0,0,1,1,0,0,4,1,0,0,0,6,0,0,7
2008,Iraq,Diyala/Al-Muqdadadiya,1,1,0,0,8,0,0,10,0,1,0,2,4,0,0,7
2008,Iraq,Diyala/Al-Khalis,0,13,0,12,48,7,0,80,0,13,0,11,40,6,0,70
2008,Iraq,Diwanyia,5,3,0,1,15,0,0,24,0,1,0,1,10,1,0,13
2008,Iraq,Diwaniya,5,16,0,13,37,2,0,73,3,10,0,7,32,1,0,53
2008,Iraq,Dahuk/Zakho,8,104,0,74,166,6,71,429,11,115,0,75,172,4,58,435
2008,Iraq,Dahuk/Teldif,0,5,0,6,18,1,0,30,0,4,0,2,13,1,0,20
2008,Iraq,Dahuk/Tanahi,0,0,0,0,0,0,10,10,0,0,0,0,0,0,6,6
2008,Iraq,Dahuk/Suriya,1,0,0,0,1,0,0,2,1,0,0,0,1,0,0,2
2008,Iraq,Dahuk/Sumel,0,0,0,0,0,0,2,2,0,0,0,0,0,0,3,3
2008,Iraq,Dahuk/Sumeil,3,3,0,1,17,1,0,25,1,2,0,2,23,0,0,28
2008,Iraq,Dahuk/Smailava,0,0,0,0,1,0,0,1,0,0,0,0,1,0,0,1
2008,Iraq,Dahuk/Sersink,0,3,0,4,14,1,0,22,0,6,0,4,16,0,0,26
2008,Iraq,Dahuk/Moquble ,17,13,0,10,67,1,0,108,17,20,0,12,100,2,0,151
2008,Iraq,Dahuk/Mesirike,2,116,0,92,265,35,50,560,10,119,0,64,278,24,56,551
2008,Iraq,Dahuk/Malaparwan,2,17,0,12,26,2,0,59,2,17,0,8,24,1,0,52
2008,Iraq,Dahuk/Kuregavana,0,1,0,2,15,1,0,19,0,0,0,1,18,1,0,20
2008,Iraq,Dahuk/Khanke,0,0,0,0,7,1,0,8,0,0,0,2,7,0,0,9
2008,Iraq,Dahuk/Hussainiya,2,72,0,35,131,22,2,264,0,78,0,47,120,19,3,267
2008,Iraq,Dahuk/Greygewry,2,102,0,55,197,7,1,364,3,132,0,53,184,16,2,390
2008,Iraq,Dahuk/Domiz,31,52,0,56,115,5,0,259,32,71,0,52,137,5,0,297
2008,Iraq,Dahuk/Dohuk,0,0,0,0,0,0,15,15,0,0,0,0,0,0,17,17
2008,Iraq,Dahuk/Daratoo,0,51,0,29,137,8,0,225,0,71,0,50,134,12,0,267
2008,Iraq,Dahuk/Balqus,0,18,0,13,31,4,15,81,1,24,0,9,41,1,17,93
2008,Iraq,Dahuk,14,78,0,46,183,9,55,385,15,92,0,55,193,5,57,417
2008,Iraq,Basrah/Al-Zubair,0,10,0,6,18,5,0,39,0,18,0,5,23,2,0,48
2008,Iraq,Basrah/Al-Tanuma,0,9,0,6,13,3,0,31,0,13,0,8,12,0,0,33
2008,Iraq,Basrah/Al-Shuaba,0,9,0,6,26,6,0,47,0,14,0,9,40,5,0,68
2008,Iraq,Basrah/Al-Chabasi,1,10,0,11,44,6,0,72,2,16,0,8,34,8,0,68
2008,Iraq,Basrah/Abul Khasib,1,13,0,9,36,5,0,64,1,21,0,3,32,3,0,60
2008,Iraq,Basrah,12,75,0,34,120,11,0,252,7,55,0,35,111,4,0,212
2008,Iraq,Baghdad/Al-Resafa,302,482,0,523,2174,345,0,3826,346,475,0,544,2265,320,0,3950
2008,Iraq,Baghdad/Al-Karkh,85,165,0,180,703,116,0,1249,85,160,0,159,806,133,0,1343
2008,Iraq,Baghdad,6,16,0,15,53,8,0,98,1,16,0,10,60,22,0,109
2008,Iraq,Baghad/Al-Resafa,0,0,0,0,2,0,0,2,0,0,0,0,0,0,0,0
2008,Iraq,Babylon/Hilla,0,2,0,2,15,3,0,22,0,2,0,3,19,7,0,31
2008,Iraq,Babylon/Al-Musayab,0,0,0,0,2,1,0,3,0,0,0,0,3,2,0,5
2008,Iraq,Babylon,1,1,0,2,8,0,0,12,2,2,0,1,7,1,0,13
2008,Iraq,Anbar/Trebil,9,17,0,10,38,3,0,77,15,16,0,8,52,2,0,93
2008,Iraq,Anbar/Ramadi,0,7,0,4,19,3,0,33,0,1,0,3,19,5,0,28
2008,Iraq,Anbar/NML,8,27,0,19,40,1,0,95,4,20,0,15,58,1,0,98
2008,Iraq,Anbar/K-70,3,5,0,0,7,0,0,15,1,5,0,3,18,0,0,27
2008,Iraq,Anbar/Falluja,1,2,0,1,5,1,0,10,0,0,0,5,10,0,0,15
2008,Iraq,Anbar/Al-Waleed,91,105,0,87,299,34,0,616,73,92,0,87,447,39,0,738
2008,Iraq,Anbar/Al-Tash,6,17,0,16,58,4,0,101,3,12,0,21,66,4,0,106
2008,Iraq,Anbar,0,14,0,9,30,4,0,57,0,12,0,9,29,6,0,56
2008,Iceland,Reykjavik,0,6,0,15,32,1,0,54,4,4,0,10,10,0,0,28
2008,Iceland,Keflavik/Reykjavik,0,0,0,0,0,0,0,0,0,0,0,0,2,0,0,2
2008,Iceland,Keflavik,0,0,0,6,8,0,0,14,0,1,0,1,28,0,0,30
2008,Iceland,Akureyri,0,0,0,0,0,0,0,0,0,0,0,0,1,0,0,1
2008,Iceland,Akranes,3,3,0,3,8,0,0,17,2,5,0,5,0,0,0,12
2008,Israel,Tel Aviv,206,128,0,54,2212,12,160,2772,263,170,0,151,10477,97,940,12098
2008,Jordan,Amman,21457,30733,0,27007,152541,27053,0,258791,22582,33555,0,29376,138095,18699,0,242307
2008,Kazakhstan,Almaty,40,19,0,67,156,5,0,287,54,30,0,74,280,5,0,443
2008,Kenya,Nairobi,1163,2183,0,2385,9669,230,0,15630,1167,2357,0,2558,14165,638,0,20885
2008,Kenya,Kakuma,3368,4628,0,3204,11376,403,0,22979,3504,5048,0,4207,17065,265,0,30089
2008,Kenya,Ifo (Dadaab),5355,7898,0,4989,19221,1211,0,38674,5688,8527,0,6070,19298,1212,0,40795
2008,Kenya,Hagadera (Dadaab),6307,9006,0,5549,21867,1303,0,44032,6464,9897,0,6598,22061,1351,0,46371
2008,Kenya,Dagahaley (Dadaab),4912,7562,0,3840,14732,979,0,32025,5293,8309,0,4941,14035,978,0,33556
2008,Kenya,Dadaab,367,386,0,202,932,52,0,1939,383,471,0,298,1191,47,0,2390
2008,Kyrgyzstan,Talas region,0,0,0,0,0,0,130,130,0,0,0,0,0,0,90,90
2008,Kyrgyzstan,Osh region,286,658,0,398,1217,83,0,2642,225,550,0,299,543,137,0,1754
2008,Kyrgyzstan,Osh,6,13,0,8,25,0,60,112,3,14,0,10,20,1,70,118
2008,Kyrgyzstan,Issyk-Kul region,0,0,0,0,0,0,180,180,0,0,0,0,0,0,150,150
2008,Kyrgyzstan,Djalalabat region,481,616,0,235,1741,159,0,3232,563,552,0,324,962,136,0,2537
2008,Kyrgyzstan,Chui region,242,371,0,277,1814,111,0,2815,242,411,0,327,1689,126,0,2795
2008,Kyrgyzstan,Bishkek,30,53,0,56,183,8,1000,1330,27,61,0,55,360,13,1070,1586
2008,Kyrgyzstan,Batken region,146,197,0,44,366,2,0,755,210,225,0,78,217,5,0,735
2008,Cambodia,Phnom Penh,6,13,0,21,62,0,0,102,11,24,0,16,69,3,0,123
2008,Rep. of Korea,Suwon,0,0,0,0,7,0,0,7,0,0,0,0,34,2,0,36
2008,Rep. of Korea,Seoul/Kyunggi Province,8,9,0,2,226,14,0,259,13,10,0,2,953,6,0,984
2008,Rep. of Korea,Pohang,0,0,0,0,0,0,0,0,0,0,0,0,1,0,0,1
2008,Rep. of Korea,Masan,0,0,0,0,0,0,0,0,0,0,0,0,6,0,0,6
2008,Rep. of Korea,Incheon,0,1,0,0,6,0,0,7,0,0,0,0,26,0,0,26
2008,Rep. of Korea,Gwangju,0,0,0,0,0,0,0,0,0,0,0,0,2,0,0,2
2008,Rep. of Korea,Euijeongbu,0,0,0,0,1,0,0,1,0,0,0,0,2,0,0,2
2008,Rep. of Korea,Daejeon,0,0,0,0,1,1,0,2,0,1,0,0,10,1,0,12
2008,Rep. of Korea,Daegu,0,0,0,1,14,0,0,15,1,1,0,1,64,0,0,67
2008,Rep. of Korea,Cheongju,0,0,0,0,0,0,0,0,0,0,0,0,4,0,0,4
2008,Rep. of Korea,Busan,0,0,0,0,8,1,0,9,0,0,0,0,21,0,0,21
2008,Kuwait,Kuwait,24,70,0,94,294,7,0,489,23,86,0,107,2170,10,0,2396
2008,Liberia,Voa,89,124,0,146,412,27,0,798,104,205,0,182,529,33,0,1053
2008,Liberia,Sinoe,0,0,0,0,0,0,1,1,0,0,0,0,0,0,8,8
2008,Liberia,Samukai,67,93,0,70,199,8,0,437,47,71,0,67,308,7,0,500
2008,Liberia,Saclepea,34,110,0,106,337,25,0,612,72,82,0,112,392,38,0,696
2008,Liberia,River Gee,0,0,0,0,0,0,0,0,0,0,0,0,0,0,4,4
2008,Liberia,River Cess,0,0,0,0,0,0,0,0,0,0,0,0,0,0,3,3
2008,Liberia,Nimba,19,39,0,82,618,30,53,841,22,44,0,90,652,37,129,974
2008,Liberia,Montserrado,0,0,0,0,0,0,5112,5112,0,0,0,0,0,0,3760,3760
2008,Liberia,Monrovia,6,18,0,10,33,0,0,67,3,15,0,10,110,0,0,138
2008,Liberia,Maryland,5,24,0,39,129,11,21,229,4,29,0,37,140,6,53,269
2008,Liberia,Margibi,0,0,0,0,0,0,17,17,0,0,0,0,0,0,34,34
2008,Liberia,Lofa,0,0,0,0,0,0,44,44,0,0,0,0,0,0,32,32
2008,Liberia,Grand Gedeh,37,89,0,109,1316,42,75,1668,42,100,0,136,1250,61,121,1710
2008,Liberia,Grand Cape Mountain,0,0,0,0,0,0,12,12,0,0,0,0,0,0,19,19
2008,Liberia,Grand Bassa,0,0,0,0,0,0,3,3,0,0,0,0,0,0,5,5
2008,Liberia,Bong,0,0,0,0,0,0,11,11,0,0,0,0,0,0,18,18
2008,Liberia,Bomi,0,0,0,0,0,0,0,0,0,0,0,0,0,0,2,2
2008,Liberia,Banjor,14,91,0,61,201,2,0,369,18,67,0,92,169,5,0,351
2008,Saint Lucia,Castries,0,0,0,0,0,0,0,0,0,0,0,0,1,0,0,1
2008,Sri Lanka,Vavuniya,0,0,0,0,0,0,18980,18980,0,0,0,0,0,0,18820,18820
2008,Sri Lanka,Trincomalee,0,0,0,0,0,0,6030,6030,0,0,0,0,0,0,5970,5970
2008,Sri Lanka,Puttalam,0,0,0,0,0,0,34640,34640,0,0,0,0,0,0,34360,34360
2008,Sri Lanka,Other,0,0,0,0,0,0,7530,7530,0,0,0,0,0,0,7470,7470
2008,Sri Lanka,Mullaitivu,0,0,0,0,0,0,57180,57180,0,0,0,0,0,0,56720,56720
2008,Sri Lanka,Mannar,0,0,0,0,0,0,10740,10740,0,0,0,0,0,0,10660,10660
2008,Sri Lanka,Kilinochchi,0,0,0,0,0,0,62450,62450,0,0,0,0,0,0,61950,61950
2008,Sri Lanka,Jaffna,0,0,0,0,0,0,43220,43220,0,0,0,0,0,0,42880,42880
2008,Sri Lanka,Colombo ,35,45,0,37,163,8,0,288,34,55,0,52,225,8,0,374
2008,Sri Lanka,Batticaloa,0,0,0,0,0,0,15410,15410,0,0,0,0,0,0,15290,15290
2008,Sri Lanka,Anuradhapura,0,0,0,0,0,0,4870,4870,0,0,0,0,0,0,4830,4830
2008,Sri Lanka,Ampara,0,0,0,0,0,0,2810,2810,0,0,0,0,0,0,2790,2790
2008,Lithuania,Vilnius,1,1,0,1,8,1,0,12,3,0,0,0,8,0,0,11
2008,Lithuania,Svencionys ,0,0,0,1,1,0,0,2,0,2,0,1,1,0,0,4
2008,Lithuania,RRC Rukla,2,0,0,5,16,0,0,23,5,4,0,0,23,0,0,32
2008,Lithuania,Pabrade,0,0,0,0,0,0,0,0,1,0,0,0,1,0,0,2
2008,Lithuania,Lentvaris,3,1,0,0,3,0,0,7,1,2,0,2,3,0,0,8
2008,Lithuania,Klaipeda,3,1,0,0,3,0,0,7,1,0,0,1,2,0,0,4
2008,Lithuania,Kaunas,4,7,0,0,11,0,0,22,1,2,0,3,13,1,0,20
2008,Lithuania,Jonava,1,1,0,0,3,0,0,5,4,0,0,0,6,0,0,10
2008,Lithuania,Grigiskes,0,0,0,0,0,0,0,0,0,0,0,0,2,0,0,2
2008,Lithuania,FRC Pabrade,10,5,0,5,20,0,0,40,8,4,0,2,61,0,0,75
2008,Lithuania,Elektrenai,5,5,0,5,12,0,0,27,10,7,0,7,10,0,0,34
2008,Lithuania,Alytus,0,2,0,1,1,0,0,4,0,0,0,0,0,0,0,0
2008,Latvia,Salaspils,0,0,0,0,0,0,0,0,0,0,0,0,1,0,0,1
2008,Latvia,Riga district,2,5,0,0,8,0,0,15,4,2,0,1,18,1,0,26
2008,Latvia,Riga,0,0,0,0,1,0,0,1,1,0,0,0,6,0,0,7
2008,Latvia,Jurmala,0,0,0,1,1,0,0,2,0,0,0,0,1,0,0,1
2008,Latvia,Jelgava,0,0,0,0,0,0,0,0,0,0,0,0,1,0,0,1
2008,Morocco,Rabat,44,45,0,46,191,4,0,330,41,47,0,77,733,7,0,905
2008,Rep. of Moldova,Chisinau,1,4,0,6,37,4,0,52,0,10,0,4,110,5,0,129
2008,Mexico,Mexico City,21,38,0,68,246,32,0,405,4,22,0,106,500,36,0,668
2008,The former Yugoslav Republic of Macedonia,Visbegovo,1,2,0,1,4,0,0,8,1,0,0,0,11,0,0,12
2008,The former Yugoslav Republic of Macedonia,Veles,0,0,0,0,0,0,0,0,0,0,0,0,1,0,0,1
2008,The former Yugoslav Republic of Macedonia,Valandovo,1,1,0,1,5,0,0,8,0,2,0,0,4,1,0,7
2008,The former Yugoslav Republic of Macedonia,Tetovo,1,4,0,2,8,1,0,16,2,4,0,6,13,0,0,25
2008,The former Yugoslav Republic of Macedonia,Sv.Nikole,0,0,0,0,0,1,0,1,0,0,0,0,0,0,0,0
2008,The former Yugoslav Republic of Macedonia,Strumica,0,0,0,0,1,0,0,1,0,0,0,0,0,0,0,0
2008,The former Yugoslav Republic of Macedonia,Prilep,0,0,0,0,1,0,0,1,0,0,0,0,4,0,0,4
2008,The former Yugoslav Republic of Macedonia,Ohrid,0,0,0,0,0,0,0,0,0,0,0,0,1,0,0,1
2008,The former Yugoslav Republic of Macedonia,Kumanovo,1,5,0,6,14,1,0,27,2,1,0,11,11,0,0,25
2008,The former Yugoslav Republic of Macedonia,Kicevo,0,0,0,0,1,0,0,1,0,0,0,0,0,0,0,0
2008,The former Yugoslav Republic of Macedonia,Kavadarci,0,0,0,0,2,0,0,2,0,0,0,0,0,0,0,0
2008,The former Yugoslav Republic of Macedonia,Gostivar,0,1,0,0,3,0,0,4,0,0,0,0,0,0,0,0
2008,The former Yugoslav Republic of Macedonia,Gevgelija,0,0,0,0,2,0,0,2,0,0,0,0,1,0,0,1
2008,The former Yugoslav Republic of Macedonia,Geriatric clinic,0,0,0,0,0,0,0,0,0,0,0,0,2,0,0,2
2008,The former Yugoslav Republic of Macedonia,"Elder.home, Kumanovo",0,0,0,0,0,0,0,0,0,0,0,0,0,1,0,1
2008,The former Yugoslav Republic of Macedonia,Berovo,0,0,0,0,1,0,0,1,0,0,0,0,0,0,0,0
2008,The former Yugoslav Republic of Macedonia,Skopje,98,155,0,125,407,30,0,815,103,174,0,97,407,25,0,806
2008,Mali,Sikasso,0,0,0,0,0,0,0,0,0,0,0,0,5,0,0,5
2008,Mali,Kayes,819,730,0,425,568,90,0,2632,349,623,0,1212,1215,126,0,3525
2008,Mali,Faragouana,5,6,0,0,15,1,0,27,6,6,0,4,10,1,0,27
2008,Mali,Bamako,177,253,0,198,1197,41,0,1866,194,288,0,238,2638,54,0,3412
2008,Myanmar,Maungdaw,30669,49352,0,37531,99177,8563,0,225292,36937,52958,0,44498,82007,9014,0,225414
2008,Myanmar,Buthidaung,15851,27303,0,18101,52103,4395,0,117753,17115,29210,0,21930,44440,5023,0,117718
2008,Montenegro,Podgorica,166,122,0,173,302,17,0,780,149,127,0,191,310,26,0,803
2008,Mongolia,Ulaanbaatar,0,0,0,0,4,0,0,4,1,0,0,0,6,0,0,7
2008,Mozambique,Zambezia,7,2,0,2,9,0,0,20,3,7,0,0,23,0,0,33
2008,Mozambique,Tete,2,0,0,3,5,0,0,10,0,0,0,2,8,1,0,11
2008,Mozambique,Sofala,2,1,0,2,8,0,0,13,2,2,0,1,15,0,0,20
2008,Mozambique,Niassa,10,18,0,11,26,0,0,65,10,18,0,10,45,0,0,83
2008,Mozambique,Nampula,41,39,0,29,139,1,0,249,56,55,0,30,453,4,0,598
2008,Mozambique,Maratane,388,563,0,241,861,23,0,2076,452,564,0,285,1493,4,0,2798
2008,Mozambique,Maputo,95,166,0,84,327,8,0,680,81,147,0,76,529,11,0,844
2008,Mozambique,Manica,2,1,0,2,8,0,0,13,1,1,0,2,18,0,0,22
2008,Mozambique,Inhambane,2,2,0,1,7,0,0,12,1,5,0,3,10,0,0,19
2008,Mozambique,Gaza,2,4,0,1,8,0,0,15,5,5,0,3,14,0,0,27
2008,Mozambique,Cabo Delgado,3,1,0,0,1,0,0,5,0,1,0,0,5,0,0,6
2008,Mauritania,Nouakchott/Nouadhibou,52,49,0,26,255,10,0,392,52,57,0,35,553,13,0,710
2008,Malawi,Dzaleka,422,1136,0,688,2069,84,0,4399,421,1139,0,778,2663,25,0,5026
2008,Malaysia,Kuala Lumpur,2224,1868,0,1864,9590,175,0,15721,2376,1993,0,2844,22773,291,0,30277
2008,Namibia,Osire,585,807,0,615,1610,62,0,3679,583,811,0,618,2368,63,0,4443
2008,Namibia,Mayukuyuku,0,0,0,0,0,0,9,9,0,0,0,0,0,0,5,5
2008,Namibia,Dukwe,0,0,0,0,0,0,1,1,0,0,0,0,0,0,3,3
2008,Niger,Niamey,8,23,0,13,49,1,0,94,7,12,0,7,98,0,0,124
2008,Niger,Goure,3,11,0,12,32,4,0,62,5,10,0,9,36,4,0,64
2008,Nigeria,Oru,74,254,0,245,1456,50,0,2079,71,229,0,319,2296,20,0,2935
2008,Nigeria,Lagos,103,120,0,179,1419,0,0,1821,49,150,0,158,1970,237,0,2564
2008,Nigeria,Ijebu Ode,11,9,0,5,30,0,0,55,9,6,0,1,82,0,0,98
2008,Nigeria,Amana/Ituav,245,154,0,200,466,50,0,1115,187,104,0,180,181,23,0,675
2008,Nicaragua,Managua,0,0,0,2,106,0,0,108,0,0,0,4,23,12,0,39
2008,Nepal,Timai,418,648,0,606,2901,306,0,4879,442,650,0,689,2939,336,0,5056
2008,Nepal,Sanischare,775,1304,0,1210,5988,639,0,9916,874,1334,0,1167,6101,736,0,10212
2008,Nepal,Out of Camp,1,5,0,2,26,4,0,38,1,2,0,4,56,4,0,67
2008,Nepal,Khudunabari,439,785,0,880,4053,432,0,6589,480,797,0,830,4017,541,0,6665
2008,Nepal,Kathmandu,20,14,0,5,58,0,0,97,17,23,0,15,123,2,0,180
2008,Nepal,Goldhap,333,433,0,462,2543,284,0,4055,351,481,0,453,2640,335,0,4260
2008,Nepal,Eastern Region,17,62,0,70,200,17,0,366,21,69,0,79,387,27,0,583
2008,Nepal,Beldangi 2 Extension,443,652,0,718,3433,385,0,5631,481,717,0,746,3514,433,0,5891
2008,Nepal,Beldangi 2,764,1228,0,1224,6501,715,0,10432,776,1318,0,1320,6575,824,0,10813
2008,Nepal,Beldangi 1,748,1092,0,1187,5071,540,0,8638,760,1169,0,1178,5188,650,0,8945
2008,Oman,Maskat,2,3,0,1,18,0,0,24,3,10,0,1,15,1,0,30
2008,Pakistan,Zar Karez,246,754,0,400,1038,68,0,2506,248,852,0,481,1180,133,0,2894
2008,Pakistan,Zangal Patai,259,823,0,504,1247,69,0,2902,262,892,0,593,1273,145,0,3165
2008,Pakistan,Zafarabad,217,733,0,309,983,50,0,2292,216,806,0,562,1298,123,0,3005
2008,Pakistan,Yakaghund,189,531,0,313,735,56,0,1824,176,552,0,311,735,90,0,1864
2008,Pakistan,Utmanzai,177,571,0,374,793,36,0,1951,179,566,0,405,763,120,0,2033
2008,Pakistan,Urguch,5,9,0,5,9,1,0,29,3,7,0,8,22,0,0,40
2008,Pakistan,Toor,356,856,0,477,1285,53,0,3027,352,882,0,512,1448,121,0,3315
2008,Pakistan,Timer,708,1665,0,940,2400,108,0,5821,763,1785,0,1035,2450,226,0,6259
2008,Pakistan,Thall,703,2067,0,1211,3297,265,0,7543,713,2182,0,1328,3326,510,0,8059
2008,Pakistan,Swat,1004,1750,0,1076,3212,196,0,7238,1092,2077,0,1371,3502,359,0,8401
2008,Pakistan,Surkhab,559,1432,0,754,2305,172,0,5222,597,1587,0,1033,3104,334,0,6655
2008,Pakistan,Sund Rawal,27,106,0,56,113,13,0,315,32,113,0,51,158,20,0,374
2008,Pakistan,Sindh,3413,9368,0,5755,15951,773,0,35260,3679,9559,0,7410,21439,1940,0,44027
2008,Pakistan,Shindand,70,232,0,146,296,17,0,761,67,239,0,145,333,42,0,826
2008,Pakistan,Shaikh Abad,277,830,0,535,1104,83,0,2829,283,849,0,591,1211,121,0,3055
2008,Pakistan,Saranan,1006,3263,0,1725,4828,307,0,11129,1059,3441,0,2218,5690,735,0,13143
2008,Pakistan,S. Waziristan,2,5,0,3,8,0,0,18,3,9,0,4,7,2,0,25
2008,Pakistan,Rata Kulachi,33,93,0,35,109,7,0,277,28,94,0,64,131,19,0,336
2008,Pakistan,Rakh Zandani,0,1,0,0,1,0,0,2,0,2,0,3,3,0,0,8
2008,Pakistan,Quetta,4,3,0,15,24,0,0,46,3,3,0,12,22,2,0,42
2008,Pakistan,Pusha Pul,56,178,0,78,252,14,0,578,52,218,0,144,317,31,0,762
2008,Pakistan,Punjab,7290,19273,0,10833,31750,1862,0,71008,7754,20643,0,14191,44166,3709,0,90463
2008,Pakistan,Posti,12,26,0,12,40,3,0,93,11,25,0,17,60,5,0,118
2008,Pakistan,Pir Alizai,550,1965,0,1099,2702,146,0,6462,535,2164,0,1551,3580,418,0,8248
2008,Pakistan,Peshawar,5,3,0,11,9,8,0,36,2,3,0,11,24,0,0,40
2008,Pakistan,Panian,2767,8521,0,5271,12853,667,0,30079,2901,8745,0,5653,13528,1387,0,32214
2008,Pakistan,Palai,241,552,0,311,875,59,0,2038,252,577,0,322,953,81,0,2185
2008,Pakistan,Padhana,477,1419,0,803,2047,138,0,4884,493,1533,0,900,2330,263,0,5519
2008,Pakistan,Orakzai,103,161,0,106,362,25,0,757,111,172,0,132,426,34,0,875
2008,Pakistan,Old Shamshatoo,2463,7490,0,5164,12412,571,0,28100,2598,7843,0,5737,13346,1149,0,30673
2008,Pakistan,Old Akora,1536,5101,0,3016,7954,285,0,17892,1675,5269,0,3484,8548,889,0,19865
2008,Pakistan,Oblan,440,1308,0,780,1917,118,0,4563,481,1401,0,946,1990,243,0,5061
2008,Pakistan,North West Frontier Province,17186,50722,0,33572,98168,5057,0,204705,18186,54493,0,37905,105648,9776,0,226008
2008,Pakistan,New Akora,3,13,0,9,51,1,0,77,3,19,0,22,53,6,0,103
2008,Pakistan,Naurang,93,308,0,181,483,21,0,1086,89,386,0,189,477,62,0,1203
2008,Pakistan,Naguman,156,501,0,285,667,35,0,1644,168,540,0,295,685,77,0,1765
2008,Pakistan,Nagar,12,36,0,20,52,1,0,121,14,32,0,11,93,5,0,155
2008,Pakistan,N. Waziristan,2,1,0,0,2,0,0,5,1,3,0,0,2,0,0,6
2008,Pakistan,Munda,524,1600,0,973,2361,127,0,5585,506,1616,0,1050,2345,284,0,5801
2008,Pakistan,Mohmand,1223,1896,0,965,2907,156,0,7147,1296,2443,0,1314,3109,207,0,8369
2008,Pakistan,Mohammad Kheil,298,830,0,395,1277,65,0,2865,265,966,0,559,1309,190,0,3289
2008,Pakistan,Michni,8,29,0,19,37,3,0,96,5,26,0,16,53,6,0,106
2008,Pakistan,Mera Kachori,222,671,0,402,1089,67,0,2451,209,720,0,421,1137,103,0,2590
2008,Pakistan,Mayar,121,399,0,222,564,30,0,1336,119,353,0,253,645,59,0,1429
2008,Pakistan,Malgagai,285,896,0,487,1417,117,0,3202,314,973,0,668,1660,234,0,3849
2008,Pakistan,Lejay Karez,43,159,0,99,248,24,0,573,30,154,0,134,329,49,0,696
2008,Pakistan,Lakti Banda,370,1054,0,646,1650,177,0,3897,388,1076,0,697,1712,291,0,4164
2008,Pakistan,Kurram,329,574,0,460,1126,68,0,2557,380,609,0,484,1144,101,0,2718
2008,Pakistan,Kund/Khairabad,689,1664,0,835,2326,140,0,5654,687,1742,0,1032,2295,276,0,6032
2008,Pakistan,Kotwai,312,1041,0,563,1418,119,0,3453,337,1174,0,653,1512,204,0,3880
2008,Pakistan,Kotkai,207,714,0,452,1093,101,0,2567,252,706,0,548,1051,166,0,2723
2008,Pakistan,Kot Chandna,688,2088,0,1339,3048,184,0,7347,710,2120,0,1346,3181,333,0,7690
2008,Pakistan,Kohat,47,86,0,97,336,34,0,600,43,102,0,103,344,45,0,637
2008,Pakistan,Koga,538,1442,0,863,2199,129,0,5171,552,1539,0,914,2071,211,0,5287
2008,Pakistan,Khyber,6,8,0,7,21,2,0,44,10,16,0,8,27,5,0,66
2008,Pakistan,Khurasan,180,592,0,433,1369,89,0,2663,192,626,0,436,1490,125,0,2869
2008,Pakistan,Khoughani,56,205,0,146,349,10,0,766,61,203,0,155,364,25,0,808
2008,Pakistan,Kheshki,27,76,0,38,109,6,0,256,19,81,0,51,117,16,0,284
2008,Pakistan,Khazana,246,778,0,436,1150,69,0,2679,261,856,0,532,1274,123,0,3046
2008,Pakistan,Khaki,717,2191,0,1482,3169,201,0,7760,782,2273,0,1685,3168,342,0,8250
2008,Pakistan,Kesu,47,107,0,92,193,8,0,447,53,162,0,85,229,14,0,543
2008,Pakistan,Kata Kanri,325,827,0,531,1255,105,0,3043,342,863,0,534,1283,181,0,3203
2008,Pakistan,Karachi,1,5,0,15,17,0,0,38,0,3,0,8,25,0,0,36
2008,Pakistan,Kalatak,63,179,0,98,279,10,0,629,77,217,0,141,375,27,0,837
2008,Pakistan,Kaghan,129,281,0,167,429,17,0,1023,136,320,0,184,434,34,0,1108
2008,Pakistan,Kacha Gari,879,2943,0,1808,4808,246,0,10684,888,3271,0,2305,6958,448,0,13870
2008,Pakistan,Kababian,461,1492,0,913,2396,77,0,5339,468,1531,0,1011,2706,236,0,5952
2008,Pakistan,Jerma,51,146,0,88,243,16,0,544,45,162,0,134,300,27,0,668
2008,Pakistan,Jalozai,1245,3680,0,2476,6991,389,0,14781,1354,3697,0,2744,8864,715,0,17374
2008,Pakistan,Jalala,607,1860,0,1105,2958,169,0,6699,683,1965,0,1307,3144,317,0,7416
2008,Pakistan,Islamabad,1445,3815,0,2348,7010,386,0,15004,1482,4102,0,2933,8625,794,0,17936
2008,Pakistan,Ichirian,351,990,0,594,1522,94,0,3551,350,954,0,689,1791,180,0,3964
2008,Pakistan,Hangu,4,8,0,1,14,2,0,29,7,5,0,6,16,0,0,34
2008,Pakistan,Girsal,0,1,0,0,2,0,0,3,0,3,0,0,3,0,0,6
2008,Pakistan,Girdi Jungle,1454,3441,0,1616,5533,805,0,12849,1319,3525,0,2395,8521,1108,0,16868
2008,Pakistan,Ghulam Banda,379,1060,0,706,1646,77,0,3868,373,1193,0,736,1868,200,0,4370
2008,Pakistan,Ghiljo,78,264,0,170,403,17,0,932,121,281,0,178,415,44,0,1039
2008,Pakistan,Ghazi,9,38,0,12,58,4,0,121,20,42,0,21,65,8,0,156
2008,Pakistan,Ghazgai Minara,112,336,0,161,440,34,0,1083,103,394,0,239,535,67,0,1338
2008,Pakistan,Gandhi Khan Khel,166,530,0,294,782,54,0,1826,166,556,0,329,769,101,0,1921
2008,Pakistan,Gandaf,635,1636,0,1068,2481,165,0,5985,636,1849,0,1088,2833,268,0,6674
2008,Pakistan,Gamkol,1446,4400,0,2533,6614,371,0,15364,1470,4599,0,3220,8111,735,0,18135
2008,Pakistan,Gambila,80,293,0,113,436,20,0,942,74,308,0,180,455,65,0,1082
2008,Pakistan,Domshivgar,13,25,0,19,39,2,0,98,3,30,0,21,55,6,0,115
2008,Pakistan,Dodpa,21,40,0,16,57,3,0,137,13,45,0,28,72,5,0,163
2008,Pakistan,Doaba,289,958,0,534,1585,133,0,3499,312,955,0,631,1849,244,0,3991
2008,Pakistan,Dir Upper,2,5,0,1,6,0,0,14,4,3,0,3,8,1,0,19
2008,Pakistan,Dir Lower,13,15,0,10,34,2,0,74,13,20,0,15,32,3,0,83
2008,Pakistan,Darsamand,277,705,0,419,1288,107,0,2796,280,780,0,480,1495,190,0,3225
2008,Pakistan,Daraban,4,8,0,6,15,0,0,33,4,10,0,4,18,2,0,38
2008,Pakistan,Dara Adam Khel,55,132,0,95,235,20,0,537,68,146,0,97,286,34,0,631
2008,Pakistan,Dabara,92,347,0,144,549,32,0,1164,136,434,0,290,1006,84,0,1950
2008,Pakistan,Chichana,145,508,0,294,852,58,0,1857,154,510,0,397,1130,131,0,2322
2008,Pakistan,Charsadda,14,26,0,16,33,3,0,92,18,21,0,19,37,0,0,95
2008,Pakistan,Chakdara,1000,2235,0,1371,3071,187,0,7864,1108,2329,0,1455,3373,298,0,8563
2008,Pakistan,Chagai,16,33,0,21,59,5,0,134,16,39,0,31,68,6,0,160
2008,Pakistan,Bizen Khel,46,216,0,127,322,15,0,726,66,255,0,144,355,49,0,869
2008,Pakistan,Basu Mera,243,740,0,461,1165,57,0,2666,256,797,0,479,1123,137,0,2792
2008,Pakistan,Barawal,13,52,0,24,72,5,0,166,21,56,0,21,88,7,0,193
2008,Pakistan,Barary,348,1035,0,696,1515,103,0,3697,374,1071,0,757,1690,168,0,4060
2008,Pakistan,Barari,10,36,0,28,56,3,0,133,13,40,0,21,65,6,0,145
2008,Pakistan,Barakai,1193,4032,0,2427,6041,316,0,14009,1325,4173,0,2746,5920,678,0,14842
2008,Pakistan,Balochistan,13367,38483,0,20609,61561,4531,0,138551,13898,41690,0,26677,75760,9010,0,167035
2008,Pakistan,Bakka Khel,29,123,0,49,170,11,0,382,40,150,0,81,254,24,0,549
2008,Pakistan,Bajaur,9554,15138,0,7314,21590,1004,0,54600,10571,18347,0,8759,21098,1342,0,60117
2008,Pakistan,Baghicha,22,91,0,69,141,14,0,337,24,94,0,57,178,22,0,375
2008,Pakistan,Badaber,1361,4357,0,2494,6181,305,0,14698,1460,4333,0,2729,6433,674,0,15629
2008,Pakistan,Azakhel,1115,3307,0,1970,5001,214,0,11607,1133,3583,0,2265,5229,441,0,12651
2008,Pakistan,Azad Kashmir,252,778,0,453,1210,48,0,2741,278,831,0,603,1611,138,0,3461
2008,Panama,Panama City,289,733,0,2057,3203,890,0,7172,302,795,0,2561,4790,1003,0,9451
2008,Panama,Kuna Yala,5,13,0,16,25,1,0,60,4,12,0,14,29,1,0,60
2008,Panama,Darien,68,72,0,74,159,14,0,387,68,58,0,63,171,25,0,385
2008,Philippines,Visayas,0,0,0,0,0,0,0,0,0,0,0,0,4,0,0,4
2008,Philippines,National Capital Region,0,2,0,1,16,0,0,19,0,1,0,5,145,0,0,151
2008,Philippines,Mindanao,0,0,0,0,0,0,0,0,0,0,0,0,5,0,0,5
2008,Philippines,Luzon,0,0,0,1,3,0,0,4,0,0,0,0,10,0,0,10
2008,Papua New Guinea,Vanimo,0,0,0,0,0,0,0,0,0,0,0,0,6,0,0,6
2008,Papua New Guinea,Port Moresby,0,0,0,0,0,0,0,0,0,0,0,0,4,0,0,4
2008,Papua New Guinea,East Awin,142,212,0,179,618,46,0,1197,142,243,0,206,661,51,0,1303
2008,Papua New Guinea,Daru,0,0,0,0,0,0,0,0,0,0,0,0,3,0,0,3
2008,Paraguay,Asunción,0,2,0,6,21,1,0,30,0,1,0,4,43,1,0,49
2008,Qatar,Doha,1,4,0,2,15,1,0,23,3,4,0,1,17,2,0,27
2008,Russian Federation,Saint Petersburg,2,3,0,4,18,0,0,27,1,2,0,7,44,0,0,54
2008,Russian Federation,Moscow,13,27,0,48,265,4,0,357,16,31,0,58,601,9,0,715
2008,Rwanda,Nyabiheke (Byumba),1451,1862,0,1250,2960,176,0,7699,1433,1810,0,1117,1626,122,0,6108
2008,Rwanda,Kiziba (Kibuye),1349,2115,0,2003,4230,413,0,10110,1232,2092,0,1745,2817,327,0,8213
2008,Rwanda,Kigeme (Gikongoro),224,207,0,153,415,22,0,1021,201,240,0,159,383,19,0,1002
2008,Rwanda,Kigali,149,211,0,190,407,7,0,964,134,213,0,183,380,8,0,918
2008,Rwanda,Gihembe (Byumba),1287,2467,0,1800,4437,398,0,10389,1327,2282,0,1710,3106,213,0,8638
2008,Saudi Arabia,Riyadh,7,45,0,30,90,5,0,177,7,41,0,44,165,10,0,267
2008,Saudi Arabia,Madina,1,1,0,0,1,0,0,3,0,0,0,0,3,0,0,3
2008,Saudi Arabia,Khobar,1,4,0,0,3,1,0,9,0,3,0,0,12,1,0,16
2008,Saudi Arabia,Jeddah,9,33,0,17,50,2,0,111,10,37,0,15,76,4,0,142
2008,Saudi Arabia,Arar,0,0,0,0,0,0,0,0,0,0,0,0,1,0,0,1
2008,Saudi Arabia,Al-Qateef,1,2,0,0,1,0,0,4,0,0,0,4,1,0,0,5
2008,Saudi Arabia,Al-Ihsa,0,0,0,0,0,0,0,0,0,0,0,0,1,0,0,1
2008,Sudan,"Yei, Ces",0,0,0,0,0,0,0,0,0,0,0,0,0,0,1,1
2008,Sudan,"Yei & Others, Ces",0,0,0,0,0,0,869,869,0,0,0,0,0,0,691,691
2008,Sudan,Yambio,207,0,0,462,775,51,0,1495,210,0,0,442,850,39,0,1541
2008,Sudan,"White Nile, White Nile",0,0,0,0,0,0,0,0,0,0,0,0,0,0,1,1
2008,Sudan,West Darfur,0,0,0,0,0,0,116000,116000,0,0,0,0,0,0,116000,116000
2008,Sudan,Wbgs & Warrab,0,0,0,0,0,0,4397,4397,0,0,0,0,0,0,4396,4396
2008,Sudan,"Wau, Wbgs",0,0,0,0,0,0,31,31,0,0,0,0,0,0,49,49
2008,Sudan,Wad Sherife Village,26,41,0,20,59,4,0,150,34,43,0,35,20,2,0,134
2008,Sudan,Wad Sherife,963,1204,0,1205,3923,396,0,7691,1016,1259,0,1123,2148,399,0,5945
2008,Sudan,Wad Medani,0,1,0,0,0,0,0,1,0,0,0,0,0,1,0,1
2008,Sudan,Wad El Hileau,0,3,0,0,1,0,0,4,1,1,0,0,2,0,0,4
2008,Sudan,"Various, Wes",0,0,0,0,0,0,33,33,0,0,0,0,0,0,26,26
2008,Sudan,"Various, Warrab",0,0,0,0,0,0,125,125,0,0,0,0,0,0,256,256
2008,Sudan,"Various, Ups",0,0,0,0,0,0,553,553,0,0,0,0,0,0,607,607
2008,Sudan,"Various, Uns",0,0,0,0,0,0,68,68,0,0,0,0,0,0,160,160
2008,Sudan,"Various, Sudan",0,0,0,0,0,0,3,3,0,0,0,0,0,0,4,4
2008,Sudan,"Various, Northern",0,0,0,0,0,0,1,1,0,0,0,0,0,0,3,3
2008,Sudan,"Various, Nbgs",0,0,0,0,0,0,78,78,0,0,0,0,0,0,80,80
2008,Sudan,"Various, Las",0,0,0,0,0,0,38,38,0,0,0,0,0,0,81,81
2008,Sudan,"Various, Krt",0,0,0,0,0,0,61,61,0,0,0,0,0,0,96,96
2008,Sudan,"Various, Kordofan",0,0,0,0,0,0,23,23,0,0,0,0,0,0,45,45
2008,Sudan,"Various, Ees",0,0,0,0,0,0,1094,1094,0,0,0,0,0,0,1194,1194
2008,Sudan,Um Shalaya,1064,0,0,949,1513,322,0,3848,964,0,0,989,731,169,0,2853
2008,Sudan,Um Gorjo,0,0,0,0,0,0,153,153,0,0,0,0,0,0,152,152
2008,Sudan,Um Gargur,488,720,0,669,2002,193,0,4072,525,824,0,735,1690,334,0,4108
2008,Sudan,Um Dukhun,0,0,0,0,0,0,4242,4242,0,0,0,0,0,0,4240,4240
2008,Sudan,"Twic East & Others, Jos",0,0,0,0,0,0,1807,1807,0,0,0,0,0,0,1736,1736
2008,Sudan,"Torit, Ees",0,0,0,0,0,0,1596,1596,0,0,0,0,0,0,1553,1553
2008,Sudan,Tendelti ,0,0,0,0,0,0,553,553,0,0,0,0,0,0,553,553
2008,Sudan,Suwakin,0,0,0,0,0,0,0,0,0,0,0,0,1,0,0,1
2008,Sudan,Shagarab Iii,348,506,0,357,1288,96,0,2595,336,480,0,340,786,156,0,2098
2008,Sudan,Shagarab Ii,410,555,0,406,1416,111,0,2898,415,612,0,440,965,175,0,2607
2008,Sudan,Shagarab I,671,956,0,652,2502,192,0,4973,710,1017,0,690,1788,307,0,4512
2008,Sudan,"Sennar, Ses",0,0,0,0,0,0,1,1,0,0,0,0,0,0,4,4
2008,Sudan,"Red Sea, Rss",0,0,0,0,0,0,2,2,0,0,0,0,0,0,2,2
2008,Sudan,Port Sudan,1,0,0,0,2,0,0,3,1,1,0,0,1,0,0,3
2008,Sudan,"Pochalla, Jos",0,0,0,0,0,0,1910,1910,0,0,0,0,0,0,670,670
2008,Sudan,"Pibor, Jos",0,0,0,0,0,0,222,222,0,0,0,0,0,0,301,301
2008,Sudan,"Nzara, Wes",69,0,0,115,299,19,0,502,70,0,0,141,324,25,0,560
2008,Sudan,Nyala,0,0,0,0,1,0,0,1,0,0,0,0,4,0,0,4
2008,Sudan,New Halfa,0,1,0,0,1,0,0,2,1,2,0,2,1,0,0,6
2008,Sudan,Mukjar,122,0,0,109,132,13,0,376,96,0,0,124,119,10,0,349
2008,Sudan,"Malakal, Ups",0,0,0,0,0,0,1007,1007,0,0,0,0,0,0,1006,1006
2008,Sudan,"Malakal, Uns",0,0,0,0,0,0,19,19,0,0,0,0,0,0,75,75
2008,Sudan,"Magwi, Ees",0,0,0,0,0,0,19654,19654,0,0,0,0,0,0,16594,16594
2008,Sudan,"Mabaan, Ups",0,0,0,0,0,0,2817,2817,0,0,0,0,0,0,1835,1835
2008,Sudan,"Kurmuk& Others, Bns",0,0,0,0,0,0,2247,2247,0,0,0,0,0,0,1964,1964
2008,Sudan,Kilo 7,24,28,0,21,121,13,0,207,26,34,0,32,105,20,0,217
2008,Sudan,Kilo 26,478,652,0,564,1909,157,0,3760,527,658,0,590,1346,252,0,3373
2008,Sudan,Khartoum,271,2058,0,0,5613,148,343700,351790,238,2098,0,0,7535,280,346300,356451
2008,Sudan,"Kassala & Others, Kas",0,0,0,0,0,0,4,4,0,0,0,0,0,0,10,10
2008,Sudan,Kassala,11,8,0,9,28,1,0,57,8,16,0,9,6,1,0,40
2008,Sudan,Karkora,0,0,0,4,1,1,0,6,0,1,0,0,2,0,0,3
2008,Sudan,"Kajo Keji, Ces",0,0,0,0,0,0,1600,1600,0,0,0,0,0,0,1234,1234
2008,Sudan,"Juba, Ces",0,0,0,0,0,0,2526,2526,0,0,0,0,0,0,2111,2111
2008,Sudan,"Juba County, Ces",0,0,0,0,0,0,663,663,0,0,0,0,0,0,1031,1031
2008,Sudan,"Ibba, Wes",29,0,0,67,121,2,0,219,27,0,0,63,92,9,0,191
2008,Sudan,Habila Area,0,0,0,0,0,0,7500,7500,0,0,0,0,0,0,7500,7500
2008,Sudan,Gulsa,0,3,0,1,3,0,0,7,2,0,0,0,0,0,0,2
2008,Sudan,Girba,344,465,0,373,1439,130,0,2751,393,471,0,407,895,203,0,2369
2008,Sudan,Gedaref,4,2,0,1,4,0,0,11,3,2,0,0,0,0,0,5
2008,Sudan,Fau V,50,79,0,45,217,16,0,407,65,79,0,46,191,29,0,410
2008,Sudan,Fau City,0,1,0,0,1,0,0,2,2,1,0,0,0,0,0,3
2008,Sudan,Fath El Rahman,12,22,0,27,75,15,0,151,10,22,0,20,56,18,0,126
2008,Sudan,"Ezo, Wes",0,0,0,0,0,0,159,159,0,0,0,0,0,0,153,153
2008,Sudan,"El Gazira & Others, Jes",0,0,0,0,0,0,3,3,0,0,0,0,0,0,11,11
2008,Sudan,Ees,0,0,0,0,0,0,11857,11857,0,0,0,0,0,0,11856,11856
2008,Sudan,Doka,0,0,0,0,1,0,0,1,0,0,0,0,0,0,0,0
2008,Sudan,Cor/Kht,0,0,0,0,8974,0,0,8974,0,0,0,0,8971,0,0,8971
2008,Sudan,"Chali, Bns",0,0,0,0,0,0,329,329,0,0,0,0,0,0,276,276
2008,Sudan,Ces,0,0,0,0,0,0,28801,28801,0,0,0,0,0,0,28801,28801
2008,Sudan,"Bor, Jos",0,0,0,0,0,0,4444,4444,0,0,0,0,0,0,4229,4229
2008,Sudan,Blue Nile,0,0,0,0,0,0,10000,10000,0,0,0,0,0,0,10000,10000
2008,Sudan,Bir Saleeba Area,0,0,0,0,0,0,3000,3000,0,0,0,0,0,0,3000,3000
2008,Sudan,Awad El Sid,34,48,0,37,161,13,0,293,43,60,0,47,118,31,0,299
2008,Sudan,Arwa,0,0,0,0,0,0,248,248,0,0,0,0,0,0,248,248
2008,Sudan,Armankul ,0,0,0,0,0,0,1316,1316,0,0,0,0,0,0,1316,1316
2008,Sudan,Abuda,173,259,0,222,656,51,0,1361,161,279,0,224,504,82,0,1250
2008,Senegal,Podor,791,1053,0,890,1572,367,0,4673,710,1108,0,560,1421,331,0,4130
2008,Senegal,Matam,1240,1648,0,1460,2397,462,0,7207,719,1155,0,895,2032,357,0,5158
2008,Senegal,Dakar/Thies,38,52,0,45,161,26,0,322,26,161,0,45,52,39,0,323
2008,Senegal,Dakar,40,47,0,70,902,23,0,1082,53,88,0,78,2262,32,0,2513
2008,Senegal,Dagana,379,471,0,681,1169,240,0,2940,302,480,0,473,1005,197,0,2457
2008,Senegal,Bakel,496,588,0,441,975,221,0,2721,424,572,0,293,869,203,0,2361
2008,Singapore,Singapore,0,0,0,0,3,0,0,3,0,0,0,0,7,0,0,7
2008,Sierra Leone,Tobanda,15,78,0,19,124,9,0,245,22,87,0,29,75,6,0,219
2008,Sierra Leone,Taiama,77,61,0,81,119,4,0,342,39,63,0,42,89,3,0,236
2008,Sierra Leone,Largo,51,64,0,34,59,12,0,220,44,28,0,12,62,5,0,151
2008,Sierra Leone,Kenema,87,163,0,134,591,21,0,996,38,83,0,54,402,49,0,626
2008,Sierra Leone,Jimmi Bagbo,27,35,0,19,95,5,0,181,3,47,0,33,136,4,0,223
2008,Sierra Leone,Jembe,33,22,0,27,69,2,0,153,48,66,0,17,79,4,0,214
2008,Sierra Leone,Gondama,94,150,0,82,326,9,0,661,55,173,0,112,102,6,0,448
2008,Sierra Leone,Gerihun,39,16,0,10,87,9,0,161,4,15,0,48,72,6,0,145
2008,Sierra Leone,Freetown,26,140,0,160,575,24,0,925,70,117,0,171,578,20,0,956
2008,Sierra Leone,Bo,25,90,0,78,259,7,0,459,24,48,0,62,201,10,0,345
2008,Sierra Leone,Bandajuma,15,33,0,12,66,4,0,130,10,23,0,15,66,5,0,119
2008,El Salvador,San Salvador,0,0,0,0,1,1,0,2,0,0,0,0,4,1,0,5
2008,El Salvador,La Unión,0,0,0,0,7,0,0,7,0,0,0,0,13,2,0,15
2008,El Salvador,Cuscatlán,0,0,0,0,1,0,0,1,0,1,0,0,1,0,0,2
2008,Somalia,Woqooyi Galbeed,9636,9072,0,5763,16889,1464,0,42824,9057,9330,0,5861,15607,1315,0,41170
2008,Somalia,South/Central,125350,118810,0,76300,216910,19620,0,556990,117720,122080,0,77390,198380,17440,0,533010
2008,Somalia,Puntland,12199,11555,0,7426,21128,1908,46,54262,11459,11874,0,7538,19381,1696,80,52028
2008,Serbia and Kosovo (S/RES/1244 (1999)),Vojvodina,26,1434,0,2271,16579,10156,0,30466,34,1578,0,2453,19561,6223,0,29849
2008,Serbia and Kosovo (S/RES/1244 (1999)),Serbia (excluding Kosovo),2000,2000,0,2500,1700,300,0,8500,2000,2000,0,2500,1700,300,0,8500
2008,Serbia and Kosovo (S/RES/1244 (1999)),Kosovo,19,42,0,40,206,66,9561,9934,21,45,0,48,256,56,11296,11722
2008,Serbia and Kosovo (S/RES/1244 (1999)),Central and Southern Serbia,13,4543,0,6598,37015,13063,0,61232,11,4876,0,6891,37480,10577,0,59835
2008,Serbia and Kosovo (S/RES/1244 (1999)),Belgrade area and west of Serbia,51,3858,0,5907,35886,16050,0,61752,46,4089,0,6347,37782,10991,0,59255
2008,Suriname,Paramaribo,0,0,0,0,0,0,0,0,0,0,0,0,1,0,0,1
2008,Slovakia,Rohovce,1,3,0,0,9,0,0,13,4,3,0,10,17,0,0,34
2008,Slovakia,Private/detention,0,0,0,0,0,0,0,0,0,0,0,2,15,0,0,17
2008,Slovakia,Opatovská,0,0,0,0,1,0,0,1,1,1,0,0,39,1,0,42
2008,Slovakia,Integration centre Zvolen,1,0,0,0,2,0,0,3,0,0,0,0,9,0,0,9
2008,Slovakia,Humenne,0,0,0,0,3,0,0,3,2,0,0,2,36,0,0,40
2008,Slovakia,Gabčíkovo,0,1,0,0,2,0,0,3,0,9,0,2,16,0,0,27
2008,Slovenia,Ljubljana,0,0,0,0,20,0,0,20,0,0,0,3,41,0,0,44
2008,Swaziland,Malindza,14,11,0,11,45,0,0,81,18,15,0,21,83,0,0,137
2008,Syrian Arab Rep.,Al-Tanf,48,68,0,39,209,20,0,384,50,55,0,60,241,21,0,427
2008,Syrian Arab Rep.,Al-Hol,29,32,0,14,76,6,0,157,31,37,0,19,95,2,0,184
2008,Chad,Yaroungou,1156,1764,0,1100,3058,230,0,7308,1057,1930,0,951,2161,166,0,6265
2008,Chad,Treguine,1798,1889,0,1253,3791,360,0,9091,1818,1828,0,1315,2294,314,0,7569
2008,Chad,Touloum,1802,4334,0,1958,5246,614,0,13954,1836,3777,0,1774,2252,328,0,9967
2008,Chad,Sannour,61,87,0,43,139,9,0,339,79,95,0,44,74,13,0,305
2008,Chad,Oure-Cassoni,2035,5167,0,2074,6636,569,0,16481,2120,4647,0,1536,2373,273,0,10949
2008,Chad,N'Djamena,27,24,0,8,65,1,0,125,28,25,0,11,181,7,0,252
2008,Chad,Moula,637,530,0,401,1045,53,0,2666,688,580,0,468,919,51,0,2706
2008,Chad,Mile,1382,2824,0,1214,3853,430,0,9703,1430,2568,0,1155,2035,285,0,7473
2008,Chad,Kounongou,1751,3032,0,1284,4228,307,0,10602,1727,2874,0,1280,1783,248,0,7912
2008,Chad,Koubigou,1231,1950,0,984,2115,139,0,6419,1059,1779,0,770,787,89,0,4484
2008,Chad,Koloma,787,1179,0,587,1518,155,0,4226,747,1306,0,575,1120,147,0,3895
2008,Chad,Kerfi,467,687,0,293,853,88,0,2388,468,719,0,291,532,64,0,2074
2008,Chad,Iridimi,1577,3221,0,1431,3913,519,0,10661,1604,3050,0,1410,1646,273,0,7983
2008,Chad,Habile3,1075,2497,0,1275,2382,250,0,7479,1054,2298,0,1162,1338,207,0,6059
2008,Chad,Habile2,1039,1920,0,790,1747,215,0,5711,1060,1673,0,592,971,154,0,4450
2008,Chad,Habile1,1039,1719,0,737,1775,193,0,5463,1065,1680,0,614,827,158,0,4344
2008,Chad,Goz Amer,2473,2442,0,1398,4510,496,0,11319,2550,2542,0,1315,2721,388,0,9516
2008,Chad,Gouroukoun,2074,2995,0,1284,3324,296,0,9973,1964,2807,0,1107,1498,214,0,7590
2008,Chad,Goundiang,81,134,0,77,216,16,0,524,84,111,0,56,110,21,0,382
2008,Chad,Gondje,1064,2077,0,975,2552,88,0,6756,1036,2017,0,1046,1781,64,0,5944
2008,Chad,Gassire,2028,2955,0,1452,3356,274,0,10065,1928,2889,0,1146,1611,260,0,7834
2008,Chad,Ganachour,231,345,0,132,412,25,0,1145,210,334,0,179,258,45,0,1026
2008,Chad,Gaga,2638,2652,0,1146,4471,325,0,11232,2466,2698,0,1279,2670,253,0,9366
2008,Chad,Farchana,1966,2637,0,1629,4948,472,0,11652,1908,2579,0,1627,2702,315,0,9131
2008,Chad,Dosseye,927,1372,0,680,1703,91,0,4773,921,1267,0,531,970,94,0,3783
2008,Chad,Djabal,1882,2128,0,1208,3716,317,0,9251,1882,2224,0,1113,2197,257,0,7673
2008,Chad,Canton Wadi Kadja,814,1057,0,533,2249,163,0,4816,838,1097,0,400,1133,187,0,3655
2008,Chad,Canton Signar Dadjo,167,240,0,144,463,33,0,1047,172,279,0,89,195,32,0,767
2008,Chad,Canton Signar,384,647,0,303,1121,166,0,2621,361,590,0,260,551,104,0,1866
2008,Chad,Canton Dogdore Et Residents,130,160,0,92,337,27,0,746,133,155,0,73,192,40,0,593
2008,Chad,Canton Barh Azoum Ambrouine,558,730,0,436,1551,121,0,3396,644,767,0,323,720,148,0,2602
2008,Chad,Canton Barh Azoum,476,669,0,342,1330,124,0,2941,547,783,0,321,663,86,0,2400
2008,Chad,Bredjing,3136,3598,0,2463,7436,661,0,17294,3194,3582,0,2620,4646,533,0,14575
2008,Chad,Arkoum,617,1056,0,516,1591,152,0,3932,621,926,0,442,754,108,0,2851
2008,Chad,Aradib2,377,675,0,327,683,70,0,2132,403,623,0,240,472,64,0,1802
2008,Chad,Aradib1,1310,2440,0,1199,2391,295,0,7635,1263,2282,0,1099,1291,216,0,6151
2008,Chad,Amboko,902,2021,0,1135,2286,105,0,6449,827,1891,0,1251,1514,125,0,5608
2008,Chad,Alacha-Alentours,158,263,0,144,471,40,0,1076,162,221,0,124,188,34,0,729
2008,Chad,Ade,1254,2369,0,1281,3486,148,0,8538,1408,2636,0,1497,2477,229,0,8247
2008,Togo,Lome,1663,2067,0,907,3103,125,0,7865,1751,1491,0,728,2216,42,0,6228
2008,Thailand,Umpium,870,1218,0,1045,3602,264,0,6999,885,1221,0,1165,3544,237,0,7052
2008,Thailand,Tham Hin,378,463,0,427,1185,123,0,2576,424,462,0,411,1082,123,0,2502
2008,Thailand,Nu Po,737,979,0,822,2712,215,0,5465,804,937,0,885,2820,202,0,5648
2008,Thailand,Mai Nai Soi,1355,1793,0,1326,4482,449,0,9405,1550,1758,0,1315,4832,451,0,9906
2008,Thailand,Mae Sot,158,313,0,275,1301,50,0,2097,162,365,0,318,1712,50,0,2607
2008,Thailand,Mae Ra Ma Luang,721,1096,0,860,2623,244,0,5544,694,1173,0,907,2691,295,0,5760
2008,Thailand,Mae La Oon,922,1226,0,960,3117,268,0,6493,1042,1335,0,1030,3287,291,0,6985
2008,Thailand,Mae La,2258,3007,0,2491,7883,840,0,16479,2337,3177,0,2645,7500,724,0,16383
2008,Thailand,Bangkok,158,234,0,222,1704,32,0,2350,177,277,0,221,3388,53,0,4116
2008,Thailand,Ban Mae Surin,228,287,0,257,868,61,0,1701,223,326,0,236,907,76,0,1768
2008,Thailand,Ban Don Yang,280,318,0,296,899,77,0,1870,297,325,0,310,800,72,0,1804
2008,Tajikistan,Dushanbe,1,0,0,3,13,0,0,17,3,1,0,1,15,3,0,23
2008,Turkmenistan,Turkmenbashi,0,0,0,0,5,4,0,9,0,0,0,2,2,1,0,5
2008,Turkmenistan,Turkmenabad,1,1,0,5,5,0,0,12,0,0,0,2,9,0,0,11
2008,Turkmenistan,Ashgabat,0,0,0,2,13,3,0,18,0,4,0,3,16,0,0,23
2008,Turkmenistan,Abadan,0,0,0,0,1,0,0,1,0,0,0,0,0,0,0,0
2008,Timor-Leste,Dili,0,0,0,0,0,0,0,0,0,0,0,0,17,0,0,17
2008,Trinidad and Tobago,Port of Spain,0,0,0,1,11,0,0,12,2,4,0,2,112,0,0,120
2008,Tunisia,Tunis,4,1,0,1,27,6,0,39,1,3,0,3,81,5,0,93
2008,Tunisia,Sousse,0,0,0,0,0,0,0,0,0,0,0,0,2,0,0,2
2008,Tunisia,Sfax,0,1,0,0,1,0,0,2,1,1,0,0,1,0,0,3
2008,Tunisia,Monastir,0,0,0,0,2,0,0,2,0,0,0,0,2,1,0,3
2008,Tunisia,Bizerte,0,0,0,0,1,0,0,1,0,0,0,0,0,0,0,0
2008,Turkey,Yozgat Camp,4,3,0,2,13,0,0,22,5,1,0,4,6,0,0,16
2008,Turkey,Yozgat,9,7,0,6,27,2,0,51,1,8,0,4,49,0,0,62
2008,Turkey,Van,185,217,0,176,778,20,0,1376,200,249,0,305,1228,26,0,2008
2008,Turkey,Unknown,2,5,0,4,20,0,0,31,1,4,0,6,35,1,0,47
2008,Turkey,Tokat,29,24,0,27,129,8,0,217,29,37,0,37,162,8,0,273
2008,Turkey,Sivas,28,34,0,24,163,8,0,257,23,31,0,39,175,12,0,280
2008,Turkey,Sirnak,4,5,0,5,14,0,0,28,4,4,0,6,44,1,0,59
2008,Turkey,Silopi,0,0,0,0,1,0,0,1,2,1,0,0,12,0,0,15
2008,Turkey,Samsun,0,0,0,0,0,0,0,0,0,0,0,0,1,0,0,1
2008,Turkey,Nigde,12,29,0,20,113,12,0,186,15,19,0,30,93,10,0,167
2008,Turkey,Nevsehir,14,35,0,29,201,5,0,284,12,25,0,39,227,9,0,312
2008,Turkey,Mugla,0,0,0,0,0,0,0,0,0,0,0,0,1,0,0,1
2008,Turkey,Mersin,3,2,0,2,16,2,0,25,2,1,0,0,19,3,0,25
2008,Turkey,Mardin,1,2,0,0,5,1,0,9,1,0,0,0,3,1,0,5
2008,Turkey,Manisa,0,0,0,0,0,0,0,0,0,0,0,0,3,0,0,3
2008,Turkey,Kutahya,16,25,0,12,82,1,0,136,11,20,0,24,90,2,0,147
2008,Turkey,Konya,35,60,0,58,179,3,0,335,45,54,0,50,199,3,0,351
2008,Turkey,Kocaeli,0,0,0,0,1,0,0,1,0,0,0,0,2,0,0,2
2008,Turkey,Kirsehir,18,33,0,18,121,9,0,199,15,32,0,34,166,9,0,256
2008,Turkey,Kirklareli,1,0,0,1,6,0,0,8,0,0,0,1,9,0,0,10
2008,Turkey,Kirikkale,1,2,0,2,15,0,0,20,6,2,0,4,18,0,0,30
2008,Turkey,Kilis,1,1,0,0,4,0,0,6,2,0,0,0,9,0,0,11
2008,Turkey,Kayseri,19,47,0,52,326,27,0,471,26,44,0,68,327,19,0,484
2008,Turkey,Kastamonu,22,20,0,8,72,4,0,126,11,18,0,20,109,1,0,159
2008,Turkey,Karaman,16,15,0,12,75,3,0,121,16,33,0,14,123,1,0,187
2008,Turkey,K.Maras,0,0,0,0,0,0,0,0,0,0,0,0,2,0,0,2
2008,Turkey,Izmit,0,0,0,0,0,0,0,0,0,0,0,0,2,0,0,2
2008,Turkey,Izmir,1,2,0,3,38,0,0,44,3,3,0,7,137,0,0,150
2008,Turkey,Istanbul,119,171,0,127,709,43,0,1169,163,170,0,200,1057,46,0,1636
2008,Turkey,Isparta,22,17,0,37,133,1,0,210,17,25,0,51,182,1,0,276
2008,Turkey,Iskenderun,0,0,0,0,0,0,0,0,0,0,0,0,1,0,0,1
2008,Turkey,Hatay,9,2,0,9,35,3,0,58,5,7,0,6,83,0,0,101
2008,Turkey,Hakkari,1,1,0,0,11,0,0,13,1,1,0,0,16,0,0,18
2008,Turkey,Gaziantep,56,61,0,30,197,6,0,350,52,63,0,56,350,7,0,528
2008,Turkey,Eskisehir,23,30,0,25,190,5,0,273,25,35,0,46,259,7,0,372
2008,Turkey,Erzurum,0,0,0,0,0,0,0,0,0,0,0,0,1,0,0,1
2008,Turkey,Edirne,0,0,0,0,0,0,0,0,0,1,0,0,19,0,0,20
2008,Turkey,Corum,23,23,0,17,105,5,0,173,21,32,0,25,132,6,0,216
2008,Turkey,Cankiri,18,15,0,12,75,3,0,123,14,27,0,18,122,4,0,185
2008,Turkey,Canakkale,0,0,0,1,1,0,0,2,1,2,0,1,1,0,0,5
2008,Turkey,Bursa,0,0,0,0,1,0,0,1,0,0,0,0,6,0,0,6
2008,Turkey,Burdur,18,17,0,12,73,0,0,120,9,13,0,11,76,1,0,110
2008,Turkey,Border,0,1,0,0,0,0,0,1,0,0,0,0,0,0,0,0
2008,Turkey,Bilecik,8,14,0,9,79,4,0,114,15,18,0,14,79,6,0,132
2008,Turkey,Balikesir,0,0,0,0,0,0,0,0,0,0,0,0,1,0,0,1
2008,Turkey,Antalya,0,0,0,0,2,1,0,3,0,0,0,0,1,1,0,2
2008,Turkey,Ankara,21,36,0,30,155,9,0,251,23,44,0,55,255,12,0,389
2008,Turkey,Amasya,23,56,0,38,177,8,0,302,37,56,0,43,232,8,0,376
2008,Turkey,Aksaray,19,27,0,31,117,6,0,200,21,28,0,22,165,7,0,243
2008,Turkey,Agri,6,4,0,9,35,0,0,54,12,15,0,21,50,2,0,100
2008,Turkey,Afyon,70,67,0,59,361,26,0,583,73,76,0,66,507,22,0,744
2008,Turkey,Adapazari,0,0,0,0,2,0,0,2,0,0,0,0,4,0,0,4
2008,Turkey,Adana,0,2,0,0,5,0,0,7,0,0,0,1,5,0,0,6
2008,United Rep. of Tanzania,Chogo,125,200,0,250,330,32,0,937,83,98,0,110,269,25,0,585
2008,United Rep. of Tanzania,Old Settlements,18371,25252,0,10403,42321,3626,0,99973,18153,15351,0,19517,37932,3634,0,94587
2008,United Rep. of Tanzania,Nyarugusu,4426,5114,0,5263,10699,472,0,25974,4391,4312,0,5959,8617,375,0,23654
2008,United Rep. of Tanzania,Mtabila,4007,3845,0,4470,9693,281,0,22296,4145,3835,0,4789,9848,334,0,22951
2008,United Rep. of Tanzania,Lugufu,2732,2812,0,3033,6200,247,0,15024,2687,2915,0,3027,5164,178,0,13971
2008,United Rep. of Tanzania,Kanembwa,112,132,0,245,530,29,0,1048,130,337,0,287,383,26,0,1163
2008,Uganda,Rhino Camp,406,684,0,493,1237,71,0,2891,395,714,0,580,946,56,0,2691
2008,Uganda,Oruchinga,216,264,0,143,455,22,0,1100,195,260,0,140,448,24,0,1067
2008,Uganda,Nakivale,4430,4645,0,2312,8914,302,0,20603,4493,4506,0,2548,9636,327,0,21510
2008,Uganda,Moyo,931,1476,0,914,2802,188,0,6311,961,1569,0,930,2016,108,0,5584
2008,Uganda,Matanda,1319,1114,0,576,2573,142,0,5724,1338,1081,0,657,2315,93,0,5484
2008,Uganda,Madi-Okollo,72,111,0,79,219,17,0,498,75,124,0,101,204,9,0,513
2008,Uganda,Kyriandongo,13,17,0,9,22,1,0,62,10,11,0,12,20,1,0,54
2008,Uganda,Kyangwali,1358,1616,0,1003,2652,181,0,6810,1374,1642,0,1065,2408,135,0,6624
2008,Uganda,Kyaka II,1660,1764,0,943,2971,230,0,7568,1555,1649,0,1053,2660,265,0,7182
2008,Uganda,Kiryandongo,394,538,0,358,1042,93,0,2425,384,551,0,380,976,67,0,2358
2008,Uganda,Kampala,900,1507,0,1438,4327,99,0,8271,955,1434,0,1358,6251,108,0,10106
2008,Uganda,Imvepi,399,837,0,625,1477,78,0,3416,496,942,0,1028,1537,34,0,4037
2008,Uganda,Ikafe,39,81,0,57,157,3,0,337,40,92,0,81,220,2,0,435
2008,Uganda,Adjumani,1528,2570,0,1768,5215,337,0,11418,1532,2549,0,1824,4173,218,0,10296
2008,Uruguay,Montevideo,0,2,0,6,34,7,0,49,7,4,0,6,109,9,0,135
2008,Uzbekistan,Termez,2,8,0,9,26,1,0,46,2,12,0,12,29,1,0,56
2008,Uzbekistan,Tashkent,26,77,0,15,197,14,0,329,30,45,0,67,238,10,0,390
2008,Venezuela (Bolivarian Republic of),Caracas,34,41,0,58,293,11,0,437,46,57,0,63,517,28,0,711
2008,Venezuela (Bolivarian Republic of),Zulia,227,285,0,224,721,36,26686,28179,253,279,0,227,935,59,29961,31714
2008,Venezuela (Bolivarian Republic of),Tachira,251,314,0,262,945,43,20116,21931,274,356,0,311,1117,52,21561,23671
2008,Venezuela (Bolivarian Republic of),Apure,236,344,0,282,810,60,7359,9091,270,340,0,285,855,82,7915,9747
2008,Venezuela (Bolivarian Republic of),Amazonas,1,5,0,5,12,1,1704,1728,0,6,0,9,14,0,1816,1845
2008,Viet Nam,Thu Duc,0,0,0,0,0,0,39,39,0,0,0,0,0,0,39,39
2008,Viet Nam,Ho Chi Minh City,0,0,0,0,0,0,3700,3700,0,0,0,0,0,0,3500,3500
2008,Viet Nam,Cu Chi,0,0,0,0,0,0,129,129,0,0,0,0,0,0,104,104
2008,Viet Nam,Binh Phuoc,0,0,0,0,0,0,130,130,0,0,0,0,0,0,131,131
2008,Viet Nam,Binh Duong,0,0,0,0,0,0,930,930,0,0,0,0,0,0,855,855
2008,Vanuatu,Port Vila,0,0,0,0,0,0,0,0,0,0,0,0,4,0,0,4
2008,Yemen,Taiz,59,179,0,179,690,185,0,1292,56,340,0,340,650,180,0,1566
2008,Yemen,Shabwa,15,28,0,29,151,6,0,229,12,22,0,22,171,2,0,229
2008,Yemen,Sana'a/Aden,15,19,0,13,190,30,0,267,19,19,0,20,320,24,0,402
2008,Yemen,Sana'a,610,1985,0,1900,6705,748,0,11948,544,1955,0,1926,6666,719,0,11810
2008,Yemen,Sada'a,2,8,0,8,25,4,0,47,3,15,0,15,55,5,0,93
2008,Yemen,Sa'dah,11217,12949,0,6194,25375,564,0,56299,10392,10488,0,5682,16701,438,0,43701
2008,Yemen,Rida'a,29,18,0,17,56,5,0,125,25,33,0,32,62,5,0,157
2008,Yemen,Mukalla,79,371,0,318,556,33,0,1357,53,264,0,424,514,34,0,1289
2008,Yemen,Mahra,32,62,0,61,157,7,0,319,32,70,0,70,182,7,0,361
2008,Yemen,Hodeidah,20,40,0,41,109,24,0,234,19,55,0,55,104,19,0,252
2008,Yemen,Dhamar,18,19,0,18,78,2,0,135,17,16,0,16,47,4,0,100
2008,Yemen,AL-Kharaz,1257,1259,0,671,2563,50,0,5800,1297,1257,0,697,2287,56,0,5594
2008,Yemen,Al-Baida,8,34,0,33,86,7,0,168,14,23,0,23,92,2,0,154
2008,Yemen,Aden,240,1534,0,1232,3311,385,0,6702,305,1359,0,1508,3636,324,0,7132
2008,Zambia,Mwange,1353,1834,0,724,3054,127,0,7092,1366,1827,0,755,3252,137,0,7337
2008,Zambia,Meheba,1661,1411,0,1201,3018,305,0,7596,1581,1364,0,1160,3709,353,0,8167
2008,Zambia,Mayukwayukwa,1075,1081,0,901,1971,163,0,5191,1010,1076,0,850,2074,273,0,5283
2008,Zambia,Kala,1231,1600,0,974,2623,69,0,6497,1248,1402,0,962,2588,71,0,6271
2008,Zimbabwe,Tongogara,248,303,0,175,523,11,0,1260,256,328,0,204,721,10,0,1519
2009,Afghanistan,Zabul,33,43,0,15,53,3,0,147,31,54,0,29,63,4,0,181
2009,Afghanistan,Wardak,29,62,0,57,166,1,0,315,23,57,0,53,154,15,0,302
2009,Afghanistan,Uruzgan,2,3,0,1,4,0,0,10,2,3,0,4,5,1,0,15
2009,Afghanistan,Takhar,118,183,0,81,257,14,0,653,136,174,0,86,301,26,0,723
2009,Afghanistan,Sari Pul,192,293,0,209,577,46,0,1317,244,350,0,253,564,70,0,1481
2009,Afghanistan,Samangan,56,93,0,46,164,9,0,368,52,87,0,52,162,17,0,370
2009,Afghanistan,Parwan,56,127,0,112,256,8,0,559,45,149,0,89,296,20,0,599
2009,Afghanistan,Panjsher,11,22,0,13,38,4,0,88,10,22,0,13,40,6,0,91
2009,Afghanistan,Paktya,58,181,0,106,273,14,0,632,61,152,0,114,203,29,0,559
2009,Afghanistan,Paktika,108,197,0,111,326,17,0,759,117,200,0,115,339,32,0,803
2009,Afghanistan,Nuristan,126,226,0,128,385,21,0,886,135,232,0,137,392,38,0,934
2009,Afghanistan,Nimroz,0,5,0,5,9,0,0,19,3,8,0,5,16,2,0,34
2009,Afghanistan,Nangarhar,4947,8974,0,4961,14838,789,0,34509,5234,9223,0,5378,15109,1448,0,36392
2009,Afghanistan,Logar,26,126,0,53,167,6,0,378,34,117,0,58,154,15,0,378
2009,Afghanistan,Laghman,528,924,0,514,1477,70,0,3513,559,963,0,549,1510,142,0,3723
2009,Afghanistan,Kunduz,591,820,0,406,1182,65,0,3064,622,798,0,401,1160,103,0,3084
2009,Afghanistan,Kunar,958,1717,0,962,2798,152,0,6587,1028,1787,0,1020,2848,271,0,6954
2009,Afghanistan,Khost,1895,3401,0,1914,5733,311,0,13254,2033,3505,0,2056,5871,574,0,14039
2009,Afghanistan,Kapisa,39,69,0,34,113,5,0,260,41,69,0,41,124,9,0,284
2009,Afghanistan,Kandahar,3345,5891,0,3225,9741,522,0,22724,3588,6154,0,3531,10076,985,0,24334
2009,Afghanistan,Kabul,698,1603,0,1038,3110,181,0,6630,805,1656,0,1126,2945,308,0,6840
2009,Afghanistan,Jawzjan,415,603,0,360,1297,86,0,2761,408,625,0,373,1244,148,0,2798
2009,Afghanistan,Hirat,3506,6153,0,3538,10546,595,0,24338,3684,6430,0,3811,11303,1056,0,26284
2009,Afghanistan,Hilmand,3768,6656,0,3731,11180,612,0,25947,4027,6935,0,4066,11485,1130,0,27643
2009,Afghanistan,Ghor,239,417,0,240,712,39,0,1647,250,440,0,259,745,70,0,1764
2009,Afghanistan,Ghazni,256,496,0,285,841,48,0,1926,282,515,0,298,866,85,0,2046
2009,Afghanistan,Faryab,565,938,0,535,1678,91,0,3807,604,977,0,571,1688,169,0,4009
2009,Afghanistan,Farah,5,9,0,5,16,2,0,37,6,10,0,7,24,1,0,48
2009,Afghanistan,Day Kundi,14,21,0,12,35,3,0,85,12,20,0,13,42,3,0,90
2009,Afghanistan,Bamyan,10,20,0,10,51,4,0,95,12,28,0,19,72,4,0,135
2009,Afghanistan,Balkh,125,166,0,119,352,33,0,795,131,169,0,98,369,53,0,820
2009,Afghanistan,Baghlan,218,380,0,200,566,33,0,1397,227,363,0,199,550,56,0,1395
2009,Afghanistan,Badghis,496,855,0,481,1435,80,0,3347,513,894,0,525,1482,140,0,3554
2009,Afghanistan,Badakhshan,4,3,0,3,12,0,0,22,8,11,0,6,69,3,0,97
2009,Angola,Zaire,0,0,0,0,0,0,8,8,0,0,0,0,0,0,13,13
2009,Angola,Various,110709,186730,0,181453,846310,125753,2933164,4384119,116808,194327,0,194996,1047938,117658,3065738,4737465
2009,Angola,Moxico,0,0,0,0,0,0,2346,2346,0,0,0,0,0,0,2871,2871
2009,Angola,Malange,0,0,0,0,0,0,391,391,0,0,0,0,0,0,487,487
2009,Angola,Lunda Sul,0,0,0,0,4,0,444,448,0,0,0,0,0,0,697,697
2009,Angola,Lunda Norte/Sul,0,0,0,0,0,0,165,165,0,0,0,0,0,0,727,727
2009,Angola,Lunda Norte,0,0,0,0,0,0,184,184,0,0,0,0,1,0,270,271
2009,Angola,Luanda,0,0,0,0,3,0,5469,5472,0,0,0,0,20,0,6105,6125
2009,Angola,Kuanza Sul,0,0,0,0,0,0,125,125,0,0,0,0,0,0,129,129
2009,Angola,Kuanza Norte,0,0,0,0,0,0,19,19,0,0,0,0,0,0,24,24
2009,Angola,Huila,0,0,0,0,0,0,0,0,0,0,0,0,0,0,7,7
2009,Angola,Huambo,0,0,0,0,0,0,3,3,0,0,0,0,0,0,40,40
2009,Angola,Bie,0,0,0,0,0,0,0,0,0,0,0,0,0,0,2,2
2009,Angola,Bengo,0,0,0,0,0,0,328,328,0,0,0,0,0,0,308,308
2009,Albania,Tirana,4,2,0,5,14,5,0,30,3,6,0,8,33,2,0,52
2009,Albania,Peshkopi,0,0,0,0,1,0,0,1,0,0,0,0,0,0,0,0
2009,Albania,Mamurras,2,0,0,0,1,0,0,3,1,0,0,0,0,0,0,1
2009,Albania,Fushe Kruje,1,0,0,0,0,0,0,1,1,0,0,0,1,0,0,2
2009,United Arab Emirates,Abu Dhabi,24,24,0,17,100,5,0,170,21,23,0,13,115,13,0,185
2009,Armenia,Yerevan,19,38,0,60,526,208,0,851,27,38,0,55,594,117,0,831
2009,Armenia,Yeghvard,0,0,0,0,13,2,0,15,0,0,0,0,12,2,0,14
2009,Armenia,Vedi,0,0,0,0,15,7,0,22,0,0,0,0,8,5,0,13
2009,Armenia,Vayots Dzor,0,0,0,0,3,0,0,3,0,0,0,0,4,0,0,4
2009,Armenia,Vardanis,0,0,0,0,2,2,0,4,0,0,0,0,2,1,0,3
2009,Armenia,Vanadzor,0,0,0,0,1,0,0,1,0,0,0,0,2,0,0,2
2009,Armenia,Vagharshapat,0,0,0,0,27,11,0,38,0,0,0,0,30,5,0,35
2009,Armenia,Tsakhkadzor,0,0,0,0,0,1,0,1,0,0,0,0,0,0,0,0
2009,Armenia,Tavush,0,0,0,0,30,22,0,52,0,0,0,0,33,14,0,47
2009,Armenia,Talin,0,0,0,0,13,5,0,18,0,0,0,0,10,3,0,13
2009,Armenia,Syunik,0,0,0,0,30,11,0,41,0,0,0,0,37,2,0,39
2009,Armenia,Stepanovan,0,0,0,0,6,2,0,8,0,0,0,0,11,0,0,11
2009,Armenia,Spitak,0,0,0,0,8,2,0,10,0,0,0,0,2,3,0,5
2009,Armenia,Sisian,0,0,0,0,1,1,0,2,0,0,0,0,0,0,0,0
2009,Armenia,Shirak,0,0,0,0,7,2,0,9,0,0,0,0,7,3,0,10
2009,Armenia,Shamshadinskiy (Berd),0,0,0,0,1,1,0,2,0,0,0,0,2,0,0,2
2009,Armenia,Sevan,0,0,0,0,5,2,0,7,0,0,0,0,2,2,0,4
2009,Armenia,Nor Hach,0,0,0,0,21,13,0,34,0,0,0,0,15,6,0,21
2009,Armenia,Noemberjan,0,0,0,0,1,1,0,2,0,0,0,0,1,1,0,2
2009,Armenia,Metsamor,0,0,0,0,8,9,0,17,0,0,0,1,12,3,0,16
2009,Armenia,Meghri,0,0,0,0,5,0,0,5,0,0,0,0,3,0,0,3
2009,Armenia,Masis,0,0,0,0,8,2,0,10,0,0,0,0,7,1,0,8
2009,Armenia,Martouni,0,0,0,0,2,1,0,3,0,0,0,0,0,0,0,0
2009,Armenia,Lori,0,0,0,0,34,12,0,46,0,0,0,0,44,7,0,51
2009,Armenia,Kotayk,0,0,0,0,100,64,0,164,0,0,0,1,124,30,0,155
2009,Armenia,Kapan,0,0,0,0,22,9,0,31,0,0,0,1,23,5,0,29
2009,Armenia,Kalinino (Tachir),0,0,0,0,0,1,0,1,0,0,0,0,1,1,0,2
2009,Armenia,Kajaran,0,0,0,0,8,4,0,12,0,0,0,0,3,1,0,4
2009,Armenia,Indjevan,0,0,0,0,1,0,0,1,0,0,0,0,2,1,0,3
2009,Armenia,Hrazdan,0,0,0,0,6,1,0,7,0,0,0,0,6,4,0,10
2009,Armenia,Gujumri,0,0,0,0,11,3,0,14,0,0,0,0,19,2,0,21
2009,Armenia,Goris,0,0,0,0,11,4,0,15,0,0,0,0,14,3,0,17
2009,Armenia,Gergharkunik,0,0,0,0,38,11,0,49,0,0,0,0,66,11,0,77
2009,Armenia,Gavar,0,0,0,0,1,1,0,2,0,0,0,0,1,0,0,1
2009,Armenia,Dilijan,0,0,0,0,4,7,0,11,0,0,0,0,4,1,0,5
2009,Armenia,Charentsavan,0,0,0,0,2,2,0,4,0,0,0,0,2,1,0,3
2009,Armenia,Chambarak,0,0,0,0,0,2,0,2,0,0,0,1,0,0,0,1
2009,Armenia,Byureghavan,0,0,0,1,17,10,0,28,0,0,0,0,19,6,0,25
2009,Armenia,Azizbekov (Vayk),0,0,0,0,1,0,0,1,0,0,0,0,0,0,0,0
2009,Armenia,Artik,0,0,0,0,2,0,0,2,0,0,0,0,0,0,0,0
2009,Armenia,Artashat,0,0,0,0,16,8,0,24,0,0,0,0,11,4,0,15
2009,Armenia,Armavir city,0,0,0,0,2,0,0,2,0,0,0,0,2,1,0,3
2009,Armenia,Armavir,0,0,0,0,21,20,0,41,0,0,0,0,18,8,0,26
2009,Armenia,Ararat,0,0,0,1,90,49,0,140,0,0,0,1,158,36,0,195
2009,Armenia,Aragatsotn,0,0,0,0,22,16,0,38,0,0,0,0,20,6,0,26
2009,Armenia,Aparan,0,0,0,0,1,1,0,2,0,0,0,0,1,0,0,1
2009,Armenia,Akhtala,0,0,0,0,1,0,0,1,0,0,0,0,0,0,0,0
2009,Armenia,Agarak,0,0,0,0,3,0,0,3,0,0,0,0,2,0,0,2
2009,Armenia,Achtarak,0,0,0,0,7,1,0,8,0,0,0,0,7,1,0,8
2009,Armenia,Abovjan (Kotashkent),0,0,0,0,23,19,0,42,0,0,0,0,30,7,0,37
2009,Azerbaijan,Baku,125,177,0,114,537,31,0,984,119,208,0,122,717,20,0,1186
2009,Burundi,Musasa,770,801,0,483,1263,54,0,3371,699,855,0,495,1128,24,0,3201
2009,Burundi,Kinama,1013,1242,0,718,1859,91,0,4923,1033,1221,0,737,1403,52,0,4446
2009,Burundi,Giharo,34,14,0,15,58,2,0,123,26,25,0,15,49,3,0,118
2009,Burundi,Bwagiriza,291,267,0,229,632,42,0,1461,324,284,0,233,564,30,0,1435
2009,Burundi,Bujumbura,649,1344,0,1125,3060,171,0,6349,680,1363,0,1183,2529,123,0,5878
2009,Benin,Kpomasse,9,14,0,11,85,2,0,121,12,18,0,22,106,3,0,161
2009,Benin,Cotonou,223,239,0,218,962,24,0,1666,213,278,0,177,1906,24,0,2598
2009,Benin,Agame,180,235,0,168,655,22,0,1260,212,280,0,166,853,12,0,1523
2009,Burkina Faso,Ouagadougou,44,68,0,56,228,2,0,398,25,55,0,55,520,5,0,660
2009,Bangladesh,Nayapara,1571,2056,0,1428,3701,147,0,8903,1551,2168,0,1294,3012,163,0,8188
2009,Bangladesh,Kutupalong,1063,1341,0,865,2368,109,0,5746,1101,1351,0,918,2040,95,0,5505
2009,Bangladesh,Dhaka,2,1,0,0,5,0,0,8,0,0,0,0,21,0,0,21
2009,Bulgaria,Sofia,11,17,0,5,105,10,0,148,12,34,0,29,619,11,0,705
2009,Bahrain,Manama,10,5,0,6,44,0,0,65,8,4,0,8,63,3,0,86
2009,Bosnia and Herzegovina,Brcko,1,1,0,1,12,2,0,17,0,1,0,2,11,2,0,16
2009,Bosnia and Herzegovina,Republika Srpska,0,135,0,273,2433,595,1581,5017,0,172,0,220,2444,636,1363,4835
2009,Bosnia and Herzegovina,Federacija Bosne i Hercegovine,15,32,0,31,77,5,4043,4203,20,29,0,21,91,5,3885,4051
2009,Belarus,Vitebsk Region,0,0,0,2,10,2,0,14,1,5,0,3,19,1,0,29
2009,Belarus,Mogilev Region,0,2,0,2,12,0,0,16,0,0,0,1,19,1,0,21
2009,Belarus,Minsk CIty,8,29,0,29,74,9,0,149,14,22,0,21,155,4,0,216
2009,Belarus,Minsk,5,6,0,6,34,2,0,53,5,9,0,5,43,2,0,64
2009,Belarus,Grodno Region,0,2,0,0,5,0,0,7,0,0,0,0,8,0,0,8
2009,Belarus,Gomel Region,0,3,0,3,16,6,0,28,4,4,0,3,33,4,0,48
2009,Belarus,Brest Region,0,0,0,0,0,0,0,0,0,0,0,0,6,1,0,7
2009,Belize,Belize  City,0,1,0,1,5,0,0,7,0,2,0,3,9,0,0,14
2009,Bolivia (Plurinational State of),Yapacani,0,2,0,2,2,0,0,6,1,0,0,1,3,0,0,5
2009,Bolivia (Plurinational State of),Tarija,0,0,0,0,1,0,0,1,0,0,0,0,1,0,0,1
2009,Bolivia (Plurinational State of),Sucre,0,0,0,0,0,0,0,0,0,0,0,0,1,0,0,1
2009,Bolivia (Plurinational State of),Santa Cruz,1,2,0,0,10,1,0,14,0,1,0,4,23,0,0,28
2009,Bolivia (Plurinational State of),Palos Blanco,0,1,0,0,2,0,0,3,0,1,0,0,3,0,0,4
2009,Bolivia (Plurinational State of),La Paz,0,1,0,26,112,4,0,143,3,10,0,27,174,7,0,221
2009,Bolivia (Plurinational State of),Cochabamba,2,3,0,7,11,0,0,23,0,3,0,4,24,0,0,31
2009,Bolivia (Plurinational State of),Beni,0,0,0,3,0,0,0,3,0,1,0,1,1,0,0,3
2009,Brazil,Sao Paulo,1,0,0,0,28,0,0,29,0,2,0,1,66,0,0,69
2009,Brazil,Roraima,0,0,0,0,0,0,0,0,0,0,0,0,2,0,0,2
2009,Brazil,Rio Grande do Sul,0,0,0,0,0,0,0,0,0,0,0,0,2,0,0,2
2009,Brazil,Rio Grande do Norte,1,1,0,0,1,0,0,3,0,0,0,0,1,0,0,1
2009,Brazil,Rio de Janeiro,0,0,0,0,3,0,0,3,1,0,0,0,12,0,0,13
2009,Brazil,Parana,0,2,0,0,1,0,0,3,1,0,0,0,7,1,0,9
2009,Brazil,Minas Gerais,0,0,0,0,0,0,0,0,0,0,0,0,4,0,0,4
2009,Brazil,Mato Grosso do Sul,0,0,0,0,1,0,0,1,0,0,0,0,0,0,0,0
2009,Brazil,Distrito Federal,0,0,0,0,0,0,0,0,0,0,0,0,1,0,0,1
2009,Brazil,Amazonas,2,5,0,7,58,1,1704,1777,3,6,0,10,66,0,1816,1901
2009,Brazil,Acre,0,0,0,0,0,0,0,0,0,0,0,0,1,0,0,1
2009,Botswana,Gaborone,21,6,0,13,46,0,0,86,20,4,0,13,170,1,0,208
2009,Botswana,Dukwi,187,241,0,163,507,34,0,1132,179,221,0,168,1198,36,0,1802
2009,Central African Rep.,Zemio,212,192,0,116,598,72,0,1190,213,206,0,117,641,113,0,1290
2009,Central African Rep.,Vakaga,185,990,0,3499,4620,231,0,9525,344,1320,0,1914,6645,252,0,10475
2009,Central African Rep.,Sam Ouandja,443,363,0,174,617,50,0,1647,444,379,0,183,500,91,0,1597
2009,Central African Rep.,Ouham-Pende,3625,4856,0,2685,13500,450,0,25116,3700,4850,0,2800,13134,400,0,24884
2009,Central African Rep.,Ouham,2160,2940,0,2484,3700,216,0,11500,2400,2872,0,2546,4500,182,0,12500
2009,Central African Rep.,Obo,18,25,0,21,98,6,0,168,15,17,0,12,118,7,0,169
2009,Central African Rep.,Nana Mambere,1900,2600,0,1300,5660,170,0,11630,4300,2500,0,1120,5280,170,0,13370
2009,Central African Rep.,Nana Grebizi,705,2240,0,1680,6720,146,0,11491,1680,2800,0,2240,9520,269,0,16509
2009,Central African Rep.,Mongoumba,1558,2025,0,1091,2649,146,0,7469,1741,1870,0,935,3400,166,0,8112
2009,Central African Rep.,Molangue,12,14,0,10,21,0,0,57,10,9,0,7,27,2,0,55
2009,Central African Rep.,Mboki,88,85,0,65,296,11,0,545,77,71,0,55,287,11,0,501
2009,Central African Rep.,Hautte-Kotto,680,1700,0,1360,4080,119,0,7939,850,2240,0,1530,4220,221,0,9061
2009,Central African Rep.,Haut Mbomou,164,415,0,380,1125,46,0,2130,150,450,0,680,1555,35,0,2870
2009,Central African Rep.,Eleveurs,1500,2000,0,1900,4500,90,0,9990,1000,1431,0,2000,5500,79,0,10010
2009,Central African Rep.,Bangui,272,372,0,421,1125,12,0,2202,318,387,0,386,2201,15,0,3307
2009,Central African Rep.,Bamingui-Bangora,500,760,0,310,2550,50,0,4170,485,770,0,360,2170,45,0,3830
2009,Canada,Canada,2459,2882,0,2012,18745,1095,0,27193,2513,3020,0,2137,25620,669,0,33959
2009,China,Yiwu,0,0,0,1,2,0,0,3,0,0,0,2,4,0,0,6
2009,China,Yanjiao,1,3,0,1,11,0,0,16,2,3,0,2,14,0,0,21
2009,China,Wuhan,2,0,0,1,1,0,0,4,0,0,0,1,2,0,0,3
2009,China,Wenchang,0,0,0,0,0,0,0,0,0,0,0,0,1,1,0,2
2009,China,Shanghai,0,0,0,0,1,0,0,1,0,1,0,0,2,0,0,3
2009,China,Nanjing,0,0,0,0,0,0,0,0,0,0,0,0,2,0,0,2
2009,China,Linyi,0,0,0,0,0,0,0,0,0,0,0,0,2,0,0,2
2009,China,Langfang,0,0,0,0,1,1,0,2,0,2,0,0,2,1,0,5
2009,China,Guangzhou,5,1,0,3,7,1,0,17,2,3,0,1,13,0,0,19
2009,China,Beijing,2,1,0,1,5,0,0,9,0,1,0,4,21,0,0,26
2009,Côte d'Ivoire,Tabou,886,1618,0,900,4111,149,0,7664,890,1616,0,790,3130,154,0,6580
2009,Côte d'Ivoire,Guiglo,357,816,0,495,2028,144,0,3840,346,889,0,443,1406,114,0,3198
2009,Côte d'Ivoire,Abidjan,144,277,0,211,1088,31,0,1751,165,316,0,210,1102,39,0,1832
2009,Cameroon,Yaounde,1,2,0,4,38,1,0,46,6,2,0,8,261,7,0,284
2009,Cameroon,Langui,328,454,0,160,774,87,0,1803,337,412,0,156,868,50,0,1823
2009,Cameroon,Kribi,0,1,0,1,1,0,0,3,0,0,0,1,2,0,0,3
2009,Cameroon,"Garoua, Yaounde",87,178,0,248,1397,31,0,1941,106,170,0,245,2264,78,0,2863
2009,Cameroon,"Douala, Yaounde",504,756,0,471,2204,47,0,3982,502,682,0,462,3066,58,0,4770
2009,Cameroon,Adamaoua,6990,12260,0,6195,18258,808,0,44511,7102,12441,0,5738,12619,1340,0,39240
2009,Dem. Rep. of the Congo,Lukaya,35,37,0,38,70,4,0,184,34,42,0,40,44,0,0,160
2009,Dem. Rep. of the Congo,Kimaza,42,36,0,31,112,0,0,221,48,47,0,41,203,5,0,344
2009,Dem. Rep. of the Congo,Goma,49,102,0,83,141,2,0,377,45,82,0,114,241,4,0,486
2009,Dem. Rep. of the Congo,Bukavu,15,10,0,8,59,2,0,94,24,24,0,19,60,3,0,130
2009,Dem. Rep. of the Congo,Sud-Kivu (Uvira/Fizi),616,683,0,694,1948,132,0,4073,654,742,0,723,1843,188,0,4150
2009,Dem. Rep. of the Congo,Province Orientale,166,177,0,179,548,88,0,1158,175,205,0,197,588,138,0,1303
2009,Dem. Rep. of the Congo,North Katanga (Pweto & Moba),1902,1885,0,1082,3379,108,0,8356,1979,1992,0,1065,3048,151,0,8235
2009,Dem. Rep. of the Congo,North Katanga (Kalemie),8,13,0,5,20,0,0,46,16,14,0,7,11,0,0,48
2009,Dem. Rep. of the Congo,Mbujimayi,0,0,0,0,3,0,0,3,0,0,0,0,9,1,0,10
2009,Dem. Rep. of the Congo,Lubumbashi,83,90,0,74,182,9,0,438,87,122,0,56,193,3,0,461
2009,Dem. Rep. of the Congo,Kinshasa,867,1297,0,1004,4146,894,0,8208,834,1256,0,1058,3657,803,0,7608
2009,Dem. Rep. of the Congo,Katanga (Kisenge),30,40,0,49,88,21,0,228,37,51,0,62,105,26,0,281
2009,Dem. Rep. of the Congo,Kasai-Oriental,37,193,0,58,391,21,0,700,42,189,0,48,447,29,0,755
2009,Dem. Rep. of the Congo,Cataractes,70,123,0,126,312,34,0,665,71,141,0,145,223,21,0,601
2009,Dem. Rep. of the Congo,Bas-Congo,4443,4621,0,4609,19524,2857,0,36054,4252,5000,0,4953,15991,152,0,30348
2009,Dem. Rep. of the Congo,Bandundu,53,70,0,71,123,17,0,334,33,77,0,76,36,3,0,225
2009,Congo,Sangha,82,131,0,39,200,9,0,461,90,161,0,21,343,3,0,618
2009,Congo,Pointe Noire,0,8,0,21,73,6,0,108,3,15,0,20,120,4,0,162
2009,Congo,Oyo,4,11,0,20,53,1,0,89,6,33,0,21,72,0,0,132
2009,Congo,Owando,0,0,0,0,3,0,0,3,0,0,0,1,6,0,0,7
2009,Congo,Ollombo,0,0,0,0,2,0,0,2,0,0,0,1,4,0,0,5
2009,Congo,Okoyo,0,1,0,0,4,0,0,5,0,1,0,0,3,0,0,4
2009,Congo,Ngo,6,33,0,56,64,1,0,160,7,43,0,39,119,0,0,208
2009,Congo,Ndjoundou/Liranga,7,32,0,21,55,2,0,117,11,36,0,20,87,8,0,162
2009,Congo,Mpouya,0,0,0,2,1,0,0,3,0,0,0,0,1,0,0,1
2009,Congo,Malolo,11,30,0,49,77,3,0,170,7,33,0,41,101,2,0,184
2009,Congo,Makoua,0,2,0,4,7,0,0,13,1,3,0,2,16,0,0,22
2009,Congo,Makotipoko,1,1,0,7,11,0,0,20,0,1,0,3,19,0,0,23
2009,Congo,Loukolela,61,127,0,149,415,9,0,761,69,148,0,161,700,13,0,1091
2009,Congo,Kondi Mbaka,9,22,0,41,50,4,0,126,3,24,0,33,56,3,0,119
2009,Congo,Komi,6,3,0,2,19,2,0,32,5,8,0,5,24,3,0,45
2009,Congo,Kintel,16,55,0,88,211,3,0,373,17,88,0,82,277,9,0,473
2009,Congo,Impfondo,343,548,0,462,1268,181,0,2802,352,505,0,553,1690,276,0,3376
2009,Congo,Gamboma,2,1,0,4,8,0,0,15,2,3,0,3,10,0,0,18
2009,Congo,Djambala,0,2,0,6,12,0,0,20,0,2,0,6,18,0,0,26
2009,Congo,Brazzaville/Point Noire,44,447,0,524,1101,2,0,2118,68,434,0,686,1597,17,0,2802
2009,Congo,Brazzaville,31,276,0,380,984,12,0,1683,69,341,0,379,1252,59,0,2100
2009,Congo,Boundji,0,1,0,1,4,0,0,6,0,0,0,0,4,0,0,4
2009,Congo,Bouemba,0,1,0,0,9,0,0,10,0,0,0,2,16,0,0,18
2009,Congo,Betou,74,183,0,92,344,17,0,710,123,225,0,110,338,45,0,841
2009,Colombia,Tulua,0,0,0,0,0,0,0,0,0,0,0,0,1,0,0,1
2009,Colombia,San Andres,0,0,0,0,2,0,0,2,0,0,0,1,1,0,0,2
2009,Colombia,Medellin,0,0,0,0,0,0,0,0,0,0,0,0,1,0,0,1
2009,Colombia,Maicao,0,0,0,0,1,0,0,1,0,0,0,0,0,0,0,0
2009,Colombia,Ibague,0,0,0,0,1,0,0,1,0,0,0,0,1,0,0,1
2009,Colombia,Duitama,0,0,0,0,1,0,0,1,0,0,0,0,0,0,0,0
2009,Colombia,Cucuta,1,0,0,0,2,0,0,3,1,0,0,1,4,0,0,6
2009,Colombia,Charala,0,0,0,0,0,0,0,0,0,0,0,0,0,1,0,1
2009,Colombia,Cartagena,0,0,0,0,1,0,0,1,0,0,0,0,9,1,0,10
2009,Colombia,Cali,0,0,0,0,1,0,0,1,0,0,0,0,2,1,0,3
2009,Colombia,Buenaventura,0,1,0,2,2,0,0,5,0,3,0,0,1,0,0,4
2009,Colombia,Bucaramanga,0,0,0,0,2,0,0,2,0,0,0,1,3,0,0,4
2009,Colombia,Bogota,5,4,0,4,44,8,0,65,5,10,0,3,176,5,0,199
2009,Colombia,Barcelona,0,0,0,2,1,0,0,3,0,0,0,0,1,0,0,1
2009,Cuba,Villa Clara,0,0,0,0,1,0,0,1,0,0,0,0,29,0,0,29
2009,Cuba,Santiago de Cuba,0,0,0,0,0,0,0,0,0,0,0,0,24,0,0,24
2009,Cuba,Sancti Spiritus,0,0,0,0,0,0,0,0,0,0,0,0,35,0,0,35
2009,Cuba,Pinar del Rio,0,0,0,0,0,0,0,0,0,0,0,0,48,0,0,48
2009,Cuba,Matanzas,0,0,0,0,0,0,0,0,0,0,0,0,24,0,0,24
2009,Cuba,Las Tunas,0,0,0,0,0,0,0,0,0,0,0,0,28,0,0,28
2009,Cuba,La Habana,0,0,0,0,0,0,0,0,0,0,0,0,7,0,0,7
2009,Cuba,Isla de la Juventud,0,0,0,0,0,0,0,0,0,0,0,7,68,0,0,75
2009,Cuba,Holguin,0,0,0,0,0,0,0,0,0,0,0,0,45,0,0,45
2009,Cuba,Guantanamo,0,0,0,0,0,0,0,0,0,0,0,0,30,0,0,30
2009,Cuba,Granma,0,0,0,0,0,0,0,0,0,0,0,0,37,0,0,37
2009,Cuba,Ciudad de La Habana,0,0,0,0,5,0,0,5,0,1,0,0,11,0,0,12
2009,Cuba,Cienfuegos,0,0,0,0,0,0,0,0,0,0,0,0,22,0,0,22
2009,Cuba,Ciego de Avila,0,0,0,0,0,0,0,0,0,0,0,0,3,0,0,3
2009,Cuba,Camaguey,0,0,0,0,1,0,0,1,0,0,0,0,33,0,0,33
2009,Cayman Islands,Grand Cayman,0,0,0,0,0,0,0,0,0,0,0,0,5,0,0,5
2009,Djibouti,Djibouti,723,1155,0,767,3320,121,0,6086,785,1283,0,708,3216,132,0,6124
2009,Djibouti,Ali-Addeh,28,34,0,25,175,1,0,263,30,54,0,24,442,9,0,559
2009,Algeria,Alger,9,8,0,6,60,1,0,84,19,5,0,7,168,2,0,201
2009,Egypt,Cairo,7511,10539,0,6808,23267,1380,0,49505,8245,7811,0,11946,29428,978,0,58408
2009,Eritrea,Emkulu,473,415,0,260,990,28,0,2166,522,427,0,301,1239,36,0,2525
2009,Eritrea,Elit,5,8,0,3,13,0,0,29,5,18,0,4,59,2,0,88
2009,Eritrea,Asmara,11,9,0,2,16,0,0,38,11,9,0,3,16,0,0,39
2009,Estonia,Tallinn,0,0,0,1,1,1,0,3,0,0,0,0,0,0,0,0
2009,Estonia,Illuka,0,0,0,0,2,0,0,2,0,0,0,4,14,0,0,18
2009,Ethiopia,Teferiber,1126,1812,0,892,2561,161,0,6552,1148,1759,0,975,1786,73,0,5741
2009,Ethiopia,Sherkole,273,382,0,176,616,17,0,1464,340,393,0,284,1058,13,0,2088
2009,Ethiopia,Sheder,516,1043,0,658,1847,96,0,4160,570,1100,0,698,1382,54,0,3804
2009,Ethiopia,Mai-Ayni,246,237,0,172,2110,16,0,2781,298,319,0,596,11683,85,0,12981
2009,Ethiopia,Kebribeyah,1477,2194,0,1089,3464,178,0,8402,1467,2288,0,1146,2966,227,0,8094
2009,Ethiopia,Fugnido,2333,2639,0,1496,4824,141,0,11433,2413,2582,0,1625,2109,40,0,8769
2009,Ethiopia,Borena,342,556,0,346,809,117,0,2170,389,505,0,285,713,113,0,2005
2009,Ethiopia,Bokolmanyo,2641,2851,0,1267,4403,279,0,11441,2677,2948,0,1304,3127,210,0,10266
2009,Ethiopia,Afar,692,1113,0,491,2107,110,0,4513,796,1243,0,664,2796,230,0,5729
2009,Ethiopia,Addis Ababa,104,155,0,109,420,13,0,801,99,160,0,102,628,26,0,1015
2009,Ethiopia,Shimelba (Shire/Shiraro),554,500,0,410,1652,180,0,3296,558,547,0,547,4998,189,0,6839
2009,Fiji,Suva,0,0,0,0,1,1,0,2,0,0,0,0,4,0,0,4
2009,Micronesia (Federated States of),Yap,0,0,0,0,0,0,0,0,0,0,0,0,1,0,0,1
2009,Gabon,Voungou/Pont,1,6,0,4,14,3,0,28,5,6,0,4,16,0,0,31
2009,Gabon,Tchibanga,62,112,0,108,339,20,0,641,61,168,0,103,391,29,0,752
2009,Gabon,Sindara,0,0,0,0,0,0,0,0,0,0,0,0,1,0,0,1
2009,Gabon,Rinanzala,2,17,0,6,23,1,0,49,0,18,0,5,27,2,0,52
2009,Gabon,Rebe,1,0,0,0,1,0,0,2,0,0,0,0,0,0,0,0
2009,Gabon,Port-Gentil,1,14,0,16,74,1,0,106,4,17,0,11,184,11,0,227
2009,Gabon,Pana/Dienga,0,0,0,0,1,0,0,1,0,0,0,1,6,0,0,7
2009,Gabon,Oyem,0,1,0,2,3,0,0,6,0,2,0,0,16,0,0,18
2009,Gabon,Okondja,3,3,0,0,4,0,0,10,0,2,0,1,41,0,0,44
2009,Gabon,Nzinga,0,4,0,4,9,2,0,19,2,3,0,3,6,0,0,14
2009,Gabon,Ntoum,0,1,0,0,2,0,0,3,0,1,0,0,1,0,0,2
2009,Gabon,Ngwoni,1,0,0,0,1,0,0,2,0,0,0,0,15,0,0,15
2009,Gabon,Ndjole,1,1,0,1,2,0,0,5,0,1,0,2,6,0,0,9
2009,Gabon,Ndende,15,43,0,27,108,6,0,199,7,40,0,25,81,0,0,153
2009,Gabon,Mounana,3,11,0,9,37,1,0,61,6,13,0,7,85,2,0,113
2009,Gabon,Mouila,15,61,0,34,170,4,0,284,43,65,0,26,188,2,0,324
2009,Gabon,Molengui Binza,10,40,0,26,86,15,0,177,12,49,0,35,74,7,0,177
2009,Gabon,Moanda,39,155,0,119,423,24,0,760,26,142,0,103,458,17,0,746
2009,Gabon,Mitzic,0,0,0,0,1,0,0,1,0,0,0,0,3,0,0,3
2009,Gabon,Mekambo,0,0,0,0,0,0,0,0,0,0,0,0,1,2,0,3
2009,Gabon,Mayumba,1,3,0,2,14,0,0,20,2,1,0,0,18,0,0,21
2009,Gabon,Makokou,0,0,0,1,2,0,0,3,0,1,0,0,16,0,0,17
2009,Gabon,Mabanda,4,10,0,5,23,3,0,45,3,10,0,4,27,4,0,48
2009,Gabon,Lope,1,0,0,3,2,0,0,6,0,1,0,0,5,0,0,6
2009,Gabon,Libreville,134,312,0,261,997,31,0,1735,86,297,0,261,1853,106,0,2603
2009,Gabon,Lekindou,1,5,0,3,9,0,0,18,0,0,0,1,4,2,0,7
2009,Gabon,Lebamba,7,11,0,7,19,1,0,45,2,6,0,5,16,2,0,31
2009,Gabon,Lastourville,1,5,0,12,28,1,0,47,0,9,0,9,48,3,0,69
2009,Gabon,Lambarene,1,1,0,1,11,0,0,14,1,7,0,2,22,1,0,33
2009,Gabon,Koumou Doussala,0,3,0,5,3,3,0,14,0,2,0,2,2,1,0,7
2009,Gabon,Koulamoutou,3,25,0,22,60,1,0,111,6,21,0,9,133,4,0,173
2009,Gabon,Gamba,2,22,0,10,67,0,0,101,8,15,0,3,80,2,0,108
2009,Gabon,Franceville,73,168,0,105,535,14,0,895,85,171,0,106,946,24,0,1332
2009,Gabon,Fougamou,1,0,0,0,2,0,0,3,0,1,0,0,4,0,0,5
2009,Gabon,Doussala,1,2,0,1,6,1,0,11,2,6,0,3,3,0,0,14
2009,Gabon,Dilemba,9,29,0,24,77,11,0,150,8,32,0,28,64,10,0,142
2009,Gabon,Boumango,4,15,0,12,18,2,0,51,2,10,0,9,21,3,0,45
2009,Gabon,Booue,1,0,0,0,3,0,0,4,0,1,0,0,8,1,0,10
2009,Gabon,Bongoville,0,0,0,0,0,0,0,0,0,0,0,0,3,0,0,3
2009,Gabon,Bitam,0,0,0,0,2,0,0,2,1,0,0,0,6,0,0,7
2009,Gabon,Bibora,0,0,0,0,1,0,0,1,0,0,0,0,0,0,0,0
2009,Gabon,Banda Mamba,1,6,0,1,9,2,0,19,1,1,0,3,1,4,0,10
2009,Gabon,Bakumba,2,17,0,9,24,1,0,53,3,13,0,5,11,0,0,32
2009,Gabon,Akieni,0,0,0,1,3,0,0,4,0,4,0,0,8,0,0,12
2009,Ghana,Volta,76,111,0,62,286,20,0,555,71,96,0,50,376,13,0,606
2009,Ghana,Kumasi,0,0,0,0,1,0,0,1,1,1,0,0,4,0,0,6
2009,Ghana,Krisan,22,68,0,43,232,10,0,375,26,51,0,38,515,9,0,639
2009,Ghana,Buduburam,605,739,0,682,3405,108,0,5539,624,752,0,626,3734,59,0,5795
2009,Ghana,Accra,30,46,0,48,163,5,0,292,31,40,0,59,309,9,0,448
2009,Guinea,Nzerekore,2,5,0,10,35,0,0,52,1,12,0,16,40,0,0,69
2009,Guinea,Laine,96,491,0,442,1155,60,0,2244,121,459,0,463,867,39,0,1949
2009,Guinea,Kouankan 2,206,448,0,340,734,58,0,1786,158,392,0,375,616,39,0,1580
2009,Guinea,Kouankan,102,403,0,330,833,37,0,1705,113,376,0,323,674,37,0,1523
2009,Guinea,Conakry,137,297,0,278,1058,15,0,1785,130,324,0,328,1340,23,0,2145
2009,Guinea,Boreah,36,189,0,113,413,29,0,780,33,167,0,114,302,19,0,635
2009,Gambia,Banjul,319,508,0,601,1039,219,0,2686,321,530,0,600,971,289,0,2711
2009,Guinea-Bissau,Jolmette,53,78,0,42,125,9,0,307,55,29,0,85,100,14,0,283
2009,Guinea-Bissau,Frontiere Sn,634,1382,0,921,525,110,0,3572,667,571,0,769,1165,158,0,3330
2009,Guinea-Bissau,Bissau,28,30,0,36,123,5,0,222,42,80,0,63,271,17,0,473
2009,Guatemala,Guatemala City,0,0,0,0,59,9,0,68,0,0,0,0,60,7,0,67
2009,"China, Hong Kong SAR","Hong Kong, SAR China",21,15,0,7,294,3,0,340,19,16,0,11,490,1,0,537
2009,Honduras,Trujillo,0,0,0,0,0,0,0,0,0,0,0,0,6,0,0,6
2009,Honduras,Tegucigalpa,0,0,0,0,0,0,0,0,0,0,0,0,8,0,0,8
2009,Honduras,Comayagua,0,0,0,0,3,0,0,3,0,0,0,0,1,0,0,1
2009,Honduras,Ceiba,0,0,0,0,0,0,0,0,0,0,0,0,2,0,0,2
2009,Croatia,Zagreb,0,1,0,2,2,0,0,5,0,1,0,3,6,1,0,11
2009,Croatia,Kutina,0,0,0,1,4,0,0,5,2,1,0,11,14,0,0,28
2009,Croatia,Jezevo,0,0,0,0,1,0,0,1,0,0,0,0,4,0,0,4
2009,Croatia,Bjelovarsko Bilogorska,0,0,0,0,0,0,0,0,0,0,0,0,1,0,0,1
2009,Haiti,Port-au-Prince,0,0,0,0,1,0,0,1,0,0,0,0,14,0,0,14
2009,Hungary,Budapest,6,5,0,16,27,0,0,54,0,25,0,346,2000,30,0,2401
2009,Hungary,Békéscsaba/Bicske/Debrecen,38,69,0,12,399,0,0,518,28,56,0,108,5662,0,0,5854
2009,Indonesia,Jakarta,36,37,0,28,172,3,0,276,39,75,0,357,1812,8,0,2291
2009,India,Tamil Nadu,0,0,0,0,0,0,35634,35634,0,0,0,0,0,0,37249,37249
2009,India,Delhi,722,998,0,1364,5277,389,0,8750,746,1132,0,1699,5213,341,0,9131
2009,Iran (Islamic Rep. of),Zanjan-Sultanieh,1,2,0,3,5,0,0,11,1,2,0,3,13,1,0,20
2009,Iran (Islamic Rep. of),Yazd,1,2954,0,3576,9589,560,0,16680,2,3154,0,3955,11735,892,0,19738
2009,Iran (Islamic Rep. of),Tehran,113,27916,0,33793,90479,5283,0,157584,121,29813,0,37390,111096,8430,0,186850
2009,Iran (Islamic Rep. of),South Khorasan,0,484,0,586,1571,92,0,2733,0,517,0,648,1922,146,0,3233
2009,Iran (Islamic Rep. of),Semnan-Semnan,0,219,0,265,712,42,0,1238,0,234,0,294,871,66,0,1465
2009,Iran (Islamic Rep. of),Semnan,1,1676,0,2029,5442,318,0,9466,1,1790,0,2244,6658,507,0,11200
2009,Iran (Islamic Rep. of),Qazvin,1,1425,0,1725,4627,270,0,8048,1,1522,0,1908,5661,431,0,9523
2009,Iran (Islamic Rep. of),Mazandaran,0,256,0,310,832,49,0,1447,0,274,0,343,1018,77,0,1712
2009,Iran (Islamic Rep. of),Markazi-Saveh,0,371,0,449,1203,70,0,2093,0,396,0,496,1473,112,0,2477
2009,Iran (Islamic Rep. of),Markazi,2,1762,0,2134,5723,334,0,9955,4,1888,0,2358,7001,532,0,11783
2009,Iran (Islamic Rep. of),Lorestan-Azna,10,16,0,19,37,2,0,84,10,18,0,23,80,4,0,135
2009,Iran (Islamic Rep. of),Kurdestan-Kamyaran,0,1,0,1,1,0,0,3,0,1,0,1,3,0,0,5
2009,Iran (Islamic Rep. of),Kordestan,0,1,0,1,2,0,0,4,1,1,0,1,4,0,0,7
2009,Iran (Islamic Rep. of),Khuzestan-Shushtar,5,8,0,10,19,1,0,43,5,9,0,12,40,2,0,68
2009,Iran (Islamic Rep. of),Khuzestan-Andimeshk,4,7,0,8,15,1,0,35,4,7,0,9,33,2,0,55
2009,Iran (Islamic Rep. of),Khuzestan,1,530,0,640,1721,100,0,2992,2,565,0,708,2109,159,0,3543
2009,Iran (Islamic Rep. of),Kerman,2,5993,0,7258,19463,1136,0,33852,2,6400,0,8024,23818,1811,0,40055
2009,Iran (Islamic Rep. of),Ilam ,5,9,0,10,20,1,0,45,6,10,0,13,45,2,0,76
2009,Iran (Islamic Rep. of),Ghom,60,5813,0,7032,18777,1097,0,32779,64,6208,0,7788,23189,1752,0,39001
2009,Iran (Islamic Rep. of),Fars,2,6220,0,7531,20195,1179,0,35127,2,6641,0,8329,24715,1879,0,41566
2009,Iran (Islamic Rep. of),West Azarbayjan-Sardasht,5,9,0,11,21,1,0,47,6,10,0,13,46,2,0,77
2009,Iran (Islamic Rep. of),West Azarbayjan-Piranshahr,10,17,0,20,39,2,0,88,11,18,0,24,83,4,0,140
2009,Iran (Islamic Rep. of),West Azarbayjan-Orumieh,33,57,0,66,129,8,0,293,36,61,0,79,276,15,0,467
2009,Iran (Islamic Rep. of),Khorasan Razavi-Torbat e jam,0,405,0,490,1315,77,0,2287,0,432,0,542,1609,122,0,2705
2009,Iran (Islamic Rep. of),Khorasan,7,12353,0,14959,40106,2341,0,69766,8,13191,0,16545,49085,3733,0,82562
2009,Iran (Islamic Rep. of),Kermanshah-Songhor,4,7,0,8,15,1,0,35,4,7,0,9,32,2,0,54
2009,Iran (Islamic Rep. of),Kermanshah-Kangavar,2,3,0,4,8,1,0,18,2,4,0,5,16,1,0,28
2009,Iran (Islamic Rep. of),Kermanshah ,2,3,0,4,8,0,0,17,2,4,0,5,16,1,0,28
2009,Iran (Islamic Rep. of),Kerman-Rafsanjan,0,538,0,651,1746,102,0,3037,0,574,0,720,2136,163,0,3593
2009,Iran (Islamic Rep. of),Kerman-Bardsir,0,361,0,437,1173,68,0,2039,0,386,0,484,1436,109,0,2415
2009,Iran (Islamic Rep. of),Hormozgan,0,1309,0,1585,4250,248,0,7392,0,1398,0,1753,5201,396,0,8748
2009,Iran (Islamic Rep. of),Golestan,0,1238,0,1499,4020,235,0,6992,0,1322,0,1657,4919,374,0,8272
2009,Iran (Islamic Rep. of),Ghazvin ,1,1,0,1,3,0,0,6,1,1,0,2,5,0,0,9
2009,Iran (Islamic Rep. of),Fars-Jahrom,20,34,0,39,77,5,0,175,21,37,0,47,168,9,0,282
2009,Iran (Islamic Rep. of),Esfahan,11,10967,0,13280,35601,2078,0,61937,11,11707,0,14688,43589,3314,0,73309
2009,Iran (Islamic Rep. of),Bushehr,0,572,0,693,1858,108,0,3231,0,611,0,766,2273,173,0,3823
2009,Iraq,Wassit,3782,4224,0,4222,13553,1317,0,27098,3950,4361,0,4358,13936,1152,0,27757
2009,Iraq,Thi-Qar,3127,3489,0,3489,11193,1088,0,22386,3264,3603,0,3603,11511,952,0,22933
2009,Iraq,Tameem,0,1,0,0,7,0,0,8,0,0,0,0,3,1,0,4
2009,Iraq,Sullaymanyah,2328,2599,0,2599,8335,809,0,16670,2429,2683,0,2683,8571,708,0,17074
2009,Iraq,Sulaymaniyah,180,514,0,523,1864,151,0,3232,170,532,0,523,2072,185,0,3482
2009,Iraq,Salah al-Din,82,94,0,95,310,31,0,612,88,95,0,97,315,27,0,622
2009,Iraq,Qadissyah,1743,1945,0,1945,6239,607,0,12479,1819,2009,0,2009,6417,531,0,12785
2009,Iraq,Qadissiya,6,8,0,8,31,2,0,55,0,2,0,8,26,1,0,37
2009,Iraq,Ninewa,255,295,0,299,970,90,0,1909,267,306,0,308,994,82,0,1957
2009,Iraq,Najaf,3421,3810,0,3808,12217,1188,0,24444,3562,3932,0,3932,12573,1038,0,25037
2009,Iraq,Muthanna,1124,1253,0,1253,4020,390,0,8040,1172,1294,0,1294,4135,342,0,8237
2009,Iraq,Missan,3000,3348,0,3359,10750,1045,0,21502,3134,3463,0,3468,11045,913,0,22023
2009,Iraq,Kirkuk,86,96,0,96,309,30,0,617,90,99,0,99,318,26,0,632
2009,Iraq,Kerbala,145,162,0,161,528,51,0,1047,152,176,0,167,543,44,0,1082
2009,Iraq,Erbil,3230,4278,0,4169,13566,1330,0,26573,3353,4389,0,4264,13810,1166,0,26982
2009,Iraq,Diyala,4024,4490,0,4489,14414,1402,0,28819,4198,4634,0,4634,14827,1225,0,29518
2009,Iraq,Dahuk,48,53,0,53,169,16,0,339,49,55,0,54,174,14,0,346
2009,Iraq,Basrah,2581,3000,0,2945,9497,934,0,18957,2685,3091,0,3038,9737,814,0,19365
2009,Iraq,Baghdad,8879,10193,0,10228,33586,3464,0,66350,9295,10476,0,10537,34680,3112,0,68100
2009,Iraq,Babylon,194,216,0,219,701,68,0,1398,203,225,0,225,721,61,0,1435
2009,Iraq,Anbar,184,330,0,385,1163,124,0,2186,190,341,0,387,1469,159,0,2546
2009,Iceland,Reykjavik,2,6,0,17,35,1,0,61,4,4,0,10,15,0,0,33
2009,Iceland,Keflavik,0,0,0,3,4,0,0,7,0,0,0,0,4,0,0,4
2009,Iceland,Akureyri,0,0,0,0,0,0,0,0,0,0,0,0,1,0,0,1
2009,Iceland,Akranes,3,3,0,3,8,0,0,17,2,5,0,5,0,0,0,12
2009,Israel,Tel Aviv,235,147,0,42,2098,12,0,2534,228,221,0,124,14425,204,0,15202
2009,Jamaica,St. Mary,0,0,0,0,0,0,0,0,0,0,0,0,1,0,0,1
2009,Jamaica,Montego Bay,0,0,0,1,1,0,0,2,0,1,0,3,3,0,0,7
2009,Jamaica,Kingston,1,0,0,0,2,0,0,3,1,0,0,0,5,0,0,6
2009,Jamaica,Falmouth,1,0,0,0,4,0,0,5,0,2,0,0,0,0,0,2
2009,Jordan,Amman,1613,2588,0,2078,11433,1860,0,19572,1792,2634,0,2227,12299,1580,0,20532
2009,Kazakhstan,Almaty,22,39,0,62,202,5,0,330,31,49,0,46,287,6,0,419
2009,Kenya,Rift valley,0,0,0,0,0,0,207,207,0,0,0,0,0,0,242,242
2009,Kenya,Nairobi,1551,2984,0,2777,13684,377,0,21373,1664,3049,0,2798,16771,661,0,24943
2009,Kenya,Kakuma,4546,6395,0,4249,14252,566,0,30008,4907,6983,0,5272,17280,341,0,34783
2009,Kenya,Ifo,6243,8934,0,4610,18114,1427,0,39328,6581,9538,0,5532,17034,1411,0,40096
2009,Kenya,Hagadera,5770,8563,0,5258,19826,1391,0,40808,6007,9257,0,6384,19634,1428,0,42710
2009,Kenya,Dagahaley,7788,11774,0,5389,20471,1545,0,46967,7910,12344,0,6458,17958,1542,0,46212
2009,Kenya,Dadaab,699,1087,0,578,2389,168,0,4921,717,1190,0,747,2962,121,0,5737
2009,Kyrgyzstan,Ysyk-kol,0,0,0,0,253,231,0,484,0,0,0,0,234,213,0,447
2009,Kyrgyzstan,Talas,0,0,0,0,186,63,0,249,0,0,0,0,134,107,0,241
2009,Kyrgyzstan,Osh,286,663,0,401,2382,1321,0,5053,227,557,0,305,1573,1259,0,3921
2009,Kyrgyzstan,Naryn,0,0,0,0,132,132,0,264,0,0,0,0,104,101,0,205
2009,Kyrgyzstan,Jalal-abad,481,616,0,235,1845,597,0,3774,563,552,0,324,1317,539,0,3295
2009,Kyrgyzstan,Chuy,1,2,0,2,1069,419,0,1493,1,2,0,3,929,296,0,1231
2009,Kyrgyzstan,Bishkek,29,51,0,50,174,6,593,903,25,44,0,43,327,13,659,1111
2009,Kyrgyzstan,Batken,146,197,0,44,729,381,0,1497,210,225,0,78,468,318,0,1299
2009,Cambodia,Phnom Penh,2,9,0,15,40,2,0,68,5,19,0,10,61,1,0,96
2009,Rep. of Korea,Whasung,0,0,0,0,3,1,0,4,0,0,0,0,5,0,0,5
2009,Rep. of Korea,Suwon,0,0,0,0,1,0,0,1,0,0,0,0,4,1,0,5
2009,Rep. of Korea,Seoul,12,6,0,0,112,1,0,131,14,7,0,2,369,5,0,397
2009,Rep. of Korea,Pohang,0,0,0,0,0,0,0,0,0,0,0,0,1,0,0,1
2009,Rep. of Korea,Masan,0,0,0,0,0,0,0,0,0,0,0,0,3,0,0,3
2009,Rep. of Korea,Incheon,0,1,0,0,2,0,0,3,0,0,0,0,12,0,0,12
2009,Rep. of Korea,Euijeongbu,0,0,0,0,1,0,0,1,0,0,0,0,2,0,0,2
2009,Rep. of Korea,Daejeon,0,0,0,0,1,1,0,2,0,0,0,0,5,1,0,6
2009,Rep. of Korea,Daegu,1,0,0,0,1,0,0,2,0,0,0,0,6,0,0,6
2009,Rep. of Korea,Cheongju,0,0,0,0,0,0,0,0,0,0,0,0,3,0,0,3
2009,Rep. of Korea,Busan,0,0,0,0,0,0,0,0,0,0,0,0,5,0,0,5
2009,Kuwait,Kuwait,39,94,0,125,386,9,0,653,33,101,0,139,2266,14,0,2553
2009,Liberia,VOA,7,13,0,28,69,10,0,127,9,10,0,27,81,13,0,140
2009,Liberia,Sinoe,0,0,0,0,0,0,0,0,0,0,0,0,0,0,1,1
2009,Liberia,Samukai,8,11,0,11,17,3,0,50,7,9,0,12,11,5,0,44
2009,Liberia,Saclepea,108,134,0,114,278,16,0,650,87,139,0,88,305,9,0,628
2009,Liberia,Rivercess,0,0,0,0,0,0,11,11,0,0,0,0,0,0,7,7
2009,Liberia,River Ghee,0,0,0,0,0,0,19,19,0,0,0,0,0,0,12,12
2009,Liberia,Nimba,154,185,0,155,433,34,33,994,163,201,0,161,385,46,29,985
2009,Liberia,Montserrado ,0,0,0,0,0,0,1442,1442,0,0,0,0,0,0,1387,1387
2009,Liberia,Monrovia,6,19,0,10,33,0,225,293,3,13,0,10,383,0,0,409
2009,Liberia,Maryland,20,11,0,17,23,0,98,169,21,15,0,12,189,2,61,300
2009,Liberia,Margibi,0,0,0,0,0,0,40,40,0,0,0,0,0,0,33,33
2009,Liberia,Lofa,0,0,0,0,0,0,57,57,0,0,0,0,0,0,42,42
2009,Liberia,Grand Kru,0,0,0,0,0,0,19,19,0,0,0,0,0,0,13,13
2009,Liberia,Grand Gedeh,316,282,0,135,646,90,0,1469,323,320,0,174,528,35,0,1380
2009,Liberia,Grand Cape Mount,0,0,0,0,0,0,31,31,0,0,0,0,0,0,25,25
2009,Liberia,Grand Bassa,0,0,0,0,0,0,2,2,0,0,0,0,0,0,2,2
2009,Liberia,Gbarpolu,0,0,0,0,0,0,165,165,0,0,0,0,0,0,140,140
2009,Liberia,Bong,0,0,0,0,0,0,7,7,0,0,0,0,0,0,9,9
2009,Liberia,Bomi,0,0,0,0,0,0,65,65,0,0,0,0,0,0,75,75
2009,Liberia,Banjor,4,9,0,9,13,1,0,36,3,5,0,7,16,3,0,34
2009,Libya,Tripoli,310,566,0,685,3353,216,0,5130,312,586,0,721,5141,432,0,7192
2009,Saint Lucia,Vigie,0,0,0,0,1,0,0,1,0,0,0,0,3,0,0,3
2009,Sri Lanka,Vavuniya,0,0,0,0,0,0,101796,101796,0,0,0,0,0,0,97804,97804
2009,Sri Lanka,Trincomalee,0,0,0,0,0,0,10455,10455,0,0,0,0,0,0,10045,10045
2009,Sri Lanka,Puttalam,0,0,0,0,0,0,35343,35343,0,0,0,0,0,0,33957,33957
2009,Sri Lanka,Mullattivu,0,0,0,0,0,0,5763,5763,0,0,0,0,0,0,5537,5537
2009,Sri Lanka,Mannar,0,0,0,0,0,0,17340,17340,0,0,0,0,0,0,16660,16660
2009,Sri Lanka,Kilinochchi,0,0,0,0,0,0,9027,9027,0,0,0,0,0,0,8673,8673
2009,Sri Lanka,Jaffna,0,0,0,0,0,0,72216,72216,0,0,0,0,0,0,69384,69384
2009,Sri Lanka,Colombo,26,42,0,31,145,6,0,250,35,49,0,42,207,6,0,339
2009,Sri Lanka,Batticaloa,0,0,0,0,0,0,6222,6222,0,0,0,0,0,0,5978,5978
2009,Sri Lanka,Anuradhapura,0,0,0,0,0,0,2142,2142,0,0,0,0,0,0,2058,2058
2009,Sri Lanka,Ampara,0,0,0,0,0,0,3009,3009,0,0,0,0,0,0,2891,2891
2009,Lithuania,Vilnius,3,3,0,0,9,1,0,16,3,4,0,2,10,1,0,20
2009,Lithuania,Svencioniu Raj.,0,0,0,0,2,0,0,2,0,0,0,3,1,0,0,4
2009,Lithuania,RRC Rukla,1,5,0,4,16,0,0,26,11,2,0,6,25,0,0,44
2009,Lithuania,Pabrade,1,0,0,0,0,0,0,1,0,0,0,0,1,0,0,1
2009,Lithuania,Klaipeda,0,0,0,0,0,0,0,0,0,0,0,0,1,0,0,1
2009,Lithuania,Kaunas,2,3,0,0,5,0,0,10,3,4,0,0,3,0,0,10
2009,Lithuania,Jonava,0,0,0,0,1,0,0,1,1,1,0,0,1,0,0,3
2009,Lithuania,FRC Pabrade,1,1,0,0,4,1,0,7,1,0,0,0,56,0,0,57
2009,Lithuania,Elektrenai,2,5,0,3,10,0,0,20,8,6,0,7,9,0,0,30
2009,Latvia,Salaspils,0,0,0,0,0,0,0,0,0,0,0,0,1,0,0,1
2009,Latvia,Riga,0,8,0,5,11,0,0,24,1,7,0,5,39,0,0,52
2009,Latvia,Jurmala,0,0,0,1,1,0,0,2,0,0,0,0,1,0,0,1
2009,Latvia,Jelgava,0,0,0,0,0,0,0,0,0,0,0,0,1,0,0,1
2009,"China, Macao SAR","Macao SAR, China",1,3,0,0,2,0,0,6,1,1,0,0,4,0,0,6
2009,Morocco,Rabat,43,39,0,48,171,4,0,305,44,32,0,63,641,6,0,786
2009,Rep. of Moldova,Chisinau,0,5,0,13,1132,115,0,1265,1,12,0,10,840,79,0,942
2009,Mexico,Mexico City,16,38,0,69,303,43,0,469,8,29,0,116,636,73,0,862
2009,The former Yugoslav Republic of Macedonia,Veles,0,2,0,0,0,0,0,2,0,2,0,0,2,0,0,4
2009,The former Yugoslav Republic of Macedonia,Debar,2,0,0,0,0,0,0,2,1,1,0,0,0,0,0,2
2009,The former Yugoslav Republic of Macedonia,Visbegovo,0,2,0,2,4,0,0,8,0,0,0,1,10,2,0,13
2009,The former Yugoslav Republic of Macedonia,Valandovo,0,1,0,2,5,0,0,8,1,2,0,0,4,1,0,8
2009,The former Yugoslav Republic of Macedonia,Tetovo,5,9,0,3,49,11,0,77,3,11,0,5,37,2,0,58
2009,The former Yugoslav Republic of Macedonia,Sveti Nikole,0,0,0,0,0,1,0,1,0,0,0,0,0,0,0,0
2009,The former Yugoslav Republic of Macedonia,Strumica,0,0,0,0,1,0,0,1,0,0,0,0,0,0,0,0
2009,The former Yugoslav Republic of Macedonia,Skopje,139,237,0,205,741,42,0,1364,151,248,0,180,705,24,0,1308
2009,The former Yugoslav Republic of Macedonia,Shtip ,9,13,0,5,39,0,0,66,6,18,0,8,45,0,0,77
2009,The former Yugoslav Republic of Macedonia,Prilep,4,8,0,3,6,2,0,23,4,3,0,0,14,0,0,21
2009,The former Yugoslav Republic of Macedonia,Ohrid,0,0,0,0,0,0,0,0,0,0,0,0,1,0,0,1
2009,The former Yugoslav Republic of Macedonia,Kumanovo,4,4,0,12,52,3,0,75,4,6,0,13,39,3,0,65
2009,The former Yugoslav Republic of Macedonia,Kicevo,1,0,0,3,18,1,0,23,0,4,0,2,10,0,0,16
2009,The former Yugoslav Republic of Macedonia,Kavadarci,0,0,0,0,2,0,0,2,0,0,0,0,0,0,0,0
2009,The former Yugoslav Republic of Macedonia,Gostivar,6,8,0,6,29,1,0,50,2,8,0,10,16,5,0,41
2009,The former Yugoslav Republic of Macedonia,Gevgelija,0,0,0,0,2,0,0,2,0,0,0,0,1,0,0,1
2009,The former Yugoslav Republic of Macedonia,Geriatric clinic,0,0,0,0,0,0,0,0,0,0,0,0,1,0,0,1
2009,The former Yugoslav Republic of Macedonia,Bitola,5,15,0,1,23,0,0,44,11,6,0,3,17,0,0,37
2009,The former Yugoslav Republic of Macedonia,Berovo,0,0,0,0,1,0,0,1,0,0,0,0,0,0,0,0
2009,Mali,Sikasso,0,0,0,0,0,0,0,0,0,0,0,0,5,0,0,5
2009,Mali,Kayes,797,1400,0,686,2026,144,0,5053,864,1457,0,698,2192,218,0,5429
2009,Mali,Faragouana,5,5,0,1,15,1,0,27,6,5,0,5,10,1,0,27
2009,Mali,Bamako,155,208,0,179,1026,18,0,1586,152,228,0,202,2502,33,0,3117
2009,Malta,Peace Lab,0,0,0,0,10,0,0,10,0,0,0,0,22,0,0,22
2009,Malta,Marsa Open Centre,0,0,0,0,0,0,0,0,0,0,0,0,0,0,670,670
2009,Malta,Hal Far Tent Village,0,0,0,0,0,0,0,0,0,0,0,0,0,0,551,551
2009,Malta,Hal Far Open Centre,0,0,0,0,0,0,0,0,0,0,0,0,0,0,584,584
2009,Malta,Hal Far Awas,0,0,0,0,0,0,37,37,0,0,0,0,0,0,117,117
2009,Malta,Dar is-Sliem,0,0,0,5,0,0,0,5,0,0,0,24,0,0,0,24
2009,Malta,Dar il-Qawsalla,0,0,0,0,0,0,20,20,0,0,0,0,0,0,18,18
2009,Malta,Dar il-Liedna,0,0,0,0,0,0,20,20,0,0,0,0,0,0,88,88
2009,Malta,Hal Far Reception Centre,0,0,0,0,0,0,96,96,0,0,0,0,0,0,0,0
2009,Myanmar,Maungdaw,30669,49352,0,37531,99177,8563,0,225292,36937,52958,0,44498,82007,9014,0,225414
2009,Myanmar,Buthidaung,15851,27303,0,18101,52103,4395,0,117753,17115,29210,0,21930,44440,5023,0,117718
2009,Montenegro,Podgorica,149,162,0,99,299,17,0,726,144,166,0,110,308,25,0,753
2009,Mongolia,Ulaanbaatar,1,0,0,0,4,0,0,5,1,0,0,0,8,0,0,9
2009,Mozambique,Zambezia,4,4,0,3,10,0,0,21,5,7,0,2,31,0,0,45
2009,Mozambique,Tete,1,1,0,3,6,0,0,11,0,1,0,1,9,2,0,13
2009,Mozambique,Sofala,2,1,0,2,8,0,0,13,1,3,0,1,14,0,0,19
2009,Mozambique,Niassa,7,21,0,12,27,0,0,67,6,21,0,8,46,0,0,81
2009,Mozambique,Nampula,41,47,0,29,170,2,0,289,56,60,0,36,589,6,0,747
2009,Mozambique,Maratane,368,566,0,260,854,26,0,2074,412,570,0,303,1382,10,0,2677
2009,Mozambique,Maputo,66,172,0,100,338,9,0,685,54,155,0,86,538,12,0,845
2009,Mozambique,Manica,2,3,0,3,11,0,0,19,3,1,0,2,24,0,0,30
2009,Mozambique,Inhambane,2,2,0,1,7,0,0,12,0,5,0,4,10,0,0,19
2009,Mozambique,Gaza,2,3,0,2,7,0,0,14,3,5,0,1,13,0,0,22
2009,Mozambique,Cabo Delgado,2,1,0,1,3,0,0,7,0,1,0,0,12,0,0,13
2009,Mauritania,Nouakchott/Nouadhibou,54,41,0,25,197,2,0,319,48,51,0,35,455,5,0,594
2009,Malawi,Zomba,0,0,0,0,0,0,0,0,0,0,0,0,3,0,0,3
2009,Malawi,Salima,0,1,0,0,1,0,0,2,2,0,0,0,6,0,0,8
2009,Malawi,Rumphi,1,1,0,2,1,0,0,5,1,6,0,2,4,0,0,13
2009,Malawi,Ntcheu,1,3,0,0,1,0,0,5,0,3,0,1,3,0,0,7
2009,Malawi,Mzimba,1,0,0,1,3,0,0,5,3,1,0,3,4,0,0,11
2009,Malawi,Mwanza,0,0,0,0,1,0,0,1,4,0,0,0,2,0,0,6
2009,Malawi,Mulanje,0,1,0,0,0,0,0,1,0,1,0,0,1,0,0,2
2009,Malawi,Mchinji,0,1,0,2,4,0,0,7,1,4,0,1,3,0,0,9
2009,Malawi,Mangochi,5,3,0,3,5,0,0,16,3,3,0,4,14,0,0,24
2009,Malawi,Machinga,1,2,0,0,1,0,0,4,0,0,0,0,2,0,0,2
2009,Malawi,Lilongwe,38,59,0,39,172,4,0,312,42,58,0,33,230,2,0,365
2009,Malawi,Kasungu,0,0,0,0,0,0,0,0,0,0,0,0,1,0,0,1
2009,Malawi,Karonga,4,4,0,2,4,0,0,14,2,5,0,1,7,0,0,15
2009,Malawi,Dzaleka,845,1234,0,683,1974,53,0,4789,952,1187,0,765,2530,52,0,5486
2009,Malawi,Dedza,2,2,0,2,2,0,0,8,2,6,0,2,4,0,0,14
2009,Malawi,Chiradzulu,2,0,0,0,1,0,0,3,0,0,0,0,1,0,0,1
2009,Malawi,Chikwawa,0,1,0,0,1,0,0,2,0,2,0,0,0,0,0,2
2009,Malawi,Blantyre,15,7,0,12,20,0,0,54,4,15,0,9,42,0,0,70
2009,Malawi,Balaka,0,2,0,2,2,1,0,7,4,2,0,2,4,0,0,12
2009,Malaysia,Kuala Lumpur,3217,2438,0,2479,16056,275,0,24465,3482,2558,0,3709,41804,402,0,51955
2009,Namibia,Osire,584,796,0,637,1724,63,0,3804,591,816,0,639,2588,68,0,4702
2009,Namibia,Dukwe,0,0,0,0,0,0,14,14,0,0,0,0,0,0,17,17
2009,Niger,Niamey,9,21,0,15,55,2,0,102,6,12,0,7,104,0,0,129
2009,Niger,Goure,3,11,0,12,32,4,0,62,5,10,0,9,36,4,0,64
2009,Nigeria,Oru Camp,32,205,0,140,1076,33,0,1486,40,138,0,220,1210,45,0,1653
2009,Nigeria,Maiduguri,3,7,0,5,14,1,0,30,9,5,0,10,8,4,0,36
2009,Nigeria,Lagos ,147,143,0,237,1511,6,0,2044,88,131,0,342,2044,326,0,2931
2009,Nigeria,Ijebuode,11,9,0,5,30,0,0,55,9,6,0,1,82,0,0,98
2009,Nigeria,Amana/Ityuav,222,145,0,260,514,54,0,1195,170,138,0,199,206,31,0,744
2009,Nicaragua,Managua,1,0,0,2,46,0,0,49,0,1,0,2,58,11,0,72
2009,Nepal,Timai,379,557,0,535,2466,258,0,4195,419,552,0,629,2477,281,0,4358
2009,Nepal,Sanischare,679,1064,0,1132,4858,510,0,8243,724,1112,0,1099,4970,597,0,8502
2009,Nepal,Khudunabari,418,711,0,845,3669,383,0,6026,455,678,0,820,3591,484,0,6028
2009,Nepal,Kathmandu,21,16,0,5,67,1,0,110,21,23,0,19,132,2,0,197
2009,Nepal,Goldhap,275,342,0,366,1912,218,0,3113,267,382,0,370,1967,257,0,3243
2009,Nepal,Beldangi 2 Extension,405,556,0,677,2890,321,0,4849,443,632,0,675,2937,361,0,5048
2009,Nepal,Beldangi 2,671,950,0,1138,5137,563,0,8459,695,1091,0,1194,5243,653,0,8876
2009,Nepal,Beldangi 1,667,990,0,1004,4223,438,0,7322,709,977,0,1026,4316,540,0,7568
2009,Oman,Muscat,3,1,0,2,16,0,0,22,1,2,0,2,10,1,0,16
2009,Pakistan,Zar Karez,132,817,0,387,1092,69,0,2497,147,884,0,467,1239,136,0,2873
2009,Pakistan,Zangal Patai,174,806,0,498,1297,66,0,2841,172,880,0,589,1326,143,0,3110
2009,Pakistan,Zafarabad,103,779,0,322,1009,51,0,2264,117,807,0,531,1388,124,0,2967
2009,Pakistan,Yakaghund,112,536,0,313,752,55,0,1768,101,562,0,304,758,87,0,1812
2009,Pakistan,Utmanzai,88,610,0,365,807,34,0,1904,95,608,0,360,815,119,0,1997
2009,Pakistan,Urguch,4,10,0,3,11,1,0,29,1,8,0,6,25,0,0,40
2009,Pakistan,Toor,259,848,0,516,1300,51,0,2974,264,842,0,566,1473,119,0,3264
2009,Pakistan,Timer,446,1730,0,938,2478,109,0,5701,485,1866,0,1010,2555,222,0,6138
2009,Pakistan,Thall,443,2063,0,1223,3367,266,0,7362,467,2127,0,1381,3424,508,0,7907
2009,Pakistan,Surkhab,331,1543,0,731,2403,172,0,5180,328,1708,0,986,3250,337,0,6609
2009,Pakistan,Sund Rawal,13,108,0,61,117,13,0,312,18,117,0,52,162,19,0,368
2009,Pakistan,Shindand,3439,9541,0,5486,16293,766,0,35525,3727,9805,0,6698,22157,1945,0,44332
2009,Pakistan,Shaikh Abad,153,871,0,475,1221,83,0,2803,166,881,0,534,1327,120,0,3028
2009,Pakistan,Saranan,592,3357,0,1780,5023,307,0,11059,597,3567,0,2212,5946,738,0,13060
2009,Pakistan,Rata Kulachi,20,101,0,33,116,7,0,277,19,98,0,63,137,19,0,336
2009,Pakistan,Rakh Zandani,0,1,0,0,1,0,0,2,0,2,0,3,3,0,0,8
2009,Pakistan,Quetta,0,5,0,5,19,0,0,29,1,3,0,4,19,1,0,28
2009,Pakistan,Pusha Pul,40,173,0,84,255,14,0,566,28,222,0,134,335,32,0,751
2009,Pakistan,Punjab,5051,19555,0,10462,32019,1818,0,68905,5355,21002,0,13329,44999,3654,0,88339
2009,Pakistan,Posti,7,25,0,17,41,3,0,93,7,28,0,17,61,5,0,118
2009,Pakistan,Pir Alizai,283,1937,0,1021,2683,142,0,6066,280,2070,0,1367,3618,401,0,7736
2009,Pakistan,Peshawar,1,7,0,4,9,0,0,21,1,10,0,3,12,0,0,26
2009,Pakistan,Panian,1517,9170,0,5111,13373,662,0,29833,1627,9271,0,5493,14208,1390,0,31989
2009,Pakistan,Palai,147,572,0,305,924,59,0,2007,172,548,0,374,977,80,0,2151
2009,Pakistan,Padhana,243,1564,0,793,2133,138,0,4871,254,1648,0,900,2435,272,0,5509
2009,Pakistan,Old Shamshatoo,1414,7688,0,4928,13514,573,0,28117,1478,8039,0,5441,14576,1153,0,30687
2009,Pakistan,Old Akora,854,5220,0,2952,8259,285,0,17570,967,5413,0,3354,8834,881,0,19449
2009,Pakistan,Oblan,247,1390,0,776,2001,118,0,4532,314,1441,0,909,2121,243,0,5028
2009,Pakistan,NWFP,13740,50882,0,31955,93836,4992,0,195405,14800,54365,0,35660,99628,9611,0,214064
2009,Pakistan,New Akora,2,14,0,10,53,2,0,81,0,27,0,26,136,8,0,197
2009,Pakistan,Naurang,54,323,0,168,513,21,0,1079,46,390,0,201,502,62,0,1201
2009,Pakistan,Naguman,91,521,0,260,683,34,0,1589,109,514,0,306,706,78,0,1713
2009,Pakistan,Nagar,9,37,0,21,53,1,0,121,7,34,0,15,94,5,0,155
2009,Pakistan,Munda,298,1660,0,949,2458,127,0,5492,293,1663,0,1020,2471,286,0,5733
2009,Pakistan,Mohammad Kheil,133,960,0,338,1435,58,0,2924,109,1074,0,469,1380,173,0,3205
2009,Pakistan,Michni,6,27,0,18,37,3,0,91,2,28,0,15,52,6,0,103
2009,Pakistan,Mera Kachori,127,683,0,404,1130,66,0,2410,107,750,0,401,1194,104,0,2556
2009,Pakistan,Mayar,81,383,0,242,559,30,0,1295,81,344,0,248,651,59,0,1383
2009,Pakistan,Malgagai,167,913,0,510,1477,118,0,3185,191,990,0,660,1754,236,0,3831
2009,Pakistan,Lejay Karez,23,164,0,97,265,24,0,573,12,151,0,135,349,49,0,696
2009,Pakistan,Lakti Banda,216,1076,0,621,1700,175,0,3788,245,1055,0,684,1783,293,0,4060
2009,Pakistan,Kund/Khairabad,417,1801,0,839,2448,139,0,5644,432,1865,0,1004,2444,280,0,6025
2009,Pakistan,Kotwai,165,1068,0,565,1425,116,0,3339,172,1201,0,621,1549,203,0,3746
2009,Pakistan,Kotkai,119,662,0,423,1082,100,0,2386,154,683,0,486,1062,166,0,2551
2009,Pakistan,Kot Chandna,455,2163,0,1251,3267,184,0,7320,472,2193,0,1293,3398,336,0,7692
2009,Pakistan,Koga,265,1352,0,745,2032,115,0,4509,312,1420,0,804,2030,189,0,4755
2009,Pakistan,Khurasan,106,575,0,371,1325,87,0,2464,112,595,0,397,1463,125,0,2692
2009,Pakistan,Khoughani,28,207,0,144,368,10,0,757,33,211,0,144,370,25,0,783
2009,Pakistan,Kheshki,12,73,0,35,111,5,0,236,10,72,0,49,119,15,0,265
2009,Pakistan,Khazana,159,785,0,433,1194,66,0,2637,165,846,0,527,1372,124,0,3034
2009,Pakistan,Khaki,420,2236,0,1439,3422,199,0,7716,493,2327,0,1550,3504,343,0,8217
2009,Pakistan,Kesu,32,115,0,86,202,8,0,443,33,171,0,84,237,14,0,539
2009,Pakistan,Kata Kanri,199,849,0,501,1278,105,0,2932,203,881,0,536,1298,178,0,3096
2009,Pakistan,Karachi,0,6,0,5,38,0,0,49,2,4,0,6,57,0,0,69
2009,Pakistan,Kalatak,32,199,0,102,286,10,0,629,52,229,0,133,396,27,0,837
2009,Pakistan,Kaghan,89,268,0,183,418,17,0,975,82,290,0,211,431,33,0,1047
2009,Pakistan,Kacha Gari,461,3185,0,1824,5945,247,0,11662,495,3515,0,2463,9741,489,0,16703
2009,Pakistan,Kababian,282,1615,0,886,2787,75,0,5645,291,1655,0,1020,3474,250,0,6690
2009,Pakistan,Jerma,26,151,0,88,258,16,0,539,23,167,0,126,323,28,0,667
2009,Pakistan,Jalozai,718,3726,0,2334,7046,386,0,14210,803,3717,0,2578,8942,705,0,16745
2009,Pakistan,Jalala,383,1873,0,1087,3059,166,0,6568,406,2002,0,1289,3268,321,0,7286
2009,Pakistan,Islamabad,945,3868,0,2269,7128,395,0,14605,970,4141,0,2795,8848,797,0,17551
2009,Pakistan,Ichirian,196,1066,0,567,1618,94,0,3541,207,1011,0,671,1894,181,0,3964
2009,Pakistan,Girsal,0,1,0,0,2,0,0,3,0,3,0,0,3,0,0,6
2009,Pakistan,Girdi Jungle,840,3645,0,1878,5668,818,0,12849,819,3613,0,2624,8695,1116,0,16867
2009,Pakistan,Ghulam Banda,241,1115,0,665,1738,77,0,3836,232,1208,0,729,1964,203,0,4336
2009,Pakistan,Ghiljo,36,233,0,142,360,17,0,788,62,255,0,148,376,41,0,882
2009,Pakistan,Ghazi,3,43,0,12,59,4,0,121,8,53,0,17,74,8,0,160
2009,Pakistan,Ghazgai Minara,61,365,0,158,465,34,0,1083,62,415,0,215,579,67,0,1338
2009,Pakistan,Gandhi Khan Khel,96,569,0,265,841,53,0,1824,100,584,0,305,829,100,0,1918
2009,Pakistan,Gandaf,393,1702,0,1064,2571,165,0,5895,388,1893,0,1088,2966,267,0,6602
2009,Pakistan,Gamkol,846,4526,0,2541,6852,367,0,15132,881,4681,0,3037,8570,732,0,17901
2009,Pakistan,Gambila,37,321,0,105,459,20,0,942,37,319,0,182,486,65,0,1089
2009,Pakistan,Domshivgar,6,30,0,18,42,2,0,98,2,27,0,22,58,6,0,115
2009,Pakistan,Dodpa,10,48,0,14,60,3,0,135,4,50,0,29,74,5,0,162
2009,Pakistan,Doaba,170,934,0,544,1597,131,0,3376,193,947,0,628,1886,241,0,3895
2009,Pakistan,Darsamand,165,736,0,419,1308,108,0,2736,186,771,0,475,1541,189,0,3162
2009,Pakistan,Daraban,4,8,0,5,16,0,0,33,2,12,0,4,18,2,0,38
2009,Pakistan,Dabara,47,365,0,159,559,32,0,1162,73,467,0,268,1056,83,0,1947
2009,Pakistan,Chichana,102,501,0,294,888,59,0,1844,104,516,0,378,1185,133,0,2316
2009,Pakistan,Chakdara,634,2301,0,1366,3211,181,0,7693,723,2288,0,1529,3539,297,0,8376
2009,Pakistan,Chagai,8,38,0,22,61,5,0,134,7,42,0,33,72,6,0,160
2009,Pakistan,Bizen Khel,21,221,0,128,341,15,0,726,35,263,0,149,375,49,0,871
2009,Pakistan,Basu Mera,152,738,0,472,1210,57,0,2629,181,765,0,500,1141,135,0,2722
2009,Pakistan,Barawal,8,52,0,26,75,5,0,166,11,61,0,20,96,8,0,196
2009,Pakistan,Barary,189,1111,0,600,1663,99,0,3662,226,1125,0,666,1862,167,0,4046
2009,Pakistan,Barari,8,36,0,28,58,3,0,133,10,42,0,20,67,6,0,145
2009,Pakistan,Barakai,728,4103,0,2424,6310,316,0,13881,763,4320,0,2700,6256,677,0,14716
2009,Pakistan,Balochistan,8022,39956,0,19791,62932,4499,0,135200,8413,42955,0,25046,78221,9008,0,163643
2009,Pakistan,Bakka Khel,17,125,0,49,174,11,0,376,15,163,0,72,266,24,0,540
2009,Pakistan,Baghicha,15,91,0,62,149,14,0,331,12,90,0,58,196,23,0,379
2009,Pakistan,Badaber,822,4455,0,2439,6458,305,0,14479,876,4464,0,2678,6941,669,0,15628
2009,Pakistan,Azakhel,629,3447,0,1991,5170,211,0,11448,631,3724,0,2258,5458,444,0,12515
2009,Pakistan,Azad Kashmir,155,779,0,463,1249,50,0,2696,174,845,0,582,1672,139,0,3412
2009,Panama,Panama,291,735,0,2060,3224,891,0,7201,304,796,0,2570,4895,1085,0,9650
2009,Panama,Kuna Yala,5,13,0,16,25,1,0,60,4,12,0,14,29,1,0,60
2009,Panama,Darien,68,71,0,70,149,14,0,372,68,57,0,60,161,25,0,371
2009,Philippines,Visayas,0,0,0,0,0,0,0,0,0,0,0,0,3,0,0,3
2009,Philippines,Mindanao,0,0,0,0,0,0,0,0,0,0,0,0,5,0,0,5
2009,Philippines,Luzon,0,0,0,1,3,0,0,4,0,0,0,1,6,0,0,7
2009,Philippines,National Capital region (NCR),1,2,0,1,8,0,0,12,0,0,0,5,114,0,0,119
2009,Palau,Koror,0,0,0,0,2,0,0,2,0,0,0,0,10,0,0,10
2009,Papua New Guinea,Vanimo,0,0,0,0,0,0,0,0,0,0,0,0,3,0,0,3
2009,Papua New Guinea,Port Moresby,0,0,0,1,2,0,0,3,0,0,0,0,8,0,0,8
2009,Papua New Guinea,East Awin,142,212,0,179,618,46,0,1197,142,243,0,206,661,51,0,1303
2009,Papua New Guinea,Daru,0,0,0,0,0,0,0,0,0,0,0,0,3,0,0,3
2009,Paraguay,Asuncion,0,2,0,4,26,1,0,33,0,1,0,5,53,1,0,60
2009,Qatar,Doha,1,1,0,2,13,1,0,18,2,2,0,4,10,1,0,19
2009,Romania,Timisoara,0,0,0,0,0,0,0,0,0,0,0,1,15,2,0,18
2009,Romania,Somcuta Mare,0,0,0,0,0,0,0,0,0,0,0,2,25,0,0,27
2009,Romania,Radauti,0,0,0,0,2,0,0,2,0,0,0,4,30,0,0,34
2009,Romania,Galati,0,0,0,1,2,0,0,3,0,1,0,0,29,0,0,30
2009,Romania,Bucuresti,0,0,0,1,7,0,0,8,0,1,0,4,81,4,0,90
2009,Russian Federation,Moskva,19,32,0,43,119,6,0,219,37,59,0,37,296,7,0,436
2009,Russian Federation,Sankt-peterburg,2,2,0,2,3,0,0,9,1,2,0,2,6,0,0,11
2009,Russian Federation,North Caucasus,0,0,0,3,7,0,0,10,1,2,0,2,3,0,0,8
2009,Rwanda,Rwamagana,32,30,0,7,70,2,0,141,38,25,0,12,49,0,0,124
2009,Rwanda,Rutsiro,200,139,0,48,381,11,0,779,166,126,0,35,173,13,0,513
2009,Rwanda,Rusizi,76,67,0,30,152,14,0,339,85,47,0,35,93,4,0,264
2009,Rwanda,Rulindo,28,19,0,2,64,0,0,113,29,21,0,6,19,0,0,75
2009,Rwanda,Ruhango,50,26,0,14,96,4,0,190,54,31,0,15,59,5,0,164
2009,Rwanda,Rubavu,284,193,0,63,605,25,0,1170,270,158,0,54,240,14,0,736
2009,Rwanda,Nyaruguru,73,50,0,23,133,1,0,280,69,48,0,10,65,2,0,194
2009,Rwanda,Nyarugenge,27,23,0,4,55,1,0,110,31,24,0,2,40,1,0,98
2009,Rwanda,Nyanza,47,24,0,11,90,0,0,172,34,33,0,12,63,4,0,146
2009,Rwanda,Nyamasheke,123,82,0,41,232,10,0,488,126,75,0,44,120,10,0,375
2009,Rwanda,Nyamagabe,68,40,0,16,104,9,0,237,49,38,0,14,41,8,0,150
2009,Rwanda,Nyagatare,146,90,0,46,326,18,0,626,131,103,0,54,305,11,0,604
2009,Rwanda,Nyabihu,330,251,0,81,860,33,0,1555,332,190,0,91,323,15,0,951
2009,Rwanda,Niabiheke,1637,1876,0,1253,2981,174,0,7921,1606,1823,0,1116,1650,120,0,6315
2009,Rwanda,Ngororero,140,92,0,35,335,11,0,613,152,69,0,27,125,6,0,379
2009,Rwanda,Ngoma,62,44,0,15,128,6,0,255,58,36,0,23,108,2,0,227
2009,Rwanda,Musanze,168,130,0,41,423,12,0,774,181,101,0,56,192,11,0,541
2009,Rwanda,Muhanga,30,26,0,2,65,4,0,127,31,24,0,9,40,3,0,107
2009,Rwanda,Kiziba,1571,2113,0,1999,4213,323,0,10219,1428,2100,0,1738,2806,402,0,8474
2009,Rwanda,Kirehe,93,95,0,29,209,5,0,431,76,59,0,26,210,4,0,375
2009,Rwanda,Kigali,118,208,0,193,479,10,0,1008,121,202,0,186,435,10,0,954
2009,Rwanda,Kicukiro,11,7,0,7,26,2,0,53,16,17,0,0,24,2,0,59
2009,Rwanda,Kayonza,87,59,0,22,186,9,0,363,88,52,0,37,183,6,0,366
2009,Rwanda,Karongi,201,150,0,58,407,20,0,836,202,126,0,54,177,15,0,574
2009,Rwanda,Kamonyi,22,11,0,6,33,1,0,73,16,8,0,2,19,0,0,45
2009,Rwanda,Huye,39,33,0,9,89,4,0,174,40,36,0,19,52,3,0,150
2009,Rwanda,Gisagara,57,39,0,26,126,3,0,251,46,41,0,23,100,2,0,212
2009,Rwanda,Gihembe,1484,2469,0,1797,4441,397,0,10588,1501,2283,0,1710,3114,211,0,8819
2009,Rwanda,Gicumbi,39,29,0,8,74,0,0,150,40,22,0,8,42,0,0,112
2009,Rwanda,Gatsibo,149,103,0,44,283,13,0,592,126,107,0,31,238,12,0,514
2009,Rwanda,Gasabo,24,23,0,3,46,2,0,98,29,9,0,5,33,2,0,78
2009,Rwanda,Gakenke,21,19,0,3,44,1,0,88,16,11,0,7,27,2,0,63
2009,Rwanda,Burera,55,35,0,12,95,2,0,199,34,28,0,12,57,2,0,133
2009,Rwanda,Bugesera,131,84,0,30,275,9,0,529,130,102,0,32,191,3,0,458
2009,Saudi Arabia,Riyadh,4,37,0,28,98,3,0,170,8,36,0,50,168,7,0,269
2009,Saudi Arabia,Madinah,1,1,0,0,1,0,0,3,0,0,0,0,3,0,0,3
2009,Saudi Arabia,Khobar,0,0,0,0,3,1,0,4,0,1,0,0,8,0,0,9
2009,Saudi Arabia,Jeddah,7,20,0,26,44,1,0,98,9,28,0,16,56,3,0,112
2009,Saudi Arabia,Arar,0,0,0,0,0,0,0,0,0,0,0,0,1,0,0,1
2009,Saudi Arabia,Al-Qateef,1,2,0,0,1,0,0,4,0,0,0,4,1,0,0,5
2009,Saudi Arabia,Al-Ihsa,0,0,0,0,0,0,0,0,0,0,0,0,1,0,0,1
2009,Sudan,"Yirol, Las",0,0,0,0,0,0,0,0,0,0,0,0,3,0,0,3
2009,Sudan,"Yirol West, Las",0,0,0,0,2,0,0,2,0,0,0,0,1,0,0,1
2009,Sudan,"Yirol East, Las",0,0,0,2,0,1,0,3,0,0,0,2,1,0,0,3
2009,Sudan,"Yei River, Ces",206,0,0,517,540,42,0,1305,214,0,0,554,349,25,0,1142
2009,Sudan,Yei,899,990,0,541,1682,115,0,4227,871,925,0,531,1243,55,1,3626
2009,Sudan,Yambio,428,459,0,250,1336,77,0,2550,383,435,0,274,1589,80,0,2761
2009,Sudan,"Wuror, Jos",0,0,0,0,0,0,0,0,0,0,0,0,2,0,0,2
2009,Sudan,White Nile,0,0,0,0,1,0,0,1,0,0,0,0,1,0,0,1
2009,Sudan,Western Darfur,0,0,0,0,0,0,251002,251002,0,0,0,0,0,0,251002,251002
2009,Sudan,"Wau, Wbgs",6,0,0,10,20,0,0,36,3,0,0,6,12,0,0,21
2009,Sudan,Wad Sherife Village,27,56,0,33,102,8,0,226,34,55,0,51,36,7,0,183
2009,Sudan,Wad Sherife,981,1357,0,1353,4672,484,0,8847,1054,1412,0,1331,2488,494,0,6779
2009,Sudan,Wad Medani,0,1,0,0,0,0,0,1,0,0,0,0,0,1,0,1
2009,Sudan,Wad El Hileau,0,3,0,0,1,0,0,4,1,1,0,0,2,0,0,4
2009,Sudan,Um Shalaya,1132,964,0,0,1575,328,0,3999,1043,1006,0,0,773,171,0,2993
2009,Sudan,Um Gorjo,0,0,0,0,0,0,10,10,0,0,0,0,0,0,10,10
2009,Sudan,Um Gargur,552,744,0,674,2142,218,0,4330,575,841,0,772,1837,360,0,4385
2009,Sudan,Um Dukhun,0,0,0,0,0,0,4416,4416,0,0,0,0,0,0,4416,4416
2009,Sudan,"Ulang, Ups",0,0,0,11,8,0,0,19,4,0,0,11,9,0,0,24
2009,Sudan,"Twic East, Jos",3,0,0,3,6,1,0,13,3,0,0,9,5,0,0,17
2009,Sudan,"Torit, EES",24,0,0,39,45,3,0,111,12,0,0,60,57,0,0,129
2009,Sudan,"Tonj, Warrab",0,0,0,3,5,0,0,8,2,0,0,2,14,0,0,18
2009,Sudan,"Tonga, Ups",0,0,0,0,1,0,0,1,1,0,0,0,0,0,0,1
2009,Sudan,Tokar,0,0,0,0,0,0,0,0,0,0,0,0,1,0,0,1
2009,Sudan,"Terekeka, Ces",1,0,0,1,2,0,0,4,1,0,0,9,4,0,0,14
2009,Sudan,Tendelti ,0,0,0,0,0,0,1864,1864,0,0,0,0,0,0,1864,1864
2009,Sudan,"Tambura, Wes",84,101,0,44,255,13,0,497,83,105,0,66,235,6,0,495
2009,Sudan,Suwakin,6,6,0,3,10,1,0,26,3,2,0,1,41,0,0,47
2009,Sudan,Southern Kordofan,1,0,0,0,6,0,0,7,0,0,0,0,9,0,0,9
2009,Sudan,Southern Darfur,0,0,0,0,0,0,5000,5000,0,0,0,0,0,0,5000,5000
2009,Sudan,Sinkat,0,0,0,0,0,0,0,0,0,0,0,0,1,0,0,1
2009,Sudan,"Singa, Bns",2,0,0,0,1,0,0,3,0,0,0,0,1,0,0,1
2009,Sudan,Shagarab 3,326,511,0,366,1373,110,0,2686,314,490,0,370,898,184,0,2256
2009,Sudan,Shagarab 2,370,584,0,425,1512,126,0,3017,380,603,0,503,1106,192,0,2784
2009,Sudan,Shagarab 1,655,1071,0,754,2793,219,0,5492,682,1144,0,820,2285,338,0,5269
2009,Sudan,"Sennar, Ses",0,0,0,0,1,0,0,1,0,0,0,0,2,0,0,2
2009,Sudan,Salalab,24,41,0,36,121,2,0,224,24,43,0,36,167,8,0,278
2009,Sudan,"Rumbek-Cueibet, Las",0,0,0,0,1,0,0,1,1,0,0,0,1,0,0,2
2009,Sudan,"Rumbek, Las",0,0,0,0,0,0,0,0,0,0,0,0,1,0,0,1
2009,Sudan,"Rumbek Centre, Las",0,0,0,0,1,0,0,1,2,0,0,0,0,3,0,5
2009,Sudan,"Rubkona, Uns",0,0,0,0,1,0,0,1,2,0,0,2,2,0,0,6
2009,Sudan,"Rubkoana, Uns",0,0,0,0,0,0,0,0,0,0,0,0,2,0,0,2
2009,Sudan,"Renk, Ups",0,0,0,0,0,0,0,0,0,0,0,0,1,0,0,1
2009,Sudan,"Red Sea, Rss",0,0,0,1,1,0,0,2,0,0,0,0,1,0,0,1
2009,Sudan,Red Sea,0,0,0,0,0,0,0,0,0,0,0,0,1,0,0,1
2009,Sudan,"Raja, Wbgs",0,0,0,0,1,0,0,1,0,0,0,1,0,0,0,1
2009,Sudan,Port Sudan,59,111,0,84,246,10,0,510,82,98,0,79,451,7,0,717
2009,Sudan,Pochalla,290,505,0,131,717,24,0,1667,286,478,0,136,255,20,0,1175
2009,Sudan,"Panyikango, Ups",0,0,0,0,0,0,0,0,0,0,0,0,1,0,0,1
2009,Sudan,"Old Fangak, Jos",0,0,0,0,0,0,0,0,0,0,0,1,2,0,0,3
2009,Sudan,"Nzara, Wes",132,146,0,72,489,30,0,869,134,163,0,82,487,36,0,902
2009,Sudan,"Nyirol, Jos",0,0,0,1,0,0,0,1,0,0,0,1,0,0,0,1
2009,Sudan,Nyala,0,0,0,0,0,0,0,0,0,0,0,0,18,0,0,18
2009,Sudan,"North Bor, Jos",0,0,0,0,0,0,0,0,0,0,0,0,1,0,0,1
2009,Sudan,New Halfa,0,1,0,0,1,0,0,2,0,3,0,2,1,0,0,6
2009,Sudan,"Mundri, Wes",4,0,0,16,17,1,0,38,9,0,0,16,9,1,0,35
2009,Sudan,Mukjar,154,0,0,121,146,14,0,435,120,0,0,133,148,10,0,411
2009,Sudan,"Morobo, Ces",90,0,0,281,263,32,0,666,119,0,0,294,141,16,0,570
2009,Sudan,"Maridi, Wes",2,0,0,2,3,0,0,7,0,0,0,6,2,0,0,8
2009,Sudan,Marghania,8,10,0,4,41,0,0,63,6,10,0,12,78,1,0,107
2009,Sudan,"Malakal, Ups",9,0,0,10,23,2,0,44,4,0,0,8,8,0,0,20
2009,Sudan,Malakal,29,13,0,4,69,1,0,116,38,10,0,8,111,1,0,168
2009,Sudan,"Maiwut, Ups",17,0,0,30,33,1,0,81,25,0,0,31,19,1,0,76
2009,Sudan,"Magwi, EES",1199,0,0,2034,2443,246,0,5922,1274,0,0,2099,1519,148,0,5040
2009,Sudan,"Mabaan, Ups",9,0,0,14,13,0,0,36,7,0,0,8,6,1,0,22
2009,Sudan,"Luakpiny, Ups",13,0,0,36,42,0,0,91,13,0,0,61,14,0,0,88
2009,Sudan,"Lopa/Lafon, Ees",21,0,0,32,39,0,0,92,25,0,0,50,56,2,0,133
2009,Sudan,"Longechuk, Ups",56,0,0,53,49,5,0,163,69,0,0,60,52,0,0,181
2009,Sudan,"Leer, Uns",1,0,0,1,2,0,0,4,0,0,0,2,1,0,0,3
2009,Sudan,"Lainya, Ces",45,0,0,103,109,5,0,262,46,0,0,89,54,8,0,197
2009,Sudan,"Kurmuk, Bns",10,0,0,26,17,0,0,53,12,0,0,19,15,0,0,46
2009,Sudan,"Koch, Uns",0,0,0,0,0,0,0,0,0,0,0,0,1,0,0,1
2009,Sudan,Kilo 7,24,31,0,20,124,13,0,212,32,39,0,33,107,20,0,231
2009,Sudan,Kilo 26,504,672,0,582,2030,191,0,3979,554,662,0,633,1490,292,0,3631
2009,Sudan,Khartoum,198,679,0,634,3387,99,271912,276909,173,690,0,710,4020,148,271911,277652
2009,Sudan,Kassala,22,23,0,21,70,5,0,141,20,25,0,23,36,3,0,107
2009,Sudan,Karkora,1,1,0,4,2,2,0,10,1,1,0,0,2,0,0,4
2009,Sudan,"Kapoeta, Ees",0,0,0,0,0,0,0,0,0,0,0,0,1,0,0,1
2009,Sudan,"Kapoeta South, Ees",3,0,0,10,9,0,0,22,7,0,0,8,5,1,0,21
2009,Sudan,"Kapoeta East, Ees",0,0,0,3,4,0,0,7,1,0,0,3,0,0,0,4
2009,Sudan,"Kajo Keji, CES",1169,0,0,2508,2711,141,0,6529,1164,0,0,2408,1521,81,0,5174
2009,Sudan,"Kadugli, South Kordofan",5,0,0,1,3,0,0,9,1,0,0,4,2,0,0,7
2009,Sudan,Juba,342,77,0,551,804,50,1,1825,369,71,0,572,817,26,5,1860
2009,Sudan,"Ikotos, Ees",1,0,0,5,5,0,0,11,0,0,0,9,2,0,0,11
2009,Sudan,"Ibba, Wes",60,92,0,30,201,12,0,395,57,86,0,40,164,14,0,361
2009,Sudan,Hawata,2,0,0,0,1,0,0,3,0,0,0,1,0,0,0,1
2009,Sudan,Habila area,0,0,0,0,0,0,7500,7500,0,0,0,0,0,0,7500,7500
2009,Sudan,Gulsa,0,2,0,2,2,0,0,6,2,0,0,0,0,0,0,2
2009,Sudan,"Guit, Uns",0,0,0,0,1,0,0,1,0,0,0,0,0,0,0,0
2009,Sudan,"Gogrial, Warrab",0,0,0,1,2,0,0,3,0,0,0,0,2,0,0,2
2009,Sudan,Girba,406,462,0,404,1583,152,0,3007,445,484,0,457,1029,223,0,2638
2009,Sudan,Gedaref,6,6,0,2,12,0,0,26,5,4,0,1,5,0,0,15
2009,Sudan,Fau Town,0,1,0,0,1,0,0,2,1,2,0,0,0,0,0,3
2009,Sudan,Fau 5,67,91,0,49,231,17,0,455,88,89,0,52,212,34,0,475
2009,Sudan,Fath El Rahman,14,28,0,29,82,16,0,169,18,25,0,22,70,18,0,153
2009,Sudan,"Ezo, Wes",362,366,0,178,1050,85,0,2041,342,391,0,190,955,76,0,1954
2009,Sudan,"El Gazira, El Gazira",0,0,0,0,2,0,0,2,0,0,0,2,0,0,0,2
2009,Sudan,"Ed Daleng, South Kordofan",2,0,0,0,1,0,0,3,0,0,0,0,1,0,0,1
2009,Sudan,Eastern Sudan,25,8,0,6,24,1,0,64,24,6,0,8,24,2,0,64
2009,Sudan,"Duk, Jos",0,0,0,0,0,0,0,0,0,0,0,1,3,0,0,4
2009,Sudan,Dordeab,1,2,0,2,3,0,0,8,1,0,0,0,1,0,0,2
2009,Sudan,Doka,0,0,0,0,1,0,0,1,0,0,0,0,0,0,0,0
2009,Sudan,Diam El-Nour,21,28,0,32,114,2,0,197,19,30,0,32,222,9,0,312
2009,Sudan,"Cueibet, Las",0,0,0,1,2,0,0,3,0,0,0,0,0,0,0,0
2009,Sudan,"Budi, Ees",23,0,0,60,45,8,0,136,20,0,0,34,34,1,0,89
2009,Sudan,Bor,29,0,0,69,95,7,0,200,37,0,0,74,33,2,0,146
2009,Sudan,Bir Saleeba area,0,0,0,0,0,0,1500,1500,0,0,0,0,0,0,1500,1500
2009,Sudan,"Ayod, Jos",0,0,0,0,0,0,0,0,0,0,0,0,2,0,0,2
2009,Sudan,"Aweil, Nbgs",0,0,0,0,0,1,0,1,0,0,0,1,3,0,0,4
2009,Sudan,"Aweil West, Nbgs",0,0,0,5,6,0,0,11,3,0,0,3,3,0,0,9
2009,Sudan,"Aweil South, Nbgs",2,0,0,6,6,0,0,14,6,0,0,3,6,0,0,15
2009,Sudan,"Aweil North, Nbgs",2,0,0,4,12,0,0,18,0,0,0,8,14,1,0,23
2009,Sudan,"Aweil East, Nbgs",0,0,0,0,3,0,0,3,0,0,0,0,6,0,0,6
2009,Sudan,Awad El Sid,34,53,0,36,159,13,0,295,49,62,0,46,122,31,0,310
2009,Sudan,Asotriba,0,0,0,0,0,0,0,0,0,0,0,0,3,0,0,3
2009,Sudan,Aroma,0,0,0,0,0,0,0,0,0,0,0,0,1,0,0,1
2009,Sudan,Armankul ,0,0,0,0,0,0,1669,1669,0,0,0,0,0,0,1668,1668
2009,Sudan,"Akobo, Jos",0,0,0,0,0,0,0,0,0,0,0,0,1,0,0,1
2009,Sudan,Abuda,201,273,0,229,721,60,0,1484,184,281,0,246,586,89,0,1386
2009,Senegal,Richard Toll,550,1024,0,725,1893,201,0,4393,650,739,0,594,1984,185,0,4152
2009,Senegal,Ourossogui,1082,1046,0,1019,2769,274,0,6190,1175,815,0,1205,2365,281,0,5841
2009,Senegal,Dakar/Thies,50,73,0,57,173,5,0,358,50,86,0,50,240,17,0,443
2009,Senegal,Dakar,43,50,0,77,935,22,0,1127,54,93,0,85,2180,31,0,2443
2009,Singapore,Singapore,0,0,0,0,3,0,0,3,0,0,0,0,4,0,0,4
2009,Sierra Leone,Tobanda,16,60,0,56,141,6,0,279,15,53,0,36,131,8,0,243
2009,Sierra Leone,Taiama,18,82,0,40,155,5,0,300,18,68,0,43,235,3,0,367
2009,Sierra Leone,Largo,8,50,0,38,104,7,0,207,11,47,0,33,75,6,0,172
2009,Sierra Leone,Kenema,43,152,0,191,681,22,0,1089,34,125,0,171,784,53,0,1167
2009,Sierra Leone,Jimmi Bagbo,20,30,0,24,104,0,0,178,6,45,0,22,140,5,0,218
2009,Sierra Leone,Jembe,8,42,0,36,93,3,0,182,7,48,0,39,116,4,0,214
2009,Sierra Leone,Gondama,20,138,0,108,292,5,0,563,24,158,0,93,287,10,0,572
2009,Sierra Leone,Gerihun,14,39,0,26,81,5,0,165,7,28,0,41,92,6,0,174
2009,Sierra Leone,Freetown,28,150,0,185,779,20,0,1162,48,143,0,185,675,21,0,1072
2009,Sierra Leone,Bo,6,39,0,47,252,10,0,354,8,29,0,52,178,12,0,279
2009,Sierra Leone,Bandajuma,9,41,0,19,81,2,0,152,8,41,0,26,69,7,0,151
2009,El Salvador,San Salvador,0,2,0,0,3,2,0,7,0,0,0,4,53,1,0,58
2009,El Salvador,La Union,0,0,0,0,6,0,0,6,0,0,0,0,13,1,0,14
2009,El Salvador,Cuscatlan,0,0,0,0,1,0,0,1,0,1,0,0,1,0,0,2
2009,Somalia,Woqooyi Galbeed,446,372,0,150,1155,18,14,2155,472,412,0,158,1461,31,7,2541
2009,Somalia,Togdheer,1,0,0,0,0,0,0,1,0,0,0,0,2,0,0,2
2009,Somalia,South Central,158585,150311,0,96530,274421,24822,0,704669,148932,154448,0,97909,250978,22064,0,674331
2009,Somalia,Sool,0,0,0,0,2,0,0,2,1,0,0,0,0,0,0,1
2009,Somalia,Somaliland,7705,7303,0,4690,13333,1206,0,34237,7236,7504,0,4757,12194,1072,0,32763
2009,Somalia,Puntland,11960,11336,0,7280,20696,1872,0,53144,11232,11648,0,7384,18928,1664,0,50856
2009,Somalia,Nugaal,20,17,0,10,88,1,0,136,24,18,0,15,174,3,0,234
2009,Somalia,Mudug,29,12,0,4,60,1,0,106,38,14,0,9,87,9,0,157
2009,Somalia,Bari,139,115,0,65,378,10,0,707,103,112,0,71,764,23,0,1073
2009,Somalia,Bakool,0,0,0,0,1,0,0,1,0,0,0,0,2,0,0,2
2009,Serbia and Kosovo (S/RES/1244 (1999)),Vojvodina,23,1354,0,2118,15209,9179,0,27883,31,1488,0,2289,17877,5641,0,27326
2009,Serbia and Kosovo (S/RES/1244 (1999)),Serbia (excluding Kosovo),2000,1950,0,2400,1700,300,0,8350,2000,1950,0,2400,1700,300,0,8350
2009,Serbia and Kosovo (S/RES/1244 (1999)),Kosovo,1,9,0,2,56,28,10389,10485,3,8,0,2,90,21,13211,13335
2009,Serbia and Kosovo (S/RES/1244 (1999)),Central/Southern Serbia,12,4515,0,6547,36608,12864,0,60546,11,4848,0,6840,37047,10441,0,59187
2009,Serbia and Kosovo (S/RES/1244 (1999)),Belgrade/West of Serbia,48,3776,0,5761,34590,15202,0,59377,40,4006,0,6195,36311,10501,0,57053
2009,Suriname,Paramaribo,0,0,0,0,0,0,0,0,0,0,0,0,1,0,0,1
2009,Slovakia,Zvolen,0,0,0,0,0,0,0,0,0,0,0,0,1,0,0,1
2009,Slovakia,Secovce,0,0,0,0,1,0,0,1,0,0,0,0,18,0,0,18
2009,Slovakia,Rohovce,0,0,0,0,2,0,0,2,0,0,0,2,52,2,0,56
2009,Slovakia,Opatovska,0,0,0,2,10,0,0,12,0,0,0,8,40,0,0,48
2009,Slovakia,Medvedov,0,0,0,0,0,0,0,0,0,0,0,0,8,0,0,8
2009,Slovakia,Kosice,3,0,0,1,6,0,0,10,0,0,0,1,8,1,0,10
2009,Slovakia,Humenne,6,5,0,6,19,3,0,39,3,1,0,10,55,3,0,72
2009,Slovenia,Ljubljana,0,5,0,0,37,0,0,42,0,6,0,28,253,0,0,287
2009,Swaziland,Malindza,14,14,0,18,75,0,0,121,19,20,0,22,74,0,0,135
2009,Chad,Yaroungou,1101,1561,0,928,2634,197,0,6421,1029,1599,0,940,1801,135,0,5504
2009,Chad,Treguine,1956,1800,0,1028,4021,460,0,9265,1967,1880,0,1076,2484,328,0,7735
2009,Chad,Touloum,2357,4519,0,2117,5552,652,0,15197,2391,3980,0,1936,2671,357,0,11335
2009,Chad,Sp Goz Beida,0,0,0,0,0,0,5050,5050,0,0,0,0,0,0,5011,5011
2009,Chad,Sp  Koukou,0,0,0,0,0,0,2151,2151,0,0,0,0,0,0,2250,2250
2009,Chad,Sihep (Sp Amtiman),113,119,0,64,201,14,0,511,110,134,0,83,127,22,0,476
2009,Chad,Sannour (Sp Gozbeida),61,87,0,43,152,10,0,353,79,95,0,44,81,13,0,312
2009,Chad,Oure Cassoni,2512,5169,0,2183,6749,580,0,17193,2607,4676,0,1634,2409,277,0,11603
2009,Chad,Ndjamena,27,24,0,8,65,1,0,125,28,25,0,11,181,7,0,252
2009,Chad,Moula,810,825,0,239,1170,60,0,3104,847,922,0,274,991,58,0,3092
2009,Chad,Mile,1291,2164,0,1111,3477,382,0,8425,1308,1944,0,942,1397,205,0,5796
2009,Chad,Massabange 2,63,30,0,46,86,30,0,255,61,30,0,38,72,30,0,231
2009,Chad,Massabange 1,386,100,0,185,334,180,0,1185,357,129,0,140,267,175,0,1068
2009,Chad,Kounoungou,1470,2605,0,1267,3872,321,0,9535,1422,2461,0,1187,1423,209,0,6702
2009,Chad,Koubigou (Sp Gozbeida),1231,2019,0,1048,2190,139,0,6627,1065,1845,0,834,902,94,0,4740
2009,Chad,Koloma (Sp Gozbeida),734,1067,0,521,1406,137,0,3865,687,1164,0,518,1022,133,0,3524
2009,Chad,Koi,310,200,0,136,386,129,0,1161,291,123,0,180,322,129,0,1045
2009,Chad,Kerfi (Sp Gozbeida),468,687,0,293,972,88,0,2508,475,719,0,291,628,65,0,2178
2009,Chad,Iridimi,1765,2894,0,1612,3910,407,0,10588,1719,2631,0,1502,1475,239,0,7566
2009,Chad,Ideter (Sp Amtiman),16,31,0,9,38,1,0,95,19,25,0,6,19,2,0,71
2009,Chad,Habile3,1029,2290,0,1168,2164,216,0,6867,993,2119,0,1071,1212,193,0,5588
2009,Chad,Habile2,1168,2136,0,865,1923,226,0,6318,1163,1853,0,662,1096,167,0,4941
2009,Chad,Habile1,1106,1773,0,759,1807,191,0,5636,1122,1714,0,644,839,152,0,4471
2009,Chad,Goz Amer,2318,2323,0,1470,5104,550,0,11765,2415,2405,0,1338,3078,448,0,9684
2009,Chad,Gouroukoun (Sp Gozbeida),2096,3025,0,1298,3408,302,0,10129,1986,2834,0,1127,1542,218,0,7707
2009,Chad,Gondje,854,1818,0,864,2371,83,0,5990,830,1761,0,944,1599,60,0,5194
2009,Chad,Gassire (Sp Gozbeida),2002,2931,0,1456,3416,276,0,10081,1919,2867,0,1164,1669,266,0,7885
2009,Chad,Ganachour (Sp Gozbeida),203,290,0,124,355,25,0,997,181,294,0,155,224,36,0,890
2009,Chad,Gaga,2182,2601,0,1203,4283,319,0,10588,2095,2562,0,1218,2337,243,0,8455
2009,Chad,Farchana,2098,2679,0,1625,4815,572,0,11789,2046,2691,0,1423,2611,355,0,9126
2009,Chad,Dosseye,998,1579,0,776,1970,96,0,5419,940,1436,0,626,1076,110,0,4188
2009,Chad,Djabal,1622,1798,0,1123,3846,358,0,8747,1633,1831,0,1026,2178,278,0,6946
2009,Chad,Daha 2,572,300,0,313,1040,227,0,2452,442,270,0,331,897,232,0,2172
2009,Chad,Daha 1,587,400,0,418,1641,667,0,3713,225,100,0,175,914,181,0,1595
2009,Chad,Bredjing,3450,3491,0,2077,7910,901,0,17829,3487,3532,0,2148,4973,590,0,14730
2009,Chad,Betimera,72,35,0,42,87,53,0,289,70,33,0,40,71,52,0,266
2009,Chad,Bedina (Sp Amtiman),84,102,0,48,170,28,0,432,72,101,0,59,75,18,0,325
2009,Chad,Arkoum (Sp Hadjer-Hadid),617,1056,0,516,1591,152,0,3932,621,926,0,442,754,108,0,2851
2009,Chad,Ardo (Sp Amtiman),163,234,0,100,348,30,0,875,195,210,0,88,206,18,0,717
2009,Chad,Aradib2,365,645,0,319,658,92,0,2079,389,593,0,237,459,76,0,1754
2009,Chad,Aradib1,1284,2412,0,1212,2365,286,0,7559,1241,2240,0,1121,1324,219,0,6145
2009,Chad,Amboko,822,1948,0,1040,2290,97,0,6197,747,1803,0,1172,1539,213,0,5474
2009,Chad,Am Nabak,1321,2761,0,1557,4507,473,0,10619,1353,2548,0,1077,1512,293,0,6783
2009,Chad,Al Kouk (Sp Amtiman),83,109,0,58,146,20,0,416,81,110,0,46,75,9,0,321
2009,Chad,Ade (Sp Gozbeida),1230,2233,0,1218,3290,138,0,8109,1402,2492,0,1426,2354,215,0,7889
2009,Chad,Able (Sp Amtiman),23,18,0,13,51,6,0,111,23,28,0,8,22,4,0,85
2009,Chad,Sp Hadjer-Hadid (Farchana Area),0,0,0,0,0,0,3607,3607,0,0,0,0,0,0,2702,2702
2009,Chad,Goundiang (Sp Hadjer-Hadid),81,134,0,77,216,16,0,524,84,111,0,56,110,21,0,382
2009,Chad,Canton Wadi Kadja (Sp Dogdore),814,1057,0,533,2249,163,0,4816,838,1097,0,400,1133,187,0,3655
2009,Chad,Canton Signar Dadjo (Sp Dogdore),167,240,0,144,463,33,0,1047,172,279,0,89,195,32,0,767
2009,Chad,Canton Signar (Sp Dogdore),384,647,0,303,1121,166,0,2621,361,590,0,260,551,104,0,1866
2009,Chad,Canton Dogdore Et Residents (Sp Dogdore),130,160,0,92,337,27,0,746,133,155,0,73,192,40,0,593
2009,Chad,Canton Barh Azoum Ambrouine (Sp Dogdore),558,730,0,436,1551,121,0,3396,644,767,0,323,720,148,0,2602
2009,Chad,Canton Barh Azoum (Sp Dogdore),476,669,0,342,1330,124,0,2941,547,783,0,321,663,86,0,2400
2009,Chad,Alacha-Alentours (Sp Hadjer-Hadid),158,263,0,144,471,40,0,1076,162,221,0,124,188,34,0,729
2009,Togo,Sotouboua,998,1556,0,552,1507,21,0,4634,1095,992,0,423,903,12,0,3425
2009,Togo,Lome,22,33,0,37,152,3,0,247,29,36,0,42,266,2,0,375
2009,Togo,Golfe,22,16,0,9,49,4,0,100,23,17,0,9,30,1,0,80
2009,Thailand,Umpium,725,1104,0,890,3230,259,0,6208,805,1106,0,989,3152,234,0,6286
2009,Thailand,Tham Hin,360,400,0,380,1101,119,0,2360,365,433,0,331,992,113,0,2234
2009,Thailand,Nu Po,711,820,0,712,2406,206,0,4855,756,824,0,772,2388,205,0,4945
2009,Thailand,Mae Sot,156,312,0,277,1285,50,0,2080,159,364,0,316,1680,50,0,2569
2009,Thailand,Mae Ra Ma Luang,980,1372,0,962,3096,277,0,6687,964,1463,0,1029,3092,336,0,6884
2009,Thailand,Mae La Oon,986,1229,0,929,3259,282,0,6685,1016,1334,0,1006,3466,304,0,7126
2009,Thailand,Mae La,1939,2797,0,2242,7329,869,0,15176,2023,2894,0,2444,6791,745,0,14897
2009,Thailand,Bangkok,176,239,0,235,1852,34,0,2536,205,305,0,239,3600,59,0,4408
2009,Thailand,Ban Mae Surin,211,256,0,218,765,54,0,1504,194,287,0,213,782,76,0,1552
2009,Thailand,Ban Mae Nai Soi,969,1248,0,837,3153,381,0,6588,1085,1268,0,787,3310,364,0,6814
2009,Thailand,Ban Don Yang,257,257,0,240,791,70,0,1615,266,272,0,250,687,68,0,1543
2009,Tajikistan,Dushanbe,3,5,0,6,14,2,0,30,2,6,0,4,20,2,0,34
2009,Turkmenistan,Turkmenbashi,0,0,0,0,4,4,0,8,0,0,0,1,3,1,0,5
2009,Turkmenistan,Turkmenabat,1,1,0,4,6,0,0,12,0,0,0,2,9,0,0,11
2009,Turkmenistan,Ashgabat,0,0,0,1,7,3,0,11,0,2,0,1,9,0,0,12
2009,Turkmenistan,Abadan,0,0,0,0,1,0,0,1,0,0,0,0,0,0,0,0
2009,Timor-Leste,Dili,0,0,0,0,0,0,0,0,0,0,0,0,11,0,0,11
2009,Trinidad and Tobago,Port of Spain,0,0,0,0,14,0,0,14,3,3,0,5,208,0,0,219
2009,Tunisia,Tunis,3,3,0,0,31,6,0,43,2,3,0,4,58,5,0,72
2009,Tunisia,Sousse,0,0,0,0,0,0,0,0,0,0,0,0,2,0,0,2
2009,Tunisia,Sfax,0,1,0,0,1,0,0,2,1,0,0,1,1,0,0,3
2009,Tunisia,Monastir,0,0,0,0,2,0,0,2,0,0,0,0,2,1,0,3
2009,Tunisia,Bizerte,0,0,0,0,1,0,0,1,0,0,0,0,0,0,0,0
2009,Turkey,Yozgat Camp,4,1,0,0,6,0,0,11,2,0,0,0,5,0,0,7
2009,Turkey,Yozgat,6,17,0,9,57,3,0,92,14,9,0,12,77,6,0,118
2009,Turkey,Van,101,156,0,130,570,14,0,971,94,168,0,179,820,23,0,1284
2009,Turkey,Tokat,24,26,0,32,151,10,0,243,28,28,0,25,207,13,0,301
2009,Turkey,Sivas,7,11,0,13,82,6,0,119,8,9,0,19,106,10,0,152
2009,Turkey,Sirnak,1,3,0,3,16,0,0,23,6,5,0,3,53,1,0,68
2009,Turkey,Silopi,0,2,0,1,1,0,0,4,0,0,0,2,3,0,0,5
2009,Turkey,Nigde,9,24,0,11,111,6,0,161,9,13,0,22,141,4,0,189
2009,Turkey,Nevsehir,11,17,0,20,186,5,0,239,7,14,0,20,279,6,0,326
2009,Turkey,Mugla,0,0,0,0,0,0,0,0,0,0,0,1,1,0,0,2
2009,Turkey,Mersin,0,0,0,0,7,2,0,9,1,0,0,0,11,1,0,13
2009,Turkey,Mardin,1,1,0,1,6,1,0,10,2,0,0,0,4,1,0,7
2009,Turkey,Manisa,0,0,0,0,1,0,0,1,0,0,0,0,3,0,0,3
2009,Turkey,Kutahya,12,17,0,14,81,1,0,125,10,14,0,14,117,2,0,157
2009,Turkey,Konya,29,45,0,39,202,4,0,319,39,42,0,33,255,4,0,373
2009,Turkey,Kocaeli,0,0,0,0,1,0,0,1,0,0,0,0,2,0,0,2
2009,Turkey,Kirsehir,12,25,0,30,137,7,0,211,20,26,0,31,199,19,0,295
2009,Turkey,Kirklareli,1,0,0,0,4,0,0,5,0,0,0,1,15,0,0,16
2009,Turkey,Kirikkale,2,3,0,3,21,0,0,29,3,2,0,5,20,0,0,30
2009,Turkey,Kilis,0,0,0,0,0,0,0,0,0,0,0,0,7,0,0,7
2009,Turkey,Kayseri,24,38,0,45,377,20,0,504,28,37,0,63,464,10,0,602
2009,Turkey,Kastamonu,15,21,0,5,82,4,0,127,12,14,0,12,137,2,0,177
2009,Turkey,Karaman,13,19,0,13,62,2,0,109,14,17,0,21,93,2,0,147
2009,Turkey,K.Maras,0,0,0,0,0,0,0,0,0,0,0,0,2,0,0,2
2009,Turkey,Izmit,0,0,0,0,0,0,0,0,0,0,0,0,2,0,0,2
2009,Turkey,Izmir,4,2,0,2,25,0,0,33,5,3,0,8,100,0,0,116
2009,Turkey,Istanbul,44,66,0,60,411,20,0,601,70,84,0,116,836,30,0,1136
2009,Turkey,Isparta,31,29,0,33,166,2,0,261,23,42,0,32,218,1,0,316
2009,Turkey,Hatay,7,0,0,9,38,1,0,55,1,3,0,6,71,0,0,81
2009,Turkey,Hakkari,0,1,0,0,5,0,0,6,1,2,0,0,11,0,0,14
2009,Turkey,Gaziantep,33,44,0,34,172,4,0,287,36,57,0,54,307,6,0,460
2009,Turkey,Eskisehir,31,29,0,34,192,7,0,293,21,29,0,24,268,10,0,352
2009,Turkey,Edirne,0,0,0,0,1,0,0,1,0,1,0,0,8,0,0,9
2009,Turkey,Corum,16,20,0,18,105,0,0,159,18,31,0,19,132,5,0,205
2009,Turkey,Cankiri,10,14,0,13,53,0,0,90,7,16,0,12,109,2,0,146
2009,Turkey,Canakkale,0,1,0,0,1,0,0,2,0,2,0,1,0,0,0,3
2009,Turkey,Bursa,0,0,0,0,2,0,0,2,1,0,0,0,3,0,0,4
2009,Turkey,Burdur,10,10,0,11,53,1,0,85,3,8,0,3,60,0,0,74
2009,Turkey,Bitlis,0,0,0,0,0,0,0,0,0,0,0,0,2,0,0,2
2009,Turkey,Bilecik,15,14,0,19,98,16,0,162,20,23,0,23,132,7,0,205
2009,Turkey,Aydin,0,0,0,0,2,0,0,2,1,1,0,0,1,0,0,3
2009,Turkey,Antalya,0,0,0,0,1,0,0,1,0,0,0,0,1,0,0,1
2009,Turkey,Ankara,24,22,0,22,164,11,0,243,31,29,0,26,298,12,0,396
2009,Turkey,Amasya,11,18,0,15,102,10,0,156,20,22,0,26,129,7,0,204
2009,Turkey,Aksaray,12,27,0,35,126,3,0,203,20,33,0,34,180,3,0,270
2009,Turkey,Agri,29,33,0,40,155,0,0,257,31,52,0,57,358,7,0,505
2009,Turkey,Afyon,60,51,0,47,348,26,0,532,57,53,0,63,502,29,0,704
2009,Turkey,Adapazari,0,0,0,0,0,0,0,0,0,0,0,0,2,0,0,2
2009,Turkey,Adana,0,0,0,0,2,1,0,3,0,0,0,0,1,0,0,1
2009,United Rep. of Tanzania,Nyarugusu,5930,7666,0,4663,13567,689,0,32515,6002,7474,0,4716,10882,595,0,29669
2009,United Rep. of Tanzania,Mtabila 1,3488,4219,0,2282,7465,232,0,17686,3660,4361,0,2452,7548,302,0,18323
2009,United Rep. of Tanzania,Kanembwa,283,321,0,249,650,23,0,1526,278,346,0,277,759,20,0,1680
2009,United Rep. of Tanzania,Chogo,120,194,0,208,342,28,0,892,92,92,0,118,246,7,0,555
2009,Uganda,Rhino Camp,114,230,0,182,247,17,0,790,92,252,0,200,151,15,0,710
2009,Uganda,Palorinya,216,272,0,199,554,30,0,1271,243,321,0,173,409,15,0,1161
2009,Uganda,Pakelle,761,1043,0,655,1977,104,0,4540,776,1035,0,674,1416,56,0,3957
2009,Uganda,Oruchinga,192,245,0,142,421,25,0,1025,182,229,0,140,429,27,0,1007
2009,Uganda,Nakivale,5240,5827,0,3012,11146,433,0,25658,5252,5737,0,3216,11938,448,0,26591
2009,Uganda,Madi-Okollo,51,79,0,60,183,16,0,389,42,92,0,82,175,7,0,398
2009,Uganda,Kyangwali,1909,2387,0,1430,4424,249,0,10399,1891,2407,0,1438,4262,209,0,10207
2009,Uganda,Kiryandongo,297,489,0,381,1041,92,0,2300,279,468,0,409,941,76,0,2173
2009,Uganda,Kayaka II,1843,2139,0,1179,3494,264,0,8919,1766,2024,0,1283,3156,294,0,8523
2009,Uganda,Kampala,1105,2057,0,2031,6666,189,0,12048,1158,2045,0,1990,9575,178,0,14946
2009,Uganda,Imvepi,129,245,0,220,268,17,0,879,156,304,0,295,247,3,0,1005
2009,Uruguay,Montevideo,3,4,0,6,45,8,0,66,8,5,0,10,109,8,0,140
2009,Uruguay,Canelones,0,0,0,0,2,0,0,2,0,0,0,0,1,0,0,1
2009,Uzbekistan,Termez,0,0,0,0,6,0,0,6,0,0,0,0,19,1,0,20
2009,Uzbekistan,Tashkent,24,31,0,47,139,9,0,250,26,28,0,39,176,10,0,279
2009,Saint Vincent and the Grenadines,Beguia,0,0,0,0,0,0,0,0,0,0,0,0,1,0,0,1
2009,Venezuela (Bolivarian Republic of),Caracas,42,57,0,70,367,12,0,548,55,68,0,81,651,32,0,887
2009,Venezuela (Bolivarian Republic of),Zulia,291,370,0,257,925,43,26686,28572,335,358,0,268,1146,75,29961,32143
2009,Venezuela (Bolivarian Republic of),Tachira,315,382,0,313,1116,52,20116,22294,341,419,0,394,1333,65,21561,24113
2009,Venezuela (Bolivarian Republic of),Apure,263,382,0,323,912,63,7359,9302,312,378,0,322,965,89,7915,9981
2009,British Virgin Islands,Tortola,0,0,0,0,0,0,0,0,0,0,0,0,6,0,0,6
2009,Viet Nam,Thu Duc,0,0,0,0,0,0,39,39,0,0,0,0,0,0,39,39
2009,Viet Nam,Ho Chi Minh City,0,0,0,0,0,0,3700,3700,0,0,0,0,0,0,3500,3500
2009,Viet Nam,Cu Chi,0,0,0,0,0,0,129,129,0,0,0,0,0,0,104,104
2009,Viet Nam,Binh Phuoc,0,0,0,0,0,0,130,130,0,0,0,0,0,0,131,131
2009,Viet Nam,Binh Duong,0,0,0,0,0,0,930,930,0,0,0,0,0,0,855,855
2009,Vanuatu,Port Vila,0,0,0,0,0,0,0,0,0,0,0,0,3,1,0,4
2009,Yemen,Taiz,59,179,0,179,690,185,0,1292,56,340,0,340,650,180,0,1566
2009,Yemen,Shabwa,15,28,0,29,151,6,0,229,12,22,0,22,171,2,0,229
2009,Yemen,Sana'a,3549,4262,0,2215,13736,461,0,24223,4428,3864,0,2141,11736,461,0,22630
2009,Yemen,Sa'ada,10658,12310,0,5892,24131,540,0,53531,9875,9979,0,5413,15921,421,0,41609
2009,Yemen,Rada',29,18,0,17,56,5,0,125,25,33,0,32,62,5,0,157
2009,Yemen,Mukalla,79,371,0,318,556,33,0,1357,53,264,0,424,514,34,0,1289
2009,Yemen,Mahra,32,62,0,61,157,7,0,319,32,70,0,70,182,7,0,361
2009,Yemen,Hodeidah,20,40,0,41,109,24,0,234,19,55,0,55,104,19,0,252
2009,Yemen,Hajjah,11217,12949,0,6194,25375,564,0,56299,10392,10488,0,5682,16701,438,0,43701
2009,Yemen,Dhamar,18,19,0,18,78,2,0,135,17,16,0,16,47,4,0,100
2009,Yemen,Amran,3365,3885,0,1858,7613,169,0,16890,3118,3146,0,1705,5010,131,0,13110
2009,Yemen,Al-Baida,8,34,0,33,86,7,0,168,14,23,0,23,92,2,0,154
2009,Yemen,Al Kharaz,1734,1547,0,1051,3781,74,0,8187,1784,1503,0,1059,3851,82,0,8279
2009,Yemen,Al Jawf,1122,1295,0,619,2538,56,0,5630,1039,1049,0,568,1670,44,0,4370
2009,Yemen,Aden,493,1419,0,1112,3335,387,0,6746,479,1011,0,801,4569,326,0,7186
2009,Zambia,Mwange,193,823,0,763,861,125,0,2765,212,887,0,874,956,126,0,3055
2009,Zambia,Meheba,1540,1878,0,580,2903,262,0,7163,1443,1259,0,1113,3664,328,0,7807
2009,Zambia,Mayukwayukwa,1068,1059,0,867,1878,155,0,5027,1017,1034,0,815,2019,272,0,5157
2009,Zambia,Kala,470,354,0,422,827,26,0,2099,586,314,0,580,541,21,0,2042
2009,Zimbabwe,Tongogara,301,379,0,183,634,14,0,1511,311,405,0,243,926,12,0,1897
2009,Zimbabwe,Harare,96,109,0,76,269,4,0,554,86,114,0,84,378,6,0,668
2010,Afghanistan,Various,27774,36662,0,37538,168532,34330,0,304836,28171,34279,0,36740,160053,34378,0,293621
2010,Afghanistan,Zabul : Wilayat - Province,1245,2021,0,1155,3189,163,0,7773,1296,2114,0,1290,2993,304,0,7997
2010,Afghanistan,Wardak : Wilayat - Province,224,758,0,589,1693,64,0,3328,205,804,0,615,1610,159,0,3393
2010,Afghanistan,Uruzgan : Wilayat - Province,65,208,0,68,193,14,0,548,51,192,0,77,202,20,0,542
2010,Afghanistan,Takhar : Wilayat - Province,700,1662,0,882,2460,130,0,5834,684,1740,0,973,2884,233,0,6514
2010,Afghanistan,Sari Pul : Wilayat - Province,453,1097,0,638,1762,127,0,4077,512,1162,0,767,1811,205,0,4457
2010,Afghanistan,Samangan : Wilayat - Province,209,535,0,275,788,47,0,1854,198,519,0,292,790,68,0,1867
2010,Afghanistan,Parwan : Wilayat - Province,423,1414,0,885,2392,93,0,5207,425,1534,0,948,2626,176,0,5709
2010,Afghanistan,Panjsher : Wolaswalei - District,21,27,0,17,48,3,0,116,22,28,0,19,45,4,0,118
2010,Afghanistan,Panjsher : Wilayat - Province,14,47,0,40,110,4,0,215,17,49,0,43,128,9,0,246
2010,Afghanistan,Paktya : Wilayat - Province,1320,4307,0,2671,7087,370,0,15755,1432,4353,0,2961,5863,711,0,15320
2010,Afghanistan,Paktika : Wilayat - Province,179,574,0,284,769,40,0,1846,192,623,0,325,764,62,0,1966
2010,Afghanistan,Nuristan : Wilayat - Province,298,442,0,268,739,38,0,1785,306,441,0,293,696,65,0,1801
2010,Afghanistan,Nimroz : Wilayat - Province,7,40,0,30,70,8,0,155,15,59,0,27,106,10,0,217
2010,Afghanistan,Nangarhar : Wilayat - Province,20381,66563,0,36254,88139,4393,0,215730,20647,68655,0,39780,86006,6722,0,221810
2010,Afghanistan,Logar : Wilayat - Province,1106,4922,0,3061,7547,375,0,17011,1168,5162,0,3186,6627,636,0,16779
2010,Afghanistan,Laghman : Wilayat - Province,3047,8868,0,5116,12449,549,0,30029,2990,9132,0,5808,12302,992,0,31224
2010,Afghanistan,Kunduz : Wilayat - Province,2771,9479,0,4918,12514,650,0,30332,2943,9797,0,5276,12215,997,0,31228
2010,Afghanistan,Kunar : Wilayat - Province,3857,8806,0,5297,12902,604,0,31466,3904,9353,0,5819,12740,1092,0,32908
2010,Afghanistan,Khost : Wilayat - Province,1478,2722,0,1714,4655,262,0,10831,1557,2927,0,1989,4310,442,0,11225
2010,Afghanistan,Kapisa : Wilayat - Province,189,462,0,277,744,30,0,1702,200,444,0,318,800,65,0,1827
2010,Afghanistan,Kandahar : Wilayat - Province,5961,11142,0,5804,15956,903,0,39766,6120,11626,0,6661,15312,1408,0,41127
2010,Afghanistan,Kabul : Wolaswalei - District,2,2,0,0,5,0,0,9,0,0,0,1,19,0,0,20
2010,Afghanistan,Kabul : Wilayat - Province,4916,16427,0,10980,31930,1742,0,65995,5137,17358,0,12144,30075,2735,0,67449
2010,Afghanistan,Jawzjan : Wilayat - Province,1284,3068,0,1915,6526,489,0,13282,1281,3171,0,2007,6506,745,0,13710
2010,Afghanistan,Hirat : Wilayat - Province,5609,7639,0,4991,14388,753,0,33380,5897,7947,0,5338,14909,1329,0,35420
2010,Afghanistan,Hilmand : Wilayat - Province,7092,10097,0,6219,16927,888,0,41223,7364,10548,0,6824,15853,1558,0,42147
2010,Afghanistan,Ghor : Wilayat - Province,404,536,0,355,956,53,0,2304,421,566,0,374,979,89,0,2429
2010,Afghanistan,Ghazni : Wilayat - Province,952,4478,0,1655,5266,360,0,12711,934,4731,0,1918,5311,579,0,13473
2010,Afghanistan,Faryab : Wilayat - Province,1543,2581,0,1607,4777,296,0,10804,1647,2716,0,1662,4855,497,0,11377
2010,Afghanistan,Farah : Wilayat - Province,2187,2963,0,1880,5149,274,0,12453,2284,3094,0,2017,4805,461,0,12661
2010,Afghanistan,Day Kundi : Wolaswalei - District,16,20,0,13,35,2,0,86,16,21,0,14,33,3,0,87
2010,Afghanistan,Day Kundi : Wilayat - Province,54,381,0,195,554,32,0,1216,50,381,0,248,575,45,0,1299
2010,Afghanistan,Bamyan : Wilayat - Province,56,144,0,105,382,30,0,717,36,158,0,144,465,53,0,856
2010,Afghanistan,Balkh : Wilayat - Province,713,1952,0,1138,3478,252,0,7533,763,2005,0,1247,3515,387,0,7917
2010,Afghanistan,Baghlan : Wilayat - Province,879,3200,0,1797,4925,275,0,11076,896,3260,0,1984,4890,470,0,11500
2010,Afghanistan,Badghis : Wilayat - Province,781,1065,0,685,1914,110,0,4555,806,1109,0,733,1756,153,0,4557
2010,Afghanistan,Badakhshan : Wilayat - Province,20,110,0,58,158,10,0,356,24,107,0,106,814,19,0,1070
2010,Afghanistan,Afghanistan : Dispersed in the country / territory,0,0,0,0,0,0,18,18,0,0,0,0,0,0,31,31
2010,Angola,Zaire,0,0,0,0,0,0,8,8,0,0,0,0,0,0,13,13
2010,Angola,Namibe,0,0,0,0,0,0,1,1,0,0,0,0,0,0,0,0
2010,Angola,Moxico,0,0,0,0,0,0,1391,1391,0,0,0,0,0,0,1875,1875
2010,Angola,Malange,0,0,0,0,0,0,391,391,0,0,0,0,0,0,487,487
2010,Angola,Lunda Sul,0,0,0,0,0,0,446,446,0,0,0,0,0,0,649,649
2010,Angola,Lunda Norte/Sul,0,0,0,0,0,0,128,128,0,0,0,0,0,0,511,511
2010,Angola,Lunda Norte,0,0,0,0,0,0,184,184,0,0,0,0,0,0,260,260
2010,Angola,Lunda N/S,0,0,0,0,0,0,37,37,0,0,0,0,0,0,219,219
2010,Angola,Luanda S,0,0,0,0,0,0,2,2,0,0,0,0,0,0,50,50
2010,Angola,Luanda,0,0,0,0,0,0,5618,5618,0,0,0,0,0,0,6383,6383
2010,Angola,Kuanza Sul,0,0,0,0,0,0,125,125,0,0,0,0,0,0,129,129
2010,Angola,Kuanza Norte,0,0,0,0,0,0,19,19,0,0,0,0,0,0,24,24
2010,Angola,Huila,0,0,0,0,0,0,2,2,0,0,0,0,0,0,10,10
2010,Angola,Huambo,0,0,0,0,0,0,23,23,0,0,0,0,0,0,46,46
2010,Angola,Bie,0,0,0,0,0,0,1,1,0,0,0,0,0,0,0,0
2010,Angola,Benguela,0,0,0,0,0,0,1,1,0,0,0,0,0,0,0,0
2010,Angola,Bengo,0,0,0,0,0,0,328,328,0,0,0,0,0,0,308,308
2010,Albania,Tirana Urban : Point,4,2,0,2,6,3,0,17,4,4,0,1,21,1,0,31
2010,Albania,Tirana Camp : Point,0,1,0,3,9,1,0,14,2,2,0,4,22,2,0,32
2010,Albania,Peshkopi : Point,0,0,0,0,1,0,0,1,0,0,0,0,0,0,0,0
2010,Albania,Mamurras : Rreth - District,1,0,0,0,1,0,0,2,0,2,0,0,0,0,0,2
2010,United Arab Emirates,Abu Dhabi,36,60,0,157,43,0,0,296,42,71,0,153,59,3,0,328
2010,Armenia,Yerevan,19,38,0,57,507,197,0,818,26,38,0,55,577,108,0,804
2010,Armenia,Vayots Dzor marz,0,0,0,0,4,0,0,4,0,0,0,0,4,0,0,4
2010,Armenia,Tavush marz,0,0,0,0,26,26,0,52,0,0,0,0,28,14,0,42
2010,Armenia,Syunik marz,0,0,0,0,74,28,0,102,0,0,0,0,69,11,0,80
2010,Armenia,Shirak marz,0,0,0,0,21,5,0,26,0,0,0,0,22,5,0,27
2010,Armenia,Lori marz,0,0,0,0,47,15,0,62,0,0,0,0,51,11,0,62
2010,Armenia,Kotayk marz,0,0,0,0,164,101,0,265,0,0,0,0,178,51,0,229
2010,Armenia,Gegharkunik marz,0,0,0,0,43,18,0,61,0,0,0,0,59,14,0,73
2010,Armenia,Armavir marz,0,0,0,0,57,39,0,96,0,0,0,0,55,17,0,72
2010,Armenia,Ararat marz,0,0,0,0,99,56,0,155,0,0,0,0,136,46,0,182
2010,Armenia,Aragatsotn marz,0,0,0,0,42,23,0,65,0,0,0,0,34,10,0,44
2010,Azerbaijan,Baku : Point,116,144,0,99,452,30,0,841,101,168,0,124,653,21,0,1067
2010,Burundi,Musasa : Point,643,789,0,436,1209,57,0,3134,613,837,0,456,1091,22,0,3019
2010,Burundi,Gasorwe : Commune,911,1254,0,711,1864,86,0,4826,937,1209,0,744,1480,52,0,4422
2010,Burundi,Bwagiriza : Point,474,431,0,347,942,52,0,2246,508,509,0,337,880,46,0,2280
2010,Burundi,Butare,38,17,0,15,59,1,0,130,23,23,0,16,52,3,0,117
2010,Burundi,Bujumbura : Point,1251,2404,0,1959,5217,261,0,11092,1284,2398,0,1939,4343,197,0,10161
2010,Burundi,Burundi : Dispersed in the country / territory,587,723,0,321,1295,72,0,2998,640,672,0,317,1116,68,0,2813
2010,Belgium,Belgium : Dispersed in the country / territory,0,0,0,0,0,0,7774,7774,0,0,0,0,0,0,10809,10809
2010,Benin,Kpomasse : Point,9,7,0,8,64,2,0,90,10,11,0,17,87,1,0,126
2010,Benin,Cotonou : Departement,229,231,0,219,948,23,0,1650,222,258,0,182,1873,22,0,2557
2010,Benin,Agame : Point,203,235,0,168,650,22,0,1278,233,279,0,166,850,11,0,1539
2010,Bonaire,Krabendijk,0,0,0,0,0,0,0,0,0,0,0,0,1,0,0,1
2010,Burkina Faso,Ouagadougou : Point,45,72,0,56,231,2,0,406,26,55,0,52,521,5,0,659
2010,Bangladesh,Nayapara : Point,1440,2115,0,1561,3802,174,0,9092,1465,2217,0,1423,3160,190,0,8455
2010,Bangladesh,Kutupalong : Point,1021,1356,0,942,2405,123,0,5847,1053,1364,0,984,2109,112,0,5622
2010,Bangladesh,Dhaka : Point,9,17,0,5,56,1,0,88,10,16,0,4,113,6,0,149
2010,Bulgaria,Sofia : Point,0,0,0,0,0,0,133,133,0,0,0,0,0,0,892,892
2010,Bahrain,Bahrain : Dispersed in the country / territory,20,6,0,12,69,4,0,111,14,8,0,8,85,8,0,123
2010,Bahamas,Bahamas : Dispersed in the country / territory,1,0,0,2,10,0,0,13,0,5,0,1,18,1,0,25
2010,Bosnia and Herzegovina,Republika Srpska : Entity,677,2362,0,2239,19667,7589,1369,33903,680,2362,0,2395,20651,5860,1441,33389
2010,Bosnia and Herzegovina,Federacija Bosne I Hercegovine : Entity,10,22,0,24,65,4,1649,1774,6,24,0,23,66,5,1721,1845
2010,Bosnia and Herzegovina,Brcko : Županija - County,4,9,0,10,89,36,0,148,4,10,0,12,82,23,0,131
2010,Bosnia and Herzegovina,Bosnia and Herzegovina : Dispersed in the country / territory,5,140,0,277,2416,595,25829,29262,8,175,0,224,2412,635,26884,30338
2010,Belarus,Minsk : Point,10,28,0,29,79,11,0,157,18,24,0,19,154,4,0,219
2010,Belarus,Grodno Region : Point,0,2,0,0,5,0,0,7,0,0,0,0,8,0,0,8
2010,Belarus,Gomel Region : Point,1,1,0,6,18,5,0,31,9,2,0,2,35,4,0,52
2010,Belarus,Brest Region : Point,0,1,0,0,1,0,0,2,1,1,0,0,6,1,0,9
2010,Belarus,Vitebsk Region : Point,0,1,0,2,9,3,0,15,2,3,0,1,22,1,0,29
2010,Belarus,Mogilev Region : Point,0,1,0,3,12,0,0,16,0,0,0,0,19,1,0,20
2010,Belarus,Minsk City : Oblast - Region,1,4,0,5,30,2,0,42,1,5,0,6,34,2,0,48
2010,Bolivia (Plurinational State of),Yapacani : Point,0,2,0,2,2,0,0,6,1,0,0,1,2,0,0,4
2010,Bolivia (Plurinational State of),Tarija : Point,0,0,0,3,78,2,0,83,0,0,0,0,1,0,0,1
2010,Bolivia (Plurinational State of),Sucre : Point,0,0,0,0,0,0,0,0,0,0,0,0,1,0,0,1
2010,Bolivia (Plurinational State of),Santa Cruz : Point,0,2,0,4,7,1,0,14,0,1,0,6,23,1,0,31
2010,Bolivia (Plurinational State of),Palos Blanco : Point,0,1,0,0,3,0,0,4,0,0,0,0,4,0,0,4
2010,Bolivia (Plurinational State of),La Paz : Point,1,8,0,27,117,4,0,157,5,13,0,27,172,7,0,224
2010,Bolivia (Plurinational State of),Cochabamba : Point,2,3,0,3,12,0,0,20,0,3,0,10,21,0,0,34
2010,Bolivia (Plurinational State of),Bolivia : Dispersed in the country / territory,1,1,0,2,10,1,0,15,0,0,0,1,131,2,0,134
2010,Bolivia (Plurinational State of),Beni : Point,0,0,0,0,1,0,0,1,0,1,0,1,1,0,0,3
2010,Brazil,Sao Paulo : ADMIN_1,7,24,0,30,380,21,0,462,11,26,0,38,1232,26,0,1333
2010,Brazil,Roraima : ADMIN_1,0,0,0,0,2,0,0,2,0,0,0,0,5,0,0,5
2010,Brazil,Pernambuco : Point,0,0,0,0,0,0,0,0,0,0,0,0,3,0,0,3
2010,Brazil,Paraná : Point,0,2,0,1,8,0,0,11,0,2,0,0,21,0,0,23
2010,Brazil,Pará : Point,0,0,0,0,0,0,0,0,0,0,0,0,1,0,0,1
2010,Brazil,Minas Gerais : Point,0,0,0,0,0,0,0,0,0,0,0,0,9,0,0,9
2010,Brazil,Mato Grosso : Point,0,0,0,0,3,0,0,3,2,0,0,1,5,0,0,8
2010,Brazil,Ceará : Point,0,0,0,0,0,0,0,0,0,0,0,0,1,0,0,1
2010,Brazil,Bahia : Point,0,0,0,0,1,0,0,1,0,0,0,0,2,0,0,2
2010,Brazil,Amazonas : ADMIN_1,0,0,0,3,145,1,0,149,1,4,0,5,461,0,0,471
2010,Brazil,Alagoas : Point,0,0,0,0,1,0,0,1,0,0,0,0,0,0,0,0
2010,Brazil,Acre : Point,3,7,0,8,45,0,0,63,2,10,0,5,101,0,0,118
2010,Brazil,Santa Catarina : ADMIN_1,0,0,0,0,3,1,0,4,0,0,0,0,8,0,0,8
2010,Brazil,Rio Grande Do Sul : ADMIN_1,0,11,0,13,56,1,0,81,0,16,0,11,73,1,0,101
2010,Brazil,Rio Grande Do Norte : ADMIN_1,2,2,0,0,3,0,0,7,0,0,0,0,7,0,0,7
2010,Brazil,Rio De Janeiro : ADMIN_2,5,23,0,24,523,13,0,588,10,18,0,28,1435,24,0,1515
2010,Brazil,Mato Grosso do Sul : Point,0,0,0,0,1,0,0,1,0,0,0,0,9,0,0,9
2010,Brazil,Distrito Federal : Point,1,2,0,0,16,3,0,22,0,1,0,0,78,4,0,83
2010,Brazil,Brazil : Dispersed in the country / territory,5,22,0,32,81,2,0,142,4,25,0,70,99,12,0,210
2010,Botswana,Dukwi : Point,134,210,0,135,388,14,0,881,133,212,0,100,1033,29,0,1507
2010,Botswana,Botswana : Dispersed in the country / territory,49,60,0,54,147,19,0,329,50,61,0,61,336,10,0,518
2010,Central African Rep.,Momou,500,700,0,300,1471,50,0,3021,400,700,0,300,1500,79,0,2979
2010,Central African Rep.,Bambari,236,187,0,162,329,27,0,941,272,147,0,145,203,43,0,810
2010,Central African Rep.,Zemio : Sous-préfecture,256,240,0,166,813,105,0,1580,267,256,0,248,943,154,0,1868
2010,Central African Rep.,Vakaga : Prefecture,500,700,0,1200,3500,212,0,6112,600,700,0,900,3645,243,0,6088
2010,Central African Rep.,Sam Ouandja : Point,247,176,0,74,288,23,0,808,241,222,0,58,225,48,0,794
2010,Central African Rep.,Ouham-pende : Prefecture,3625,4856,0,3685,14500,450,0,27116,3700,4850,0,3857,14134,400,0,26941
2010,Central African Rep.,Ouham : Prefecture,3160,5940,0,5484,7700,260,0,22544,3400,4975,0,5546,7500,200,0,21621
2010,Central African Rep.,Obo : Sous-préfecture,20,30,0,60,196,12,0,318,30,40,0,48,250,14,0,382
2010,Central African Rep.,Nana-Griizi,185,990,0,3499,4620,231,0,9525,344,1320,0,1914,6645,252,0,10475
2010,Central African Rep.,Nana Mambere : Prefecture,1900,2000,0,1300,4660,170,0,10030,3700,2007,0,1120,4280,170,0,11277
2010,Central African Rep.,Mongoumba : Sous-préfecture,785,1027,0,657,1498,78,0,4045,812,998,0,476,1589,80,0,3955
2010,Central African Rep.,Mboki : Point,80,68,0,125,455,18,0,746,72,57,0,160,450,15,0,754
2010,Central African Rep.,Hautte-kotto : Prefecture,350,800,0,740,2200,189,0,4279,400,1000,0,900,2000,221,0,4521
2010,Central African Rep.,Haut-mboumou : Prefecture,600,1600,0,1300,4000,143,0,7643,900,1800,0,1600,3900,157,0,8357
2010,Central African Rep.,Central African Republic : Dispersed in the country / territory,0,0,0,3,2,0,0,5,0,2,0,2,7,0,0,11
2010,Central African Rep.,Bangui : Sous-préfecture,302,413,0,463,1180,12,0,2370,343,420,0,394,2248,17,0,3422
2010,Central African Rep.,Bamingui-bangora : Prefecture,500,760,0,910,3150,50,0,5370,485,770,0,660,2670,45,0,4630
2010,Canada,Canada : Dispersed in the country / territory,1823,2305,0,1735,15421,1026,0,22310,1899,2445,0,1819,21944,608,0,28715
2010,Switzerland,Switzerland : Dispersed in the country / territory,1511,1977,0,1540,8697,639,10764,25128,1593,2174,0,1892,15997,366,14578,36600
2010,China,Yunnan,0,0,0,0,0,0,21821,21821,0,0,0,0,0,0,22669,22669
2010,China,Yiwu : Point,0,0,0,2,2,0,0,4,0,1,0,2,3,0,0,6
2010,China,Wuhan : Point,0,2,0,1,5,0,0,8,0,0,0,1,6,0,0,7
2010,China,Tian Jin,0,1,0,0,1,0,0,2,0,2,0,0,6,0,0,8
2010,China,Shanghai : Point,0,0,0,0,0,0,0,0,0,0,0,0,2,0,0,2
2010,China,Shan Dong,0,0,0,0,0,0,0,0,0,0,0,0,1,0,0,1
2010,China,Nanjing : Point,1,0,0,0,1,0,0,2,0,0,0,0,2,0,0,2
2010,China,Langfang : Point,6,8,0,5,24,3,0,46,3,12,0,9,28,2,0,54
2010,China,Jianxi,0,0,0,0,0,0,824,824,0,0,0,0,0,0,891,891
2010,China,Ji Lin,0,0,0,0,0,0,0,0,0,0,0,0,1,0,0,1
2010,China,Hu Nan,0,0,0,0,0,0,0,0,0,0,0,0,2,0,0,2
2010,China,Hai Nan,0,0,0,0,0,0,14867,14867,0,0,0,0,1,0,16608,16609
2010,China,Guangzhou : Point,3,1,0,0,8,0,0,12,0,3,0,1,11,2,0,17
2010,China,Guangxi,0,0,0,0,0,0,53303,53303,0,0,0,0,0,0,58965,58965
2010,China,Guangdong,0,0,0,0,0,0,39884,39884,0,0,0,0,0,0,43654,43654
2010,China,Fujian,0,0,0,0,0,0,13211,13211,0,0,0,0,0,0,14198,14198
2010,China,Chong Qing,1,0,0,0,1,0,0,2,1,0,0,0,1,0,0,2
2010,China,Beijing : Point,0,1,0,0,8,1,0,10,2,2,0,2,16,1,0,23
2010,China,Beihai : Point,0,0,0,0,0,0,0,0,0,0,0,0,0,1,0,1
2010,Côte d'Ivoire,Tabou : Departement,1346,1734,0,964,4139,160,0,8343,1268,1812,0,831,3090,159,0,7160
2010,Côte d'Ivoire,Guiglo : Departement,322,775,0,501,2003,144,0,3745,297,864,0,456,1402,116,0,3135
2010,Côte d'Ivoire,Abidjan : Departement,204,341,0,224,1183,38,0,1990,197,362,0,248,1154,42,0,2003
2010,Cameroon,Zembe Borongo,239,383,0,224,630,27,0,1503,246,434,0,185,352,49,0,1266
2010,Cameroon,Yokosire,61,161,0,105,266,18,0,611,60,179,0,83,171,36,0,529
2010,Cameroon,Yarmbang,89,170,0,71,218,9,0,557,94,130,0,67,130,13,0,434
2010,Cameroon,Yaounde : Point,8,10,0,7,35,3,0,63,8,17,0,14,90,3,0,132
2010,Cameroon,Yamba,158,310,0,121,369,22,0,980,143,275,0,118,256,19,0,811
2010,Cameroon,Woumbou,47,58,0,40,121,4,0,270,27,68,0,42,100,5,0,242
2010,Cameroon,Tongo Gandima,119,202,0,133,330,13,0,797,132,240,0,118,255,34,0,779
2010,Cameroon,Toktoyo,153,250,0,142,409,19,0,973,180,287,0,139,275,30,0,911
2010,Cameroon,Timangolo,51,71,0,40,113,10,0,285,40,77,0,50,72,10,0,249
2010,Cameroon,Tapare,17,35,0,11,39,3,0,105,21,34,0,19,28,5,0,107
2010,Cameroon,Sandaye,23,25,0,19,37,2,0,106,18,28,0,16,26,1,0,89
2010,Cameroon,Samba,41,90,0,38,111,3,0,283,33,66,0,36,70,6,0,211
2010,Cameroon,Ouro-Adde,124,190,0,119,240,13,0,686,122,206,0,97,166,12,0,603
2010,Cameroon,Nyabi,174,346,0,232,584,27,0,1363,190,336,0,186,420,44,0,1176
2010,Cameroon,Ngunbela,17,31,0,11,67,1,0,127,16,48,0,27,39,4,0,134
2010,Cameroon,Nguindi,38,70,0,31,104,4,0,247,34,60,0,31,54,11,0,190
2010,Cameroon,Ngazi,27,21,0,8,34,4,0,94,12,22,0,10,25,0,0,69
2010,Cameroon,Ngaoui,675,1198,0,597,1623,82,0,4175,750,1160,0,625,960,143,0,3638
2010,Cameroon,Ndokayo,275,441,0,235,661,29,0,1641,252,429,0,259,559,64,0,1563
2010,Cameroon,Ndanga Gandima,65,81,0,53,185,9,0,393,63,113,0,60,130,15,0,381
2010,Cameroon,Nandoungue,94,163,0,78,217,13,0,565,105,171,0,68,139,18,0,501
2010,Cameroon,Nabemo,70,109,0,51,157,5,0,392,73,132,0,52,119,11,0,387
2010,Cameroon,Mobe,37,56,0,20,92,0,0,205,32,69,0,30,57,10,0,198
2010,Cameroon,Mimbang,4,9,0,8,25,0,0,46,5,10,0,9,23,2,0,49
2010,Cameroon,Mikila,48,82,0,46,113,4,0,293,46,81,0,48,77,11,0,263
2010,Cameroon,Meiganga,193,368,0,212,508,23,0,1304,220,420,0,201,378,43,0,1262
2010,Cameroon,Meidougou,366,548,0,328,826,33,0,2101,356,617,0,313,518,60,0,1864
2010,Cameroon,Mboumama,91,151,0,91,261,8,0,602,97,147,0,82,229,15,0,570
2010,Cameroon,Mboula,50,112,0,48,139,10,0,359,54,88,0,39,105,17,0,303
2010,Cameroon,Mborguene,47,67,0,40,107,4,0,265,34,78,0,42,110,5,0,269
2010,Cameroon,Mbonga,42,70,0,48,107,7,0,274,40,75,0,42,84,11,0,252
2010,Cameroon,Mbondo,46,73,0,30,106,6,0,261,37,68,0,33,84,13,0,235
2010,Cameroon,Mbile,68,140,0,78,205,5,0,496,68,118,0,77,145,11,0,419
2010,Cameroon,Mbewe,11,19,0,14,19,3,0,66,12,11,0,9,27,0,0,59
2010,Cameroon,Mbarang,67,124,0,47,151,6,0,395,80,100,0,50,93,9,0,332
2010,Cameroon,Mandjou,166,315,0,166,441,25,0,1113,163,288,0,153,258,33,0,895
2010,Cameroon,Lokoti,90,121,0,61,191,12,0,475,68,143,0,74,152,17,0,454
2010,Cameroon,Langui : Point,335,438,0,198,785,88,0,1844,339,418,0,186,878,52,0,1873
2010,Cameroon,Kouba,31,72,0,32,73,3,0,211,18,61,0,30,32,7,0,148
2010,Cameroon,Kombo Laka,85,132,0,57,190,13,0,477,99,119,0,64,175,17,0,474
2010,Cameroon,Kole,28,53,0,43,75,2,0,201,30,56,0,27,39,3,0,155
2010,Cameroon,Kette,94,235,0,129,381,15,0,854,117,232,0,123,262,34,0,768
2010,Cameroon,Kenzou,219,426,0,260,697,33,0,1635,225,437,0,212,400,44,0,1318
2010,Cameroon,Guiwa Yangamo,51,110,0,58,164,11,0,394,63,95,0,68,114,12,0,352
2010,Cameroon,Goundjel,3,3,0,3,10,0,0,19,1,2,0,1,13,0,0,17
2010,Cameroon,Goro,65,125,0,43,143,8,0,384,63,116,0,42,111,8,0,340
2010,Cameroon,Gbiti,463,785,0,463,1484,49,0,3244,470,814,0,459,1181,116,0,3040
2010,Cameroon,Gbakim,34,67,0,35,108,3,0,247,35,59,0,35,103,8,0,240
2010,Cameroon,Garoua-Boulai,496,943,0,572,1413,67,0,3491,551,985,0,529,911,91,0,3067
2010,Cameroon,Gargapela,81,130,0,64,177,10,0,462,78,129,0,55,103,12,0,377
2010,Cameroon,Garga Sarali,63,108,0,57,202,15,0,445,102,129,0,65,181,10,0,487
2010,Cameroon,Garga Libona,143,202,0,105,309,15,0,774,157,215,0,98,198,18,0,686
2010,Cameroon,Gandinang,0,0,0,0,1,0,0,1,0,0,0,0,1,0,0,1
2010,Cameroon,Gado Badzere,66,89,0,72,147,12,0,386,60,114,0,61,98,16,0,349
2010,Cameroon,Fada,48,58,0,36,99,6,0,247,51,64,0,35,65,8,0,223
2010,Cameroon,Douala : Point,1,1,0,0,1,0,0,3,2,1,0,0,11,1,0,15
2010,Cameroon,Djohong,61,70,0,36,109,6,0,282,55,61,0,29,89,8,0,242
2010,Cameroon,Djalingo,45,74,0,30,125,13,0,287,48,97,0,47,71,7,0,270
2010,Cameroon,Dir,56,86,0,54,124,4,0,324,52,97,0,51,85,10,0,295
2010,Cameroon,Digou Adamou,16,19,0,9,31,1,0,76,10,22,0,9,25,5,0,71
2010,Cameroon,Dang Patou,54,70,0,50,134,6,0,314,63,74,0,28,95,7,0,267
2010,Cameroon,Dakere Babongo,54,80,0,43,118,6,0,301,56,97,0,41,72,10,0,276
2010,Cameroon,Bouli,72,85,0,59,160,4,0,380,49,81,0,51,102,7,0,290
2010,Cameroon,Boulembe,76,143,0,72,161,13,0,465,69,127,0,53,115,10,0,374
2010,Cameroon,Boubara,49,92,0,73,178,9,0,401,58,94,0,49,157,18,0,376
2010,Cameroon,Borgop,48,84,0,41,93,12,0,278,46,73,0,31,68,4,0,222
2010,Cameroon,Betare Oya,0,0,0,0,1,0,0,1,0,0,0,0,9,0,0,9
2010,Cameroon,Belel,0,0,0,1,1,0,0,2,0,2,0,0,8,0,0,10
2010,Cameroon,Bedobo,41,92,0,57,146,4,0,340,46,78,0,33,112,4,0,273
2010,Cameroon,Bazzama,63,121,0,48,179,7,0,418,63,114,0,59,107,10,0,353
2010,Cameroon,Batoua Godole,238,395,0,179,565,31,0,1408,240,405,0,170,340,47,0,1202
2010,Cameroon,Bagodo,121,252,0,109,316,11,0,809,155,264,0,121,181,33,0,754
2010,Cameroon,Bafouck,55,87,0,52,125,6,0,325,51,61,0,49,131,10,0,302
2010,Cameroon,Babongo,2,3,0,3,7,0,0,15,0,5,0,2,5,2,0,14
2010,Cameroon,Adinkol,34,37,0,19,70,4,0,164,32,37,0,24,45,6,0,144
2010,Cameroon,"AD, NW",55,281,0,331,818,44,0,1529,70,346,0,281,569,76,0,1342
2010,Cameroon,Cameroon : Dispersed in the country / territory,750,1131,0,756,4143,89,0,6869,733,961,0,754,6434,156,0,9038
2010,Dem. Rep. of the Congo,Pweto,567,638,0,329,1013,48,0,2595,516,566,0,323,874,49,0,2328
2010,Dem. Rep. of the Congo,Manono,3,0,0,1,1,0,0,5,1,1,0,2,1,0,0,5
2010,Dem. Rep. of the Congo,Dilolo,24,19,0,4,45,3,0,95,20,27,0,5,44,3,0,99
2010,Dem. Rep. of the Congo,Bondo,78,42,0,39,165,11,0,335,85,44,0,29,166,9,0,333
2010,Dem. Rep. of the Congo,Zomfi : Point,3,3,0,2,5,0,0,13,2,2,0,2,4,0,0,10
2010,Dem. Rep. of the Congo,Walungu various,7,8,0,1,10,1,0,27,4,2,0,1,4,1,0,12
2010,Dem. Rep. of the Congo,Uvira Various : Point,149,140,0,64,214,17,0,584,133,135,0,61,114,7,0,450
2010,Dem. Rep. of the Congo,Uvira Rural : Point,906,865,0,594,1692,116,0,4173,873,856,0,544,1675,87,0,4035
2010,Dem. Rep. of the Congo,Tshimbumbulu : Point,28,19,0,9,23,9,0,88,17,17,0,11,22,8,0,75
2010,Dem. Rep. of the Congo,Tshifwameso : Point,4,9,0,10,22,0,0,45,6,10,0,10,13,0,0,39
2010,Dem. Rep. of the Congo,Tshabobo : Point,85,92,0,21,138,4,0,340,86,79,0,21,144,9,0,339
2010,Dem. Rep. of the Congo,Tseke-Zole : Point,34,38,0,27,85,6,0,190,42,49,0,34,126,18,0,269
2010,Dem. Rep. of the Congo,Sud-Kivu : Province,604,609,0,1245,1464,91,0,4013,714,784,0,1716,1511,87,0,4812
2010,Dem. Rep. of the Congo,South and North Kivu ,4409,4960,0,7716,9922,551,0,27558,5016,5643,0,10346,9718,627,0,31350
2010,Dem. Rep. of the Congo,Sadi/Zulu : Point,1,2,0,3,3,0,0,9,1,2,0,1,11,0,0,15
2010,Dem. Rep. of the Congo,North katanga( Moba) : Point,308,345,0,157,1103,22,0,1935,283,316,0,180,1215,31,0,2025
2010,Dem. Rep. of the Congo,North Katanga( Kalemie) : Point,8,16,0,11,22,0,0,57,17,14,0,6,28,1,0,66
2010,Dem. Rep. of the Congo,Nord-Kivu : Province,0,0,0,0,0,0,2594,2594,0,0,0,0,0,0,3582,3582
2010,Dem. Rep. of the Congo,Nlundu Matende : Point,4,5,0,6,25,5,0,45,7,7,0,8,21,6,0,49
2010,Dem. Rep. of the Congo,Nkondo : Point,26,39,0,23,67,6,0,161,6,22,0,33,30,64,0,155
2010,Dem. Rep. of the Congo,Napassa : Point,4,1,0,0,0,0,0,5,3,5,0,0,3,0,0,11
2010,Dem. Rep. of the Congo,Mwene Ditu,15,22,0,6,30,1,0,74,14,14,0,6,33,1,0,68
2010,Dem. Rep. of the Congo,Mfuiki : Point,4,2,0,2,6,0,0,14,4,5,0,2,12,1,0,24
2010,Dem. Rep. of the Congo,Mbujimayi : Point,0,0,0,0,0,0,0,0,0,0,0,0,3,0,0,3
2010,Dem. Rep. of the Congo,Lusuku : Point,19,29,0,14,57,3,0,122,29,40,0,11,63,4,0,147
2010,Dem. Rep. of the Congo,Lubumbashi : Point,78,80,0,55,165,11,0,389,78,90,0,50,188,8,0,414
2010,Dem. Rep. of the Congo,Kulindji : Point,5,9,0,19,7,2,0,42,4,24,0,23,26,5,0,82
2010,Dem. Rep. of the Congo,Kinshasa : Territoire - Disctrict,585,1083,0,832,3600,923,0,7023,598,1059,0,881,3167,790,0,6495
2010,Dem. Rep. of the Congo,Kinshasa : Point,106,217,0,175,639,66,0,1203,88,206,0,153,590,80,0,1117
2010,Dem. Rep. of the Congo,Kinsalulu : Point,11,10,0,10,26,1,0,58,13,14,0,15,10,0,0,52
2010,Dem. Rep. of the Congo,Kinsafu : Point,7,11,0,11,15,1,0,45,5,7,0,7,9,0,0,28
2010,Dem. Rep. of the Congo,Kimpindi : Point,4,4,0,4,9,2,0,23,7,7,0,8,3,0,0,25
2010,Dem. Rep. of the Congo,Kimfwakata : Point,9,7,0,8,12,0,0,36,6,10,0,7,7,0,0,30
2010,Dem. Rep. of the Congo,Kimbianga : Point,3,4,0,2,8,1,0,18,2,5,0,4,3,3,0,17
2010,Dem. Rep. of the Congo,Kimaza : Point,44,73,0,121,1,0,0,239,45,88,0,228,16,0,0,377
2010,Dem. Rep. of the Congo,Kilueka : Point,42,87,0,51,155,12,0,347,70,82,0,46,127,14,0,339
2010,Dem. Rep. of the Congo,Katshia : Point,41,64,0,25,91,5,0,226,33,67,0,27,94,8,0,229
2010,Dem. Rep. of the Congo,Katanga (Kisenge) : Point,8,11,0,10,27,2,0,58,8,13,0,6,20,5,0,52
2010,Dem. Rep. of the Congo,Kahemba : Point,0,2,0,0,2,2,0,6,1,3,0,0,6,2,0,12
2010,Dem. Rep. of the Congo,Isiro : Point,4,3,0,7,14,1,0,29,2,5,0,5,18,0,0,30
2010,Dem. Rep. of the Congo,Ingbokolo : Point,110,105,0,100,327,15,0,657,94,96,0,100,278,19,0,587
2010,Dem. Rep. of the Congo,Goma : Point,86,142,0,118,198,0,0,544,73,105,0,108,214,2,0,502
2010,Dem. Rep. of the Congo,Fizi (Baraka) : Point,418,513,0,257,669,71,0,1928,422,506,0,285,659,55,0,1927
2010,Dem. Rep. of the Congo,Dungu : Point,2,0,0,2,2,0,0,6,1,0,0,0,5,0,0,6
2010,Dem. Rep. of the Congo,Doruma : Point,13,10,0,7,20,8,0,58,4,8,0,8,18,8,0,46
2010,Dem. Rep. of the Congo,Divuma : Point,30,24,0,16,49,5,0,124,27,31,0,19,38,9,0,124
2010,Dem. Rep. of the Congo,District de Luababa,1128,1251,0,631,1773,157,0,4940,1160,1262,0,686,1973,176,0,5257
2010,Dem. Rep. of the Congo,Buta : Point,3,5,0,5,12,0,0,25,4,4,0,2,11,1,0,22
2010,Dem. Rep. of the Congo,Bukavu : Point,21,26,0,34,73,4,0,158,34,42,0,66,84,3,0,229
2010,Dem. Rep. of the Congo,Bas-Congo : Province,2515,5679,0,3516,13210,2079,0,26999,2533,5787,0,3946,10444,1605,0,24315
2010,Dem. Rep. of the Congo,Bangalu Afflux : Point,14,10,0,13,29,7,0,73,10,11,0,12,16,13,0,62
2010,Dem. Rep. of the Congo,Aru : Point,13,3,0,4,22,0,0,42,9,4,0,5,3,1,0,22
2010,Dem. Rep. of the Congo,Ariwara : Point,7,41,0,41,120,57,0,266,51,77,0,65,236,96,0,525
2010,Dem. Rep. of the Congo,Aba : Point,0,0,0,0,2,0,0,2,0,0,0,0,3,0,0,3
2010,Congo,Tchiamba-Nza,4,5,0,2,16,3,0,30,2,10,0,3,12,1,0,28
2010,Congo,Sangha : Departement,122,189,0,47,264,12,0,634,84,190,0,65,518,6,0,863
2010,Congo,Pool : Departement,17,30,0,12,37,1,0,97,13,31,0,7,70,2,0,123
2010,Congo,Pointe Noire : Point,10,13,0,12,74,2,0,111,10,16,0,9,154,0,0,189
2010,Congo,Oyo : Point,15,28,0,11,36,0,0,90,12,24,0,7,103,0,0,146
2010,Congo,Owando : District,0,0,0,0,0,0,0,0,0,0,0,0,5,0,0,5
2010,Congo,Ollombo : Point,2,2,0,0,2,0,0,6,2,1,0,0,4,0,0,7
2010,Congo,Okoyo : District,0,0,0,1,1,0,0,2,0,0,0,0,1,4,0,5
2010,Congo,Ngo : Point,8,19,0,9,20,1,0,57,15,19,0,7,77,0,0,118
2010,Congo,Mpouya : Point,2,2,0,0,1,0,0,5,0,0,0,0,5,0,0,5
2010,Congo,Malolo : Point,15,30,0,11,68,12,0,136,18,35,0,24,51,8,0,136
2010,Congo,Makoua : District,3,2,0,0,1,0,0,6,1,1,0,0,8,0,0,10
2010,Congo,Makotipoko : Point,4,3,0,1,6,0,0,14,2,6,0,0,17,0,0,25
2010,Congo,Loukolela : Point,179,269,0,107,387,15,0,957,208,295,0,98,597,19,0,1217
2010,Congo,Liranga,2394,2502,0,1215,4216,291,0,10618,2324,2530,0,1111,3433,229,0,9627
2010,Congo,Kondi Mbaka : Point,18,20,0,13,74,6,0,131,26,27,0,16,82,10,0,161
2010,Congo,Komi : Point,2,4,0,3,20,2,0,31,4,6,0,7,33,4,0,54
2010,Congo,Kintele : Point,37,88,0,41,124,8,0,298,33,100,0,44,251,6,0,434
2010,Congo,Impfondo : Point,3053,3571,0,1902,6061,543,0,15130,3147,3673,0,1877,5847,334,0,14878
2010,Congo,Gamboma : District,4,5,0,1,3,0,0,13,4,7,0,0,39,0,0,50
2010,Congo,Enyelle,430,424,0,193,732,65,0,1844,429,453,0,212,606,53,0,1753
2010,Congo,Dongou,1426,1590,0,731,2544,260,0,6551,1455,1560,0,774,2130,195,0,6114
2010,Congo,Djambala : District,1,6,0,3,4,0,0,14,4,5,0,1,15,0,0,25
2010,Congo,Brazzaville : Point,417,955,0,608,1801,41,0,3822,392,928,0,586,2787,34,0,4727
2010,Congo,Betou : Point,5935,7151,0,3564,12295,1099,0,30044,5887,7367,0,3515,9993,629,0,27391
2010,Colombia,Tuluá,0,0,0,0,0,0,0,0,0,0,0,0,1,0,0,1
2010,Colombia,Tame,0,0,0,0,0,0,0,0,0,0,0,0,1,0,0,1
2010,Colombia,Sogamoso,0,0,0,0,1,0,0,1,0,0,0,0,0,0,0,0
2010,Colombia,San Andres,0,0,0,0,2,0,0,2,0,0,0,1,1,0,0,2
2010,Colombia,Palmira,0,0,0,0,0,0,0,0,0,0,0,0,1,0,0,1
2010,Colombia,Neiva,0,0,0,0,0,0,0,0,0,0,0,0,1,0,0,1
2010,Colombia,Medellín,0,0,0,0,1,1,0,2,0,0,0,0,10,0,0,10
2010,Colombia,Maicao,0,0,0,0,1,0,0,1,1,0,0,0,0,0,0,1
2010,Colombia,Ibagué,0,0,0,0,1,0,0,1,0,0,0,0,1,0,0,1
2010,Colombia,Duitama,0,0,0,0,1,0,0,1,0,0,0,0,0,0,0,0
2010,Colombia,Cucuta,1,0,0,0,6,0,0,7,1,0,0,1,6,1,0,9
2010,Colombia,Charalá : Point,0,0,0,0,0,0,0,0,0,0,0,0,0,1,0,1
2010,Colombia,Cartagena : Point,0,0,0,0,2,0,0,2,0,0,0,0,10,1,0,11
2010,Colombia,Cali : Point,0,0,0,0,1,0,0,1,0,0,0,0,4,2,0,6
2010,Colombia,Buenaventura : Point,0,1,0,2,2,0,0,5,0,3,0,0,1,0,0,4
2010,Colombia,Bogota : Point,8,5,0,6,52,6,0,77,5,13,0,6,196,6,0,226
2010,Colombia,Barcelona : Point,0,0,0,2,1,0,0,3,0,0,0,0,1,0,0,1
2010,Colombia,Apartadó,0,0,0,0,0,0,0,0,0,0,0,0,1,0,0,1
2010,Colombia,Colombia : Dispersed in the country / territory,0,0,0,0,0,0,1816767,1816767,0,0,0,0,0,0,1855287,1855287
2010,Costa Rica,Costa Rica: dispersed in the country,383,885,0,888,6100,175,0,8431,550,1161,0,1163,8039,536,0,11449
2010,Cuba,Villa Clara : Provincia,0,0,0,0,1,0,0,1,0,0,0,0,22,0,0,22
2010,Cuba,Matanzas : Point,0,0,0,0,0,0,0,0,0,0,0,0,24,0,0,24
2010,Cuba,Las Tunas : Municipio,0,0,0,0,0,0,0,0,0,0,0,0,18,0,0,18
2010,Cuba,La Habana : Provincia,0,0,0,0,1,0,0,1,0,0,0,0,0,0,0,0
2010,Cuba,Holguin : Municipio,0,0,0,0,0,0,0,0,0,0,0,0,39,0,0,39
2010,Cuba,Guantßnamo : Point,0,0,0,0,0,0,0,0,0,0,0,1,53,0,0,54
2010,Cuba,Granma : Provincia,0,0,0,0,0,0,0,0,0,0,0,0,30,0,0,30
2010,Cuba,Cienfuegos : Municipio,0,0,0,0,0,0,0,0,0,0,0,0,23,0,0,23
2010,Cuba,Camaguey : Municipio,0,0,0,0,1,0,0,1,0,0,0,0,28,0,0,28
2010,Cuba,Santiago De Cuba : Municipio,0,0,0,0,0,0,0,0,0,0,0,0,20,0,0,20
2010,Cuba,Sancti Spiritus : Municipio,0,0,0,0,0,0,0,0,0,0,0,0,27,0,0,27
2010,Cuba,Pinar Del Rio : Municipio,0,0,0,0,0,0,0,0,0,0,0,0,49,0,0,49
2010,Cuba,Isla De La Juventud : Provincia,0,0,0,0,0,0,0,0,0,0,0,2,44,0,0,46
2010,Cuba,Ciudad De La Habana : Municipio Especial ,0,0,0,0,11,0,0,11,0,1,0,1,22,0,0,24
2010,Cuba,Ciego De Avila : Municipio,0,0,0,0,0,0,0,0,0,0,0,0,4,0,0,4
2010,Curaçao,Willemstad,0,1,0,1,3,0,0,5,2,0,0,0,2,0,0,4
2010,Cayman Islands,Cayman Islands : Dispersed in the country / territory,0,0,0,0,0,0,0,0,0,0,0,0,5,0,0,5
2010,Czech Rep.,Czech Republic,0,0,0,0,0,0,345,345,0,0,0,0,0,0,659,659
2010,Germany,Germany : Dispersed in the country / territory,8229,23093,0,31340,184696,29551,3255,280164,8780,24652,0,34628,275516,25775,4665,374016
2010,Djibouti,Djibouti : Point,53,56,0,38,362,4,0,513,44,91,0,42,808,12,0,997
2010,Djibouti,Ali-Addeh : Point,959,1334,0,902,3925,151,0,7271,1003,1452,0,800,3632,175,0,7062
2010,Denmark,Denmark : Dispersed in the country / territory,0,0,0,0,0,0,1512,1512,0,0,0,0,0,0,1704,1704
2010,Dominican Rep.,Dominican Republic : Dispersed in the country / territory,0,0,0,0,0,0,1178,1178,0,0,0,0,0,0,1180,1180
2010,Algeria,Alger : Point,15,10,0,11,101,1,0,138,24,6,0,10,261,4,0,305
2010,Ecuador,Ecuador : Dispersed in the country / territory,1869,5140,0,4444,33153,1348,0,45954,2021,5221,0,4888,42103,1854,0,56087
2010,Egypt,Helwan,91,154,0,115,739,56,0,1155,83,201,0,141,785,31,0,1241
2010,Egypt,Giza,130,266,0,226,1678,65,0,2365,156,325,0,268,1940,77,0,2766
2010,Egypt,Cairo : Point,7185,9847,0,6455,20524,1214,0,45225,7870,7078,0,11525,26075,829,0,53377
2010,Egypt,Alexandria : Point,20,60,0,41,176,18,0,315,15,50,0,40,248,21,0,374
2010,Egypt,6th October,86,199,0,157,727,84,0,1253,91,234,0,156,807,60,0,1348
2010,Eritrea,Emkulu : Point,499,431,0,262,829,38,0,2059,514,439,0,279,1355,45,0,2632
2010,Eritrea,Elit : Point,24,10,0,8,16,0,0,58,25,21,0,6,61,2,0,115
2010,Eritrea,Asmara : Point,7,9,0,2,18,0,0,36,10,9,0,3,24,0,0,46
2010,Spain,Spain : Dispersed in the country / territory,0,0,0,0,0,0,881,881,0,0,0,0,0,0,1831,1831
2010,Estonia,Tallinn : Point,0,0,0,0,0,0,0,0,0,0,0,0,1,0,0,1
2010,Estonia,Illuka : Linnad - District,1,0,0,0,1,0,0,2,1,0,0,0,8,0,0,9
2010,Estonia,Estonia : Dispersed in the country / territory,0,0,0,0,3,0,0,3,1,2,0,0,31,0,0,34
2010,Ethiopia,Sherkole : Point,286,374,0,175,611,19,0,1465,359,381,0,276,1125,17,0,2158
2010,Ethiopia,Sheder : Point,849,1322,0,856,2360,125,0,5512,920,1386,0,866,1711,63,0,4946
2010,Ethiopia,Melkadida:Point,3481,3949,0,1501,5020,286,0,14237,3553,4002,0,1379,2097,223,0,11254
2010,Ethiopia,Mai-Ayni : Point,337,311,0,312,2618,25,0,3603,361,364,0,1088,6790,49,0,8652
2010,Ethiopia,Kebribeyah : Point,1192,2552,0,1206,3337,188,0,8475,1233,2566,0,1196,2891,240,0,8126
2010,Ethiopia,Fugnido : Point,2480,2813,0,1705,5035,184,0,12217,2514,2818,0,1742,2427,52,0,9553
2010,Ethiopia,Bokolmanyo : Point,1823,2252,0,869,3008,161,0,8113,1709,2414,0,947,1666,139,0,6875
2010,Ethiopia,Berhale:point,806,1332,0,546,2041,79,0,4804,871,1465,0,691,2189,218,0,5434
2010,Ethiopia,Awbarre : Point,1040,2003,0,967,2823,175,0,7008,1084,1909,0,1056,1983,80,0,6112
2010,Ethiopia,Asaita:point,315,494,0,281,1055,77,0,2222,394,598,0,372,1425,79,0,2868
2010,Ethiopia,Adiharush,162,209,0,83,655,4,0,1113,179,210,0,104,5281,36,0,5810
2010,Ethiopia,Shimelba (Shire/Shiraro) : Point,566,485,0,393,1532,188,0,3164,580,491,0,498,4262,192,0,6023
2010,Ethiopia,Borena : Awrajja - Zone,269,354,0,193,547,95,0,1458,301,337,0,144,430,87,0,1299
2010,Ethiopia,Addis Ababa Urban : Point,132,214,0,164,661,27,0,1198,120,226,0,138,1065,75,0,1624
2010,Fiji,Suva : Point,0,0,0,0,1,1,0,2,0,0,0,0,5,0,0,5
2010,France,France : Dispersed in the country / territory,0,0,0,0,0,0,67449,67449,0,0,0,0,0,0,93069,93069
2010,Gabon,Voungou/Pont : Point,1,5,0,4,13,4,0,27,0,9,0,4,18,0,0,31
2010,Gabon,Tchibanga : Point,45,103,0,108,361,24,0,641,39,159,0,82,358,16,0,654
2010,Gabon,Sindara : Point,0,0,0,0,0,0,0,0,0,0,0,0,1,0,0,1
2010,Gabon,Rinanzala : Point,0,12,0,10,25,2,0,49,0,12,0,11,30,2,0,55
2010,Gabon,Rebe : Point,0,0,0,0,1,0,0,1,0,0,0,0,0,0,0,0
2010,Gabon,Port-Gentil : Point,0,14,0,12,76,2,0,104,0,16,0,12,178,16,0,222
2010,Gabon,Pana/Dienga : Point,0,0,0,0,1,0,0,1,0,0,0,1,6,0,0,7
2010,Gabon,Oyem : Point,0,0,0,0,6,0,0,6,0,2,0,1,17,0,0,20
2010,Gabon,Okondja : Point,0,6,0,0,4,0,0,10,0,2,0,1,45,0,0,48
2010,Gabon,Nzinga : Point,0,4,0,5,8,3,0,20,0,3,0,4,7,0,0,14
2010,Gabon,Ntoum : Point,0,0,0,1,0,0,0,1,0,1,0,0,1,0,0,2
2010,Gabon,Ngwoni : Point,0,1,0,0,1,0,0,2,0,0,0,0,15,0,0,15
2010,Gabon,Ndjole : Point,0,0,0,0,0,0,0,0,0,0,0,0,5,0,0,5
2010,Gabon,Ndende : Point,0,44,0,29,119,7,0,199,0,40,0,26,90,0,0,156
2010,Gabon,Mounana : Point,0,9,0,11,35,1,0,56,0,11,0,10,85,3,0,109
2010,Gabon,Mouila : Point,0,48,0,46,154,3,0,251,0,55,0,43,197,4,0,299
2010,Gabon,Molengui Binza : Point,0,44,0,29,88,17,0,178,0,48,0,35,90,7,0,180
2010,Gabon,Moanda : Point,2,155,0,99,434,27,0,717,5,125,0,115,485,20,0,750
2010,Gabon,Mitzic : Point,0,0,0,0,1,0,0,1,0,0,0,0,3,0,0,3
2010,Gabon,Mekambo : Point,0,0,0,0,0,0,0,0,0,0,0,0,1,2,0,3
2010,Gabon,Mayumba : Point,0,2,0,4,14,0,0,20,0,3,0,0,18,0,0,21
2010,Gabon,Makokou : Point,0,0,0,0,4,0,0,4,0,0,0,0,13,1,0,14
2010,Gabon,Mabanda : Point,0,13,0,5,24,3,0,45,0,10,0,4,29,5,0,48
2010,Gabon,Lopé,0,1,0,3,2,0,0,6,0,0,0,0,5,0,0,5
2010,Gabon,Libreville : Point,53,289,0,289,1137,30,0,1798,65,294,0,246,2015,109,0,2729
2010,Gabon,Lekindou : Point,0,4,0,4,10,0,0,18,0,0,0,0,5,2,0,7
2010,Gabon,Lebamba : Point,0,15,0,7,22,1,0,45,0,6,0,3,19,2,0,30
2010,Gabon,Lastoursville : Point,0,7,0,13,28,1,0,49,0,8,0,9,46,3,0,66
2010,Gabon,Lambaréné : Point,0,2,0,1,12,0,0,15,0,8,0,2,24,1,0,35
2010,Gabon,Koumou Doussala : Point,0,3,0,5,3,3,0,14,0,1,0,3,2,1,0,7
2010,Gabon,Koulamoutou : Point,1,22,0,20,66,2,0,111,0,23,0,11,140,6,0,180
2010,Gabon,Gamba : Point,0,15,0,16,72,0,0,103,0,25,0,3,80,2,0,110
2010,Gabon,Franceville : Point,57,189,0,107,557,16,0,926,48,206,0,125,941,28,0,1348
2010,Gabon,Fougamou : Point,0,1,0,0,2,0,0,3,0,1,0,0,4,0,0,5
2010,Gabon,Doussala : Point,1,2,0,1,6,1,0,11,2,6,0,3,3,0,0,14
2010,Gabon,Dilemba : Point,0,29,0,27,79,13,0,148,0,32,0,24,76,10,0,142
2010,Gabon,Boumango : Point,0,10,0,12,19,2,0,43,0,4,0,9,20,4,0,37
2010,Gabon,Booue : Point,1,0,0,1,4,0,0,6,0,1,0,0,7,1,0,9
2010,Gabon,Bongoville : Point,0,0,0,0,0,0,0,0,0,0,0,0,3,0,0,3
2010,Gabon,Bitam : Point,0,0,0,0,2,0,0,2,0,1,0,0,6,0,0,7
2010,Gabon,Bibora : Point,0,0,0,0,1,0,0,1,0,0,0,0,0,0,0,0
2010,Gabon,Banda Mamba : Point,0,5,0,2,6,3,0,16,0,1,0,2,1,4,0,8
2010,Gabon,Bakumba : Point,0,17,0,9,25,1,0,52,0,13,0,8,11,0,0,32
2010,Gabon,Akieni : Point,0,0,0,2,2,0,0,4,0,3,0,1,8,0,0,12
2010,Georgia,Tbilisi : Point,0,0,0,0,3,1,0,4,0,1,0,1,5,0,0,7
2010,Georgia,Martkopi,1,0,0,0,1,0,0,2,0,1,0,0,7,0,0,8
2010,Georgia,Zugdidi : Raion - District,0,1,0,2,1,0,0,4,0,0,0,0,1,0,0,1
2010,Georgia,"Vale, Akhaltsikhe district",0,0,0,0,1,0,0,1,0,0,0,1,1,0,0,2
2010,Georgia,Georgia : Dispersed in the country / territory,33,53,0,65,980,190,0,1321,35,67,0,60,857,140,0,1159
2010,Ghana,Volta : Province,76,111,0,62,286,20,0,555,71,96,0,50,376,13,0,606
2010,Ghana,Kumasi : District,0,0,0,0,1,0,0,1,1,1,0,0,4,0,0,6
2010,Ghana,Krisan : Point,40,70,0,43,236,11,0,400,45,51,0,46,444,10,0,596
2010,Ghana,Buduburam : Point,595,712,0,662,3453,109,0,5531,636,748,0,642,3724,68,0,5818
2010,Ghana,Accra : Point,63,96,0,74,213,11,0,457,54,66,0,95,380,12,0,607
2010,Guinea,Nzerekore : Point,23,30,0,15,48,3,0,119,23,32,0,40,48,7,0,150
2010,Guinea,Macenta : Point,245,642,0,554,356,33,0,1830,191,597,0,552,254,31,0,1625
2010,Guinea,Laine : Point,120,533,0,525,1063,0,0,2241,134,508,0,509,753,42,0,1946
2010,Guinea,Kountaya : Point,0,7,0,13,5,1,0,26,7,9,0,5,7,1,0,29
2010,Guinea,Kouankan : Point,172,550,0,536,461,37,0,1756,176,515,0,477,374,34,0,1576
2010,Guinea,Conakry : Point,122,412,0,708,436,8,0,1686,118,439,0,797,527,12,0,1893
2010,Gambia,Basse : Point,6,2,0,7,34,12,0,61,11,23,0,8,24,0,7,73
2010,Gambia,Banjul : ADMIN_1,676,890,0,509,1637,245,0,3957,710,867,0,610,1320,0,183,3690
2010,Gambia,Gambia : Dispersed in the country / territory,54,69,0,41,184,10,0,358,45,67,0,25,125,0,51,313
2010,Guinea-Bissau,Jolmete : Point,106,111,0,67,231,29,0,544,85,128,0,61,158,21,0,453
2010,Guinea-Bissau,Bissau : Point,19,9,0,20,94,3,0,145,24,53,0,50,243,14,0,384
2010,Guinea-Bissau,Sao Domingos : ADMIN_2,648,635,0,325,1713,195,0,3516,651,717,0,323,1100,176,0,2967
2010,Grenada,Grenada : Dispersed in the country / territory,0,0,0,0,1,0,0,1,0,1,0,0,1,0,0,2
2010,Guatemala,Guatemala : Municipio,1,0,0,0,59,9,0,69,0,2,0,0,62,7,0,71
2010,Guyana,Guyana : Dispersed in the country / territory,0,0,0,1,3,0,0,4,0,1,0,1,1,0,0,3
2010,"China, Hong Kong SAR","Hong Kong, SAR China",19,18,0,11,164,2,0,214,22,15,0,20,369,1,0,427
2010,Honduras,Trujillo : Municipio,0,0,0,0,0,0,0,0,0,0,0,0,5,0,0,5
2010,Honduras,Tegucigalpa : Point,0,0,0,0,1,0,0,1,0,0,0,0,3,0,0,3
2010,Honduras,Ceiba : Point,0,0,0,0,0,0,0,0,0,0,0,0,2,0,0,2
2010,Honduras,Comayagua : Departamento,0,0,0,0,3,0,0,3,0,0,0,0,0,0,0,0
2010,Croatia,Zagreb : Point,0,1,0,1,4,0,0,6,0,0,0,7,7,0,0,14
2010,Croatia,Vinkovci: Point,0,0,0,0,1,0,0,1,0,0,0,0,1,0,0,1
2010,Croatia,Rijeka: Point,0,0,0,0,0,0,0,0,0,0,0,0,2,0,0,2
2010,Croatia,Kutina : Point,3,2,0,0,8,0,0,13,5,1,0,2,25,0,0,33
2010,Croatia,Jezevo : Point,0,0,0,0,0,0,0,0,0,0,0,0,39,0,0,39
2010,Croatia,Bjelovar: Point,0,0,0,0,0,0,0,0,0,0,0,0,1,0,0,1
2010,Croatia,Croatia : Dispersed in the country / territory,26,52,0,94,1035,586,10682,12475,25,44,0,113,1025,499,9861,11567
2010,Indonesia,Sumatra Utara,6,10,0,7,46,1,0,70,11,24,0,11,76,2,0,124
2010,Indonesia,Sulawesi Utara,0,0,0,0,0,0,0,0,0,0,0,1,15,0,0,16
2010,Indonesia,Riau,0,4,0,0,2,1,0,7,0,2,0,2,33,0,0,37
2010,Indonesia,Makassar : Point,3,1,0,0,6,0,0,10,0,3,0,9,57,1,0,70
2010,Indonesia,Kupang : ADMIN_2,0,0,0,0,0,0,0,0,0,0,0,1,15,0,0,16
2010,Indonesia,Kalimantan Barat,0,0,0,0,1,0,0,1,1,1,0,4,26,0,0,32
2010,Indonesia,Jawa Timur,1,0,0,0,0,0,0,1,0,1,0,5,33,0,0,39
2010,Indonesia,Jawa Barat,17,17,0,18,93,3,0,148,17,38,0,107,588,2,0,752
2010,Indonesia,Belawan : Point,0,0,0,0,0,0,0,0,0,0,0,1,33,1,0,35
2010,Indonesia,Banten,0,1,0,1,4,0,0,6,0,1,0,2,13,0,0,16
2010,Indonesia,Tanjung Pinang : Point,0,0,0,0,4,0,0,4,1,0,0,34,343,1,0,379
2010,Indonesia,Indonesia : Dispersed in the country / territory,7,1,0,4,11,1,0,24,3,4,0,15,120,0,0,142
2010,Indonesia,Dki Jakarta : Propinsi - Province,20,24,0,15,84,3,0,146,16,31,0,88,626,9,0,770
2010,Indonesia,Bali : Propinsi - Province,2,4,0,2,10,0,0,18,1,9,0,1,8,0,0,19
2010,India,Tamil Nadu : State,0,0,0,0,0,0,34358,34358,0,0,0,0,0,0,35640,35640
2010,India,Delhi : District,698,1160,0,1376,4706,382,0,8322,701,1140,0,1433,6538,435,0,10247
2010,Iran (Islamic Rep. of),Tehran,4,121,0,150,408,19,0,702,5,139,0,163,518,35,0,860
2010,Iran (Islamic Rep. of),Kerman,0,1,0,1,4,0,0,6,0,1,0,1,5,0,0,7
2010,Iran (Islamic Rep. of),Ghom,1,2,0,2,4,0,0,9,1,2,0,2,10,0,0,15
2010,Iran (Islamic Rep. of),Fars,0,0,0,0,0,0,0,0,0,0,0,1,2,0,0,3
2010,Iran (Islamic Rep. of),Markazi,1,2,0,4,11,0,0,18,3,9,0,2,16,0,0,30
2010,Iran (Islamic Rep. of),Khuzestan,0,1,0,0,3,0,0,4,1,0,0,0,3,0,0,4
2010,Iran (Islamic Rep. of),Khorasan Razavi,0,14,0,16,49,3,0,82,0,18,0,22,66,4,0,110
2010,Iran (Islamic Rep. of),Esfahan,0,0,0,1,1,0,0,2,0,0,0,1,3,0,0,4
2010,Iraq,Wassit,3782,4221,0,4221,13538,1315,0,27077,3947,4357,0,4357,13923,1152,0,27736
2010,Iraq,Thi-Qar,3560,3973,0,3973,12745,1239,0,25490,3715,4102,0,4102,13106,1084,0,26109
2010,Iraq,Sulaymaniyah,6,6,0,6,20,2,0,40,6,6,0,6,20,2,0,40
2010,Iraq,Sulaimaniya   ,2954,3559,0,3551,11387,1066,0,22517,3113,3658,0,3675,11767,975,0,23188
2010,Iraq,Salah al-Din,3184,3553,0,3553,11401,1109,0,22800,3323,3669,0,3669,11724,970,0,23355
2010,Iraq,Qadissyah,1876,2094,0,2094,6717,653,0,13434,1958,2163,0,2163,6907,571,0,13762
2010,Iraq,Ninewa,12509,13967,0,13958,44801,4352,0,89587,13055,14420,0,14414,46058,3810,0,91757
2010,Iraq,Najaf,3136,3501,0,3499,11221,1091,0,22448,3271,3612,0,3612,11541,954,0,22990
2010,Iraq,Muthanna,1084,1211,0,1211,3883,377,0,7766,1132,1250,0,1250,3993,330,0,7955
2010,Iraq,Missan,2899,3235,0,3236,10376,1008,0,20754,3025,3340,0,3340,10675,882,0,21262
2010,Iraq,Makhmwr,989,1035,0,1049,1649,777,0,5499,1061,1047,0,1152,1540,802,0,5602
2010,Iraq,Kirkuk,3430,3825,0,3825,12274,1193,0,24547,3578,3951,0,3951,12624,1043,0,25147
2010,Iraq,Kerbala,3595,4012,0,4011,12870,1250,0,25738,3751,4144,0,4142,13233,1094,0,26364
2010,Iraq,Erbil,3168,3667,0,3627,11672,1096,0,23230,3324,3772,0,3751,12198,966,0,24011
2010,Iraq,Dohuk   ,6329,7121,0,6917,21825,2112,0,44304,6624,7421,0,7133,22560,1857,0,45595
2010,Iraq,Diyala,11192,12492,0,12495,40078,3897,0,80154,11678,12895,0,12897,41215,3406,0,82091
2010,Iraq,Dahuk,12,14,0,14,44,4,0,88,13,14,0,14,46,4,0,91
2010,Iraq,Basrah,2600,2919,0,2919,9334,908,0,18680,2713,3009,0,3002,9617,792,0,19133
2010,Iraq,Baghdad,29175,32846,0,32893,106263,10519,0,211696,30471,33867,0,33933,109389,9290,0,216950
2010,Iraq,Babylon,3864,4313,0,4313,13834,1347,0,27671,4032,4452,0,4452,14229,1176,0,28341
2010,Iraq,Anbar/Al-Waleed : Point,20,53,0,47,99,10,0,229,27,54,0,37,166,21,0,305
2010,Iraq,Anbar,3770,4208,0,4208,13498,1311,0,26995,3934,4345,0,4345,13881,1147,0,27652
2010,Iceland,Reykjavik : Point,1,0,0,0,4,0,0,5,2,1,0,1,13,0,0,17
2010,Italy,Italy : Dispersed in the country / territory,0,0,0,0,0,0,887,887,0,0,0,0,0,0,3189,3189
2010,Jamaica,Jamaica : Dispersed in the country / territory,1,0,0,1,5,0,0,7,0,3,0,2,9,0,0,14
2010,Jordan,Zarqa,196,254,0,137,701,78,0,1366,160,245,0,191,762,61,0,1419
2010,Jordan,Tafilah,5,1,0,3,3,0,0,12,1,3,0,1,5,1,0,11
2010,Jordan,Mafraq,18,27,0,18,76,3,0,142,33,31,0,7,81,4,0,156
2010,Jordan,Madaba,14,16,0,11,39,3,0,83,16,12,0,15,70,3,0,116
2010,Jordan,Ma'an,8,11,0,4,25,2,0,50,5,9,0,2,33,1,0,50
2010,Jordan,Karak,11,13,0,8,41,1,0,74,10,22,0,6,50,2,0,90
2010,Jordan,Jarash,8,8,0,1,6,0,0,23,5,9,0,0,16,1,0,31
2010,Jordan,Irbid,51,84,0,45,256,34,0,470,61,87,0,40,335,38,0,561
2010,Jordan,Balqa,5,8,0,12,47,6,0,78,13,18,0,16,53,2,0,102
2010,Jordan,Aqaba,2,8,0,9,24,2,0,45,6,10,0,4,35,2,0,57
2010,Jordan,Amman,1171,1709,0,1433,7823,1442,0,13578,1295,1886,0,1508,8614,1259,0,14562
2010,Jordan,Ajlun,8,12,0,5,20,1,0,46,6,12,0,4,30,2,0,54
2010,Japan,Japan : Dispersed in the country / territory,0,0,0,0,0,0,1957,1957,0,0,0,0,0,0,4902,4902
2010,Kenya,Nairobi : District,1324,2704,0,2607,14553,693,0,21881,1410,2729,0,2736,17091,760,0,24726
2010,Kenya,Kakuma : Point,5739,7981,0,5468,17798,753,0,37739,6027,8863,0,6917,21240,421,0,43468
2010,Kenya,Ifo : Point,7589,11304,0,6000,21926,1754,0,48573,7928,11976,0,7118,20293,1722,0,49037
2010,Kenya,Hagadera : Point,7523,11043,0,6555,23234,1703,0,50058,7878,11869,0,7935,22042,1724,0,51448
2010,Kenya,Dagahaley : Point,7897,12390,0,5857,19946,1491,0,47581,8122,13231,0,6859,16244,1433,0,45889
2010,Kenya,Dadaab : Point,770,1056,0,610,2278,153,0,4867,754,1146,0,771,2799,134,0,5604
2010,Kyrgyzstan,Osh : Point,4,11,0,5,16,0,780,816,0,13,0,7,12,0,600,632
2010,Kyrgyzstan,Bishkek : Point,33,79,0,61,186,8,500,867,36,65,0,63,322,10,600,1096
2010,Kyrgyzstan,Ysyk-kol : Oblast - Region,0,0,0,0,0,0,250,250,0,0,0,0,0,0,200,200
2010,Kyrgyzstan,Talas : Oblast - Region,0,0,0,0,0,0,240,240,0,0,0,0,0,0,230,230
2010,Kyrgyzstan,Osh : Oblast - Region,250,600,0,300,1800,800,0,3750,200,500,0,277,1000,900,0,2877
2010,Kyrgyzstan,Naryn : Oblast - Region,0,0,0,0,0,0,250,250,0,0,0,0,0,0,200,200
2010,Kyrgyzstan,Kyrgyzstan : Dispersed in the country / territory,0,0,0,0,0,0,149200,149200,0,0,0,0,0,0,130800,130800
2010,Kyrgyzstan,Jalal-abad : Oblast - Region,400,550,0,200,1700,500,1020,4370,450,500,0,300,1200,500,930,3880
2010,Kyrgyzstan,Chuy : Oblast - Region,0,1,0,1,3,0,1150,1155,0,2,0,0,8,0,950,960
2010,Kyrgyzstan,Batken : Oblast - Region,100,150,0,30,600,300,0,1180,150,200,0,50,400,300,0,1100
2010,Cambodia,Phnom Penh Urban : Point,2,3,0,5,22,1,0,33,5,12,0,2,61,2,0,82
2010,Cambodia,Phnom Penh Camp : Point,3,6,0,16,17,0,0,42,1,7,0,8,7,0,0,23
2010,Rep. of Korea,Whasung : Point,0,0,0,0,3,1,0,4,0,0,0,0,11,0,0,11
2010,Rep. of Korea,Suwon : Point,0,0,0,0,0,0,0,0,0,0,0,0,6,1,0,7
2010,Rep. of Korea,Seoul : Point,20,12,0,1,134,2,0,169,20,10,0,4,506,4,0,544
2010,Rep. of Korea,Pohang : Point,0,0,0,0,0,0,0,0,0,0,0,0,1,0,0,1
2010,Rep. of Korea,Jeju,0,0,0,0,0,0,0,0,0,0,0,0,1,0,0,1
2010,Rep. of Korea,Daejeon : Point,0,0,0,0,1,1,0,2,0,0,0,0,4,1,0,5
2010,Rep. of Korea,Daegu : Point,2,0,0,0,3,0,0,5,0,0,0,0,6,0,0,6
2010,Rep. of Korea,Busan : Point,0,0,0,0,0,0,0,0,0,0,0,0,4,0,0,4
2010,Rep. of Korea,Inchon : Do - Province,0,1,0,0,2,0,0,3,0,0,0,0,15,0,0,15
2010,Rep. of Korea,Euijeongbu : Point,0,0,0,0,1,0,0,1,0,0,0,0,2,0,0,2
2010,Rep. of Korea,Cheongju : Point,0,0,0,0,0,0,0,0,0,0,0,0,2,0,0,2
2010,Kuwait,Kuwait : Dispersed in the country / territory,65,56,0,123,357,133,0,734,78,82,0,136,546,184,0,1026
2010,Lebanon,South,72,103,0,45,197,11,0,428,97,105,0,51,476,17,0,746
2010,Lebanon,North,7,8,0,4,27,2,0,48,8,10,0,5,54,2,0,79
2010,Lebanon,Mount Lebanon,324,334,0,265,1348,111,0,2382,355,402,0,278,2958,93,0,4086
2010,Lebanon,Bekaa,36,26,0,20,94,5,0,181,30,40,0,43,155,13,0,281
2010,Lebanon,Beirut,45,48,0,29,219,11,0,352,54,57,0,44,724,18,0,897
2010,Liberia,VOA : Point,5,8,0,8,19,6,0,46,6,7,0,11,17,5,0,46
2010,Liberia,Samukai : Point,2,4,0,5,6,1,0,18,2,2,0,5,4,1,0,14
2010,Liberia,Saclepea : Point,108,132,0,111,264,17,0,632,87,137,0,87,283,10,0,604
2010,Liberia,Nimba : County,2317,2601,0,1025,4506,539,0,10988,2294,2799,0,1145,2549,264,0,9051
2010,Liberia,Monrovia : Point,6,19,0,10,32,0,0,67,3,13,0,17,93,0,0,126
2010,Liberia,Maryland : County,20,11,0,17,23,0,0,71,21,15,0,12,189,2,0,239
2010,Liberia,Grand Gedeh : County,316,281,0,135,646,90,0,1468,323,318,0,174,527,34,0,1376
2010,Liberia,Banjor : Point,2,3,0,4,2,1,0,12,1,3,0,4,3,1,0,12
2010,Libya,Tripoli : Point,283,522,0,543,3012,167,0,4527,302,557,0,571,4799,361,0,6590
2010,Saint Lucia,Castries : Point,0,0,0,0,1,0,0,1,0,0,0,0,5,0,0,5
2010,Sri Lanka,Vavuniya : Division,0,0,0,0,0,0,94324,94324,0,0,0,0,0,0,90629,90629
2010,Sri Lanka,Puttalam : Division,0,0,0,0,0,0,35343,35343,0,0,0,0,0,0,33957,33957
2010,Sri Lanka,Mannar : Division,0,0,0,0,0,0,9281,9281,0,0,0,0,0,0,8919,8919
2010,Sri Lanka,Jaffna : Division,0,0,0,0,0,0,67931,67931,0,0,0,0,0,0,65269,65269
2010,Sri Lanka,Gampaha : Division,17,22,0,9,86,5,0,139,15,22,0,30,90,2,0,159
2010,Sri Lanka,Colombo : Division,0,0,0,1,2,0,0,3,1,1,0,0,58,0,0,60
2010,Sri Lanka,Batticaloa : Point,0,0,0,0,0,0,1224,1224,0,0,0,0,0,0,1176,1176
2010,Sri Lanka,Ampara : Division,0,0,0,0,0,0,1173,1173,0,0,0,0,0,0,1127,1127
2010,Sri Lanka,Trincomalee : Division,0,0,0,0,0,0,3008,3008,0,0,0,0,0,0,2892,2892
2010,Sri Lanka,Sri Lanka : Dispersed in the country / territory,0,0,0,0,0,0,6732,6732,0,0,0,0,0,0,6468,6468
2010,Sri Lanka,Kilinochchi : Division,0,0,0,0,0,0,635,635,0,0,0,0,0,0,612,612
2010,Sri Lanka,Anuradhapura : Division,0,0,0,0,0,0,2141,2141,0,0,0,0,0,0,2059,2059
2010,Lithuania,Vilnius district,0,0,0,0,1,0,0,1,0,1,0,0,1,0,0,2
2010,Lithuania,RRC Rukla : Point,1,2,0,0,5,1,0,9,6,0,0,4,7,0,0,17
2010,Lithuania,FRC Pabrade : Point,1,0,0,3,15,0,0,19,0,4,0,0,41,0,0,45
2010,Lithuania,Elektrenai : Point,0,0,0,0,1,0,0,1,1,0,0,2,1,0,0,4
2010,Lithuania,Vilnius : Savivaldybe - Municipality,0,0,0,0,0,0,0,0,0,0,0,0,1,0,0,1
2010,Lithuania,Lithuania : Dispersed in the country / territory,9,10,0,9,1084,429,0,1541,14,11,0,22,1635,451,0,2133
2010,Lithuania,Kaunas : Savivaldybe - Municipality,0,0,0,0,1,0,0,1,0,0,0,3,1,0,0,4
2010,Lithuania,Jonavos Raj. : Savivaldybe - Municipality,0,0,0,0,2,0,0,2,3,0,0,0,6,0,0,9
2010,Latvia,Mucenieki : Point,0,1,0,1,4,0,0,6,0,0,0,7,18,0,0,25
2010,Latvia,Latvia : Dispersed in the country / territory,4,2,0,7,14,0,0,27,3,5,0,7,48,0,0,63
2010,"China, Macao SAR","Macao, SAR China",1,1,0,0,2,0,0,4,0,1,0,0,5,0,0,6
2010,Morocco,Rabat : Point,44,44,0,42,178,5,0,313,56,53,0,48,596,6,0,759
2010,Rep. of Moldova,Republic of Moldova : Dispersed in the country / territory,0,3,0,6,1113,119,0,1241,0,12,0,7,830,89,0,938
2010,Rep. of Moldova,Chisinau : Municipality,1,0,0,5,19,0,0,25,2,4,0,4,44,2,0,56
2010,Mexico,Mexico City : Point,10,26,0,71,386,28,0,521,9,25,0,85,884,43,0,1046
2010,The former Yugoslav Republic of Macedonia,Vizbegovo,6,2,0,2,6,0,0,16,0,1,0,10,78,0,0,89
2010,The former Yugoslav Republic of Macedonia,Valandovo : Opština - Municipality,0,0,0,0,3,0,0,3,0,0,0,0,2,0,0,2
2010,The former Yugoslav Republic of Macedonia,Tetovo : Opština - Municipality,9,15,0,7,64,12,0,107,6,10,0,8,42,2,0,68
2010,The former Yugoslav Republic of Macedonia,Sveti Nikole : Region,0,0,0,0,0,1,0,1,0,0,0,0,0,0,0,0
2010,The former Yugoslav Republic of Macedonia,Strumica : Point,0,0,0,1,2,0,0,3,0,0,0,0,0,0,0,0
2010,The former Yugoslav Republic of Macedonia,Stip : Region,4,2,0,0,7,1,0,14,6,2,0,3,2,0,0,13
2010,The former Yugoslav Republic of Macedonia,Skopje : Region,120,194,0,164,657,34,0,1169,138,215,0,149,548,29,0,1079
2010,The former Yugoslav Republic of Macedonia,Radovis : Opština - Municipality,0,0,0,0,0,0,0,0,0,0,0,0,1,0,0,1
2010,The former Yugoslav Republic of Macedonia,Probistip,0,0,0,0,0,1,0,1,0,0,0,0,0,0,0,0
2010,The former Yugoslav Republic of Macedonia,Prilep : Opština - Municipality,2,8,0,3,10,0,0,23,3,2,0,6,4,1,0,16
2010,The former Yugoslav Republic of Macedonia,Ohrid : Opština - Municipality,0,0,0,0,0,0,0,0,0,0,0,0,1,0,0,1
2010,The former Yugoslav Republic of Macedonia,Kumanovo : Opština - Municipality,11,10,0,12,66,3,0,102,12,14,0,12,43,9,0,90
2010,The former Yugoslav Republic of Macedonia,Kocani : Region,0,0,0,0,1,0,0,1,0,0,0,0,0,0,0,0
2010,The former Yugoslav Republic of Macedonia,Kicevo : Opština - Municipality,1,0,0,0,19,1,0,21,0,4,0,1,10,0,0,15
2010,The former Yugoslav Republic of Macedonia,Kavadarci : Opština - Municipality,0,0,0,0,2,0,0,2,0,0,0,0,0,0,0,0
2010,The former Yugoslav Republic of Macedonia,Gostivar : Opština - Municipality,7,7,0,5,28,1,0,48,3,8,0,12,14,6,0,43
2010,The former Yugoslav Republic of Macedonia,Gevgelija : Opština - Municipality,0,0,0,0,2,0,0,2,0,0,0,0,1,0,0,1
2010,The former Yugoslav Republic of Macedonia,Debar : Region,2,0,0,0,0,0,0,2,1,1,0,0,0,0,0,2
2010,The former Yugoslav Republic of Macedonia,Bitola : Region,15,14,0,3,38,0,0,70,15,9,0,5,35,0,0,64
2010,The former Yugoslav Republic of Macedonia,Berovo : Opština - Municipality,0,0,0,0,1,0,0,1,0,0,0,0,0,0,0,0
2010,Mali,Sikasso : Point,795,1400,0,686,2021,144,0,5046,864,1455,0,698,2187,218,0,5422
2010,Mali,Kayes : Point,4,3,0,2,15,1,0,25,6,5,0,4,8,0,0,23
2010,Mali,Faragouana : Point,0,0,0,0,0,0,0,0,0,0,0,0,27,0,0,27
2010,Mali,Bamako : Point,157,149,0,241,1027,18,0,1592,159,193,0,239,2501,34,0,3126
2010,Malta,Santa Venera : ADMIN_1,0,0,0,4,0,0,0,4,0,0,0,12,0,0,0,12
2010,Malta,Safi : ADMIN_1,0,0,0,0,0,0,0,0,0,0,0,0,0,0,39,39
2010,Malta,MEC accomodation,0,0,0,0,0,0,0,0,0,0,0,0,0,0,152,152
2010,Malta,Marsa : ADMIN_1,0,0,0,0,0,0,0,0,0,0,0,0,670,0,0,670
2010,Malta,Hal Far,0,0,0,0,0,0,0,0,0,0,0,0,0,0,1139,1139
2010,Malta,Fgura : ADMIN_1,0,0,0,0,0,0,0,0,0,0,0,42,0,0,0,42
2010,Malta,Balzan : ADMIN_1,0,0,0,0,0,0,0,0,0,0,0,0,166,0,0,166
2010,Malta,Malta : Dispersed in the country / territory,0,0,0,0,0,0,200,200,0,0,0,0,0,0,800,800
2010,Myanmar,Southeast Myanmar,2535,4436,0,5070,16374,3169,0,31584,2425,4261,0,4566,16744,2435,0,30431
2010,Myanmar,Northern Rakhine State,50712,63390,0,123928,167681,16904,0,422615,44964,56205,0,104916,153700,14988,0,374773
2010,Montenegro,Pluzine : Point,0,0,0,0,1,0,0,1,0,0,0,0,1,0,0,1
2010,Montenegro,Cetinje : Point,0,0,0,2,12,3,0,17,1,1,0,0,6,1,0,9
2010,Montenegro,Zabljak : Opština - Municipality,0,0,0,0,0,1,0,1,0,0,0,0,0,0,0,0
2010,Montenegro,Ulcinj : Opština - Municipality,2,14,0,14,92,33,0,155,4,20,0,16,101,21,0,162
2010,Montenegro,Tivat : Opština - Municipality,1,18,0,26,222,85,0,352,0,20,0,35,226,73,0,354
2010,Montenegro,Savnik : Opština - Municipality,0,0,0,0,0,0,0,0,0,0,0,0,0,1,0,1
2010,Montenegro,Rozaj : Opština - Municipality,4,10,0,18,68,11,0,111,5,22,0,20,59,8,0,114
2010,Montenegro,Podgorica : Opština - Municipality,205,398,0,370,1769,478,0,3220,216,419,0,443,1790,363,0,3231
2010,Montenegro,Pljevlja : Opština - Municipality,2,1,0,9,60,17,0,89,5,6,0,4,51,13,0,79
2010,Montenegro,Plav : Opština - Municipality,4,10,0,25,140,52,0,231,4,18,0,29,139,42,0,232
2010,Montenegro,Niksic : Opština - Municipality,6,22,0,41,272,80,0,421,14,21,0,45,223,47,0,350
2010,Montenegro,Mojkovac : Opština - Municipality,0,1,0,2,15,4,0,22,1,2,0,4,15,4,0,26
2010,Montenegro,Kotor : Opština - Municipality,0,11,0,8,94,48,0,161,1,7,0,15,123,28,0,174
2010,Montenegro,Kolasin : Opština - Municipality,1,5,0,4,57,24,0,91,1,5,0,10,63,15,0,94
2010,Montenegro,Herceg Novi : Opština - Municipality,5,22,0,44,538,228,0,837,3,33,0,57,449,152,0,694
2010,Montenegro,Danilovgrad : Point,2,10,0,20,116,51,0,199,3,12,0,26,107,31,0,179
2010,Montenegro,Budva : Opština - Municipality,6,22,0,27,253,94,0,402,4,24,0,40,224,61,0,353
2010,Montenegro,Bijelo Polje : Opština - Municipality,1,6,0,17,69,13,0,106,1,6,0,21,62,6,0,96
2010,Montenegro,Berane : Opština - Municipality,48,71,0,120,414,145,0,798,48,92,0,95,423,92,0,750
2010,Montenegro,Bar : Opština - Municipality,16,69,0,101,611,231,0,1028,28,59,0,107,587,176,0,957
2010,Montenegro,Andrijevica : Opština - Municipality,3,8,0,16,89,32,0,148,2,9,0,17,72,23,0,123
2010,Mongolia,Ulaanbaatar : Point,2,0,0,0,4,0,0,6,1,0,0,0,6,0,0,7
2010,Mongolia,Mongolia : Dispersed in the country / territory,0,1,0,0,6,2,0,9,1,1,0,0,16,3,0,21
2010,Mozambique,Zambezia : Point,2,5,0,2,21,0,0,30,3,7,0,2,48,0,0,60
2010,Mozambique,Tete : Point,1,1,0,2,7,0,0,11,0,1,0,1,8,2,0,12
2010,Mozambique,Sofala : Point,3,2,0,2,10,1,0,18,1,5,0,2,15,1,0,24
2010,Mozambique,Niassa : Point,9,27,0,11,30,0,0,77,8,21,0,11,58,0,0,98
2010,Mozambique,Nampula : Distrito,46,59,0,36,185,2,0,328,54,67,0,37,621,7,0,786
2010,Mozambique,Maratane : Point,442,612,0,344,1056,42,0,2496,490,666,0,448,2527,19,0,4150
2010,Mozambique,Maputo : Point,102,181,0,105,363,8,0,759,87,166,0,98,570,13,0,934
2010,Mozambique,Manica : Point,1,2,0,2,17,0,0,22,3,2,0,1,49,0,0,55
2010,Mozambique,Inhambane : Point,2,1,0,3,8,0,0,14,0,6,0,3,13,0,0,22
2010,Mozambique,Gaza : Point,2,3,0,2,7,0,0,14,1,7,0,1,16,0,0,25
2010,Mozambique,Cabo Delgado:Point,2,2,0,0,10,0,0,14,0,0,0,0,42,0,0,42
2010,Mauritania,Wilayas : Trarza / Brakna / Gorgol / Guidimakha / Assaba,173,189,0,84,313,24,0,783,169,157,0,68,189,19,0,602
2010,Mauritania,Nouakchott/Nouadhibou : Point,52,46,0,31,168,2,0,299,49,44,0,30,532,4,0,659
2010,Montserrat,Montserrat : Dispersed in the country / territory,0,0,0,0,0,0,0,0,0,0,0,0,14,0,0,14
2010,Malawi,Dzaleka : Point,1073,1437,0,950,2422,0,0,5882,1127,1458,0,1090,3262,0,0,6937
2010,Malaysia,Kuala Lumpur : Wilayah Persekutuan - Federal State,3704,2628,0,2294,18889,372,0,27887,3884,2733,0,3144,54693,516,0,64970
2010,Namibia,Osire : Point,522,700,0,566,1584,56,0,3428,494,746,0,564,2179,60,0,4043
2010,Namibia,Namibia: Dispersed in the country,0,0,0,0,0,0,10,10,0,0,0,0,0,0,18,18
2010,Namibia,Namibia : Dispersed in the country / territory,107,101,0,91,170,6,0,475,142,92,0,69,399,27,0,729
2010,Niger,Niamey : Point,9,22,0,28,72,4,0,135,9,18,0,14,135,6,0,182
2010,Niger,Goure : Point,2,1,0,0,3,0,0,6,0,0,0,1,8,0,0,9
2010,Nigeria,Oru Camp : Point,30,202,0,140,1074,33,0,1479,38,137,0,220,1206,46,0,1647
2010,Nigeria,Lagos : Point,180,203,0,260,1677,8,0,2328,168,195,0,383,2111,116,0,2973
2010,Nigeria,Benue : State,77,60,0,85,163,19,0,404,48,80,0,58,125,13,0,324
2010,Nigeria,Amana : Point,145,160,0,100,351,35,0,791,122,100,0,99,81,18,0,420
2010,Nigeria,Maidugur : Local Authority,3,7,0,5,14,1,0,30,9,5,0,10,8,4,0,36
2010,Nigeria,Ijebuode : Local Authority,11,9,0,8,22,0,0,50,9,8,0,5,58,0,0,80
2010,Nicaragua,Rivas : ADMIN_1,0,0,0,1,4,0,0,5,0,1,0,2,4,0,0,7
2010,Nicaragua,Ocotal,0,0,0,1,1,0,0,2,0,0,0,1,0,0,0,1
2010,Nicaragua,Nueva Guinea,0,0,0,0,11,0,0,11,0,0,0,1,0,2,0,3
2010,Nicaragua,Managua : Point,1,1,0,1,6,0,0,9,0,1,0,2,34,0,0,37
2010,Nicaragua,Puerto Cabezas : Municipio,0,0,0,0,0,0,0,0,0,0,0,0,1,0,0,1
2010,Netherlands,Netherlands : Dispersed in the country/territory,0,0,0,0,0,0,4533,4533,0,0,0,0,0,0,8514,8514
2010,Nepal,Timai : Point,304,438,0,447,2062,216,0,3467,356,429,0,506,2061,239,0,3591
2010,Nepal,Sanischare : Point,581,807,0,951,3921,436,0,6696,610,925,0,891,4018,509,0,6953
2010,Nepal,Khudunabari : Point,410,599,0,696,3472,362,0,5539,426,598,0,656,3366,482,0,5528
2010,Nepal,Kathmandu : Point,19,22,0,2,68,1,0,112,23,25,0,19,108,2,143,320
2010,Nepal,Goldhap : Point,207,285,0,265,1429,163,0,2349,204,276,0,271,1472,192,0,2415
2010,Nepal,Beldangi 2 : Point,618,792,0,950,4499,498,0,7357,619,874,0,1081,4512,602,0,7688
2010,Nepal,Beldangi 1 : Point,578,812,0,882,3722,394,0,6388,628,778,0,954,3778,493,0,6631
2010,Nepal,Nepal : Dispersed in the country / territory,3,11,0,8,53,6,1238,1319,3,11,0,9,90,9,1147,1269
2010,Nepal,Beldangi 2 Extension : Point,354,454,0,546,2581,294,0,4229,402,507,0,601,2616,342,0,4468
2010,Oman,Oman : Dispersed in the country / territory,8,7,0,4,32,2,0,53,2,5,0,5,23,3,0,38
2010,Pakistan,Zar Karez : Point,379,791,0,400,1088,74,0,2732,402,858,0,500,1257,147,0,3164
2010,Pakistan,Zangal Patai : Point,565,707,0,469,1225,62,0,3028,544,748,0,580,1254,139,0,3265
2010,Pakistan,Zafarabad : Point,355,695,0,390,1018,49,0,2507,399,731,0,557,1440,129,0,3256
2010,Pakistan,Yakaghund : Point,379,483,0,318,752,58,0,1990,341,508,0,325,739,87,0,2000
2010,Pakistan,Utmanzai : Point,364,565,0,336,859,30,0,2154,422,551,0,334,864,116,0,2287
2010,Pakistan,Urguch : Point,3,9,0,5,12,1,0,30,5,8,0,4,27,0,0,44
2010,Pakistan,Toor : Point,233,790,0,535,1328,82,0,2968,218,823,0,559,1483,166,0,3249
2010,Pakistan,Togh Sarai,530,654,0,336,1082,91,0,2693,627,839,0,299,959,83,0,2807
2010,Pakistan,Timer : Point,359,1647,0,1002,2546,123,0,5677,377,1756,0,1112,2598,244,0,6087
2010,Pakistan,Thall : Point,729,1821,0,1266,3274,290,0,7380,842,1871,0,1442,3351,533,0,8039
2010,Pakistan,Surkhab : Point,416,1627,0,777,2456,174,0,5450,397,1748,0,1038,3325,346,0,6854
2010,Pakistan,Sund Rawal : Point,29,92,0,60,114,11,0,306,45,101,0,58,154,18,0,376
2010,Pakistan,Sind : Province,5294,8438,0,5867,16743,769,0,37111,5579,8815,0,6983,21964,1908,0,45249
2010,Pakistan,Shindand : Point,128,212,0,161,327,16,0,844,117,220,0,164,361,39,0,901
2010,Pakistan,Shaikh Abad : Point,583,783,0,511,1246,81,0,3204,577,783,0,558,1350,119,0,3387
2010,Pakistan,Saranan : Point,1748,3169,0,1972,5146,320,0,12355,1822,3317,0,2410,6103,779,0,14431
2010,Pakistan,Rata Kulachi : Point,51,91,0,41,118,7,0,308,40,90,0,71,145,19,0,365
2010,Pakistan,Rakh Zandani : Point,0,1,0,0,1,0,0,2,1,1,0,3,4,0,0,9
2010,Pakistan,Quetta : Point,0,5,0,3,20,0,0,28,2,5,0,3,21,1,0,32
2010,Pakistan,Pusha Pul : Point,101,174,0,98,256,14,0,643,100,194,0,149,346,33,0,822
2010,Pakistan,Punjab : Province,13281,18938,0,11614,33741,2057,0,79631,14033,20042,0,14207,46547,3862,0,98691
2010,Pakistan,Posti : Point,6,27,0,20,42,4,0,99,12,29,0,15,63,7,0,126
2010,Pakistan,Pir Alizai : Point,1161,1751,0,1066,2647,142,0,6767,1146,1838,0,1366,3647,393,0,8390
2010,Pakistan,Peshawar : Point,1,7,0,3,5,0,0,16,1,8,0,3,11,0,0,23
2010,Pakistan,Panian : Point,3625,9199,0,4966,13996,659,0,32445,3954,9339,0,5412,14776,1406,0,34887
2010,Pakistan,Palai : Point,358,440,0,233,745,47,0,1823,398,423,0,288,842,65,0,2016
2010,Pakistan,Padhana : Point,625,1518,0,854,2240,137,0,5374,644,1596,0,988,2521,270,0,6019
2010,Pakistan,Old Akora : Point,3751,4819,0,3183,8436,278,0,20467,3918,5008,0,3614,8980,885,0,22405
2010,Pakistan,Oblan : Point,634,1258,0,783,2003,116,0,4794,674,1280,0,941,2144,232,0,5271
2010,Pakistan,Nwfp : Province,34411,54439,0,37152,112535,5967,0,244504,36625,57977,0,42259,126014,11166,0,274041
2010,Pakistan,New Akora : Point,65,17,0,7,56,3,0,148,60,23,0,22,181,10,0,296
2010,Pakistan,Naurang : Point,27,314,0,185,530,21,0,1077,29,343,0,231,530,61,0,1194
2010,Pakistan,Naguman : Point,306,470,0,268,681,32,0,1757,325,443,0,331,715,78,0,1892
2010,Pakistan,Nagar : Point,41,35,0,23,58,2,0,159,43,39,0,15,96,5,0,198
2010,Pakistan,Munda : Point,1144,1495,0,957,2473,125,0,6194,1164,1498,0,1093,2496,283,0,6534
2010,Pakistan,Michni : Point,9,18,0,16,29,2,0,74,16,15,0,14,42,5,0,92
2010,Pakistan,Mera Kachori : Point,487,625,0,415,1082,82,0,2691,460,625,0,447,1146,118,0,2796
2010,Pakistan,Mayar : Point,65,348,0,258,555,46,0,1272,86,309,0,247,657,72,0,1371
2010,Pakistan,Malgagai : Point,698,867,0,577,1497,117,0,3756,717,936,0,703,1819,231,0,4406
2010,Pakistan,Lejay Karez : Point,9,164,0,105,273,24,0,575,14,129,0,148,364,50,0,705
2010,Pakistan,Lakti Banda : Point,614,870,0,637,1619,161,0,3901,633,910,0,710,1700,283,0,4236
2010,Pakistan,Kund/Khairabad,321,1792,0,951,2514,143,0,5721,365,1802,0,1115,2548,288,0,6118
2010,Pakistan,Kotwai : Point,487,1034,0,620,1435,124,0,3700,490,1152,0,673,1575,218,0,4108
2010,Pakistan,Kotkai : Point,328,437,0,361,920,80,0,2126,366,499,0,383,945,142,0,2335
2010,Pakistan,Kot Chandna : Point,1644,1990,0,1416,3423,185,0,8658,1735,2054,0,1488,3516,336,0,9129
2010,Pakistan,Koga : Point,151,1291,0,806,2097,112,0,4457,163,1388,0,913,2076,186,0,4726
2010,Pakistan,Khurasan,310,452,0,346,1159,83,0,2350,331,461,0,323,1372,115,0,2602
2010,Pakistan,Khoughani,90,198,0,132,377,10,0,807,101,197,0,155,368,26,0,847
2010,Pakistan,Kheshki : Point,69,51,0,41,105,5,0,271,62,65,0,51,109,14,0,301
2010,Pakistan,Khazana : Point,576,708,0,469,1180,73,0,3006,594,730,0,571,1396,120,0,3411
2010,Pakistan,Khaki : Point,592,2050,0,1446,3496,273,0,7857,624,2125,0,1603,3595,417,0,8364
2010,Pakistan,Kesu : Point,122,107,0,93,206,12,0,540,153,145,0,101,254,17,0,670
2010,Pakistan,Kata Kanri : Point,533,732,0,526,1302,101,0,3194,554,796,0,556,1317,178,0,3401
2010,Pakistan,Karachi : Point,1,13,0,12,36,1,0,63,3,8,0,15,57,0,0,83
2010,Pakistan,Kalatak : Point,158,185,0,117,291,20,0,771,200,207,0,161,419,31,0,1018
2010,Pakistan,Kaghan : Point,228,261,0,151,423,38,0,1101,244,289,0,184,431,42,0,1190
2010,Pakistan,Kababian : Point,994,1371,0,847,2615,78,0,5905,1046,1408,0,980,3639,236,0,7309
2010,Pakistan,Jerma,49,138,0,95,264,16,0,562,69,148,0,133,340,27,0,717
2010,Pakistan,Jalozai : Point,9974,12699,0,5103,20081,1020,0,48877,10138,14589,0,6743,19002,1399,0,51871
2010,Pakistan,Jalala : Point,1481,1764,0,1164,3118,166,0,7693,1498,1893,0,1313,3371,326,0,8401
2010,Pakistan,Islamabad : Point,12,45,0,52,176,5,0,290,14,50,0,71,254,4,0,393
2010,Pakistan,Islamabad : District,2647,3833,0,2440,7532,429,0,16881,2739,4158,0,2986,9157,866,0,19906
2010,Pakistan,Ichirian : Point,509,1005,0,590,1671,90,0,3865,473,946,0,688,1952,181,0,4240
2010,Pakistan,Girsal : Point,0,1,0,0,2,0,0,3,0,1,0,2,3,0,0,6
2010,Pakistan,Girdi Jungle : Point,1362,3699,0,1998,5717,926,0,13702,1548,3535,0,2676,8902,1279,0,17940
2010,Pakistan,Ghulam Banda : Point,490,968,0,739,1764,75,0,4036,522,1086,0,786,1996,195,0,4585
2010,Pakistan,Ghiljo : Point,120,202,0,126,339,19,0,806,104,241,0,134,349,41,0,869
2010,Pakistan,Ghazi : Point,20,41,0,14,61,4,0,140,19,50,0,16,78,8,0,171
2010,Pakistan,Ghazgai Minara,144,387,0,174,477,35,0,1217,152,419,0,237,605,68,0,1481
2010,Pakistan,Gandaf : Point,313,1660,0,1178,2688,162,0,6001,319,1858,0,1196,3090,267,0,6730
2010,Pakistan,Gamkol : Point,1996,4130,0,2721,6985,357,0,16189,2000,4173,0,3304,8779,724,0,18980
2010,Pakistan,Gambila : Point,31,302,0,129,464,20,0,946,28,296,0,201,514,64,0,1103
2010,Pakistan,Domshivgar : Point,26,25,0,16,44,3,0,114,20,22,0,26,59,6,0,133
2010,Pakistan,Dodpa : Point,2,47,0,20,56,3,0,128,5,46,0,28,71,5,0,155
2010,Pakistan,Doaba : Point,209,720,0,519,1389,121,0,2958,248,733,0,582,1713,229,0,3505
2010,Pakistan,Darsamand : Point,270,600,0,420,1182,108,0,2580,294,634,0,467,1481,194,0,3070
2010,Pakistan,Daraban : Point,7,8,0,7,16,0,0,38,4,12,0,4,22,2,0,44
2010,Pakistan,Dabara : Point,202,332,0,209,562,32,0,1337,301,436,0,290,1087,92,0,2206
2010,Pakistan,Chichana : Point,196,450,0,335,897,57,0,1935,216,456,0,399,1204,134,0,2409
2010,Pakistan,Chakdara : Point,1902,2183,0,1396,3305,208,0,8994,2039,2186,0,1548,3645,340,0,9758
2010,Pakistan,Chagai : Point,11,30,0,23,59,6,0,129,17,35,0,30,65,10,0,157
2010,Pakistan,Bizen Khel : Point,14,191,0,150,354,15,0,724,18,240,0,161,393,48,0,860
2010,Pakistan,Benazir Complex,145,193,0,58,244,8,0,648,172,232,0,89,229,9,0,731
2010,Pakistan,Basu Mera : Point,377,649,0,507,1201,60,0,2794,415,692,0,532,1124,164,0,2927
2010,Pakistan,Barawal : Point,14,50,0,29,78,5,0,176,15,59,0,26,100,8,0,208
2010,Pakistan,Barary : Point,695,991,0,610,1713,96,0,4105,675,1014,0,701,1911,165,0,4466
2010,Pakistan,Barari : Point,11,32,0,29,54,4,0,130,9,38,0,22,67,9,0,145
2010,Pakistan,Barakai : Point,2565,3686,0,2567,6396,312,0,15526,2708,3868,0,2895,6421,659,0,16551
2010,Pakistan,Bakka Khel : Point,11,108,0,59,166,10,0,354,14,136,0,72,265,22,0,509
2010,Pakistan,Baghicha : Point,61,87,0,68,156,14,0,386,77,92,0,59,216,22,0,466
2010,Pakistan,Badaber : Point,2726,3581,0,2374,6005,281,0,14967,2892,3637,0,2557,6658,634,0,16378
2010,Pakistan,Azakhel : Point,2546,2959,0,1900,4875,196,0,12476,2879,3108,0,2262,5207,410,0,13866
2010,Pakistan,Azad Kashmir,307,761,0,514,1352,61,0,2995,341,807,0,619,1813,160,0,3740
2010,Pakistan,Pakistan : Dispersed in the country / territory,64,179,0,211,556,26,0,1036,83,218,0,212,373,24,0,910
2010,Pakistan,Old Shamshatoo : Point,3651,6721,0,4855,13364,559,0,29150,3856,6948,0,5458,14662,1131,0,32055
2010,Pakistan,Mohammad Kheil : Point,88,910,0,361,1394,55,0,2808,96,991,0,514,1372,169,0,3142
2010,Pakistan,Gandhi Khan Khel : Point,100,518,0,308,861,54,0,1841,120,534,0,361,846,98,0,1959
2010,Pakistan,Balochistan : Province,16352,39508,0,22069,65914,4687,0,148530,16823,41717,0,27333,82099,9275,0,177247
2010,Panama,Panama : Distrito,274,750,0,2096,3185,863,0,7168,265,827,0,2611,4847,974,0,9524
2010,Panama,Kuna Yala : Point,5,13,0,16,25,1,0,60,4,12,0,14,29,1,0,60
2010,Panama,Darien : Provincia,68,71,0,70,149,14,0,372,68,57,0,60,161,25,0,371
2010,Peru,Peru : Dispersed in the country / territory,4,16,0,63,402,39,0,524,4,38,0,61,676,107,0,886
2010,Philippines,REGION XI,0,0,0,0,0,0,0,0,0,0,0,0,1,0,0,1
2010,Philippines,REGION VI,0,0,0,0,0,0,0,0,0,0,0,0,1,0,0,1
2010,Philippines,REGION IV-B,0,0,0,0,0,0,0,0,0,0,0,0,1,0,0,1
2010,Philippines,REGION IV-A,0,0,0,0,0,0,0,0,0,0,0,0,1,0,0,1
2010,Philippines,REGION III,0,0,0,0,2,0,0,2,0,0,0,0,5,0,0,5
2010,Philippines,REGION I,0,0,0,0,0,0,0,0,0,0,0,0,3,0,0,3
2010,Philippines,NCR ,0,0,0,0,0,0,0,0,0,0,0,0,1,0,0,1
2010,Philippines,CAR,0,0,0,0,0,0,0,0,0,0,0,0,2,0,0,2
2010,Philippines,CALABARZON,0,0,0,0,0,0,0,0,0,0,0,0,3,0,0,3
2010,Philippines,National Capital region (NCR) ,8,17,0,10,48,2,16,101,11,24,0,15,158,3,52,263
2010,Papua New Guinea,Port Moresby : Point,1,0,0,0,1,0,0,2,0,0,0,0,5,0,0,5
2010,Papua New Guinea,East Awin : Point,142,212,0,179,618,46,0,1197,142,243,0,206,661,51,0,1303
2010,Papua New Guinea,Daru : Province,0,0,0,0,0,0,0,0,0,0,0,0,3,0,0,3
2010,Paraguay,Asuncion : Point,2,0,0,3,32,1,0,38,0,0,0,5,71,1,0,77
2010,Qatar,Qatar : Dispersed in the country / territory,5,1,0,4,21,3,0,34,6,1,0,3,18,5,0,33
2010,Romania,Timisoara,0,0,0,1,0,0,0,1,0,0,0,2,39,0,0,41
2010,Romania,Somcuta Mare,2,0,0,1,5,0,0,8,1,0,0,7,45,0,0,53
2010,Romania,Radauti,0,7,0,1,6,0,0,14,0,10,0,4,42,0,0,56
2010,Romania,Galati,0,0,0,0,1,0,0,1,0,0,0,1,49,0,0,50
2010,Romania,Bucharest,1,0,0,7,16,0,0,24,3,0,0,15,116,3,0,137
2010,Russian Federation,Sankt-peterburg : Oblast - Region,0,0,0,1,0,0,0,1,0,0,0,0,17,0,0,17
2010,Russian Federation,Moskva : Oblast - Region,5,5,0,9,36,0,0,55,5,8,0,301,7,0,0,321
2010,Rwanda,Rwamagana : Point,5,2,0,1,14,1,0,23,8,5,0,2,9,0,0,24
2010,Rwanda,Rutsiro : Commune,136,101,0,28,298,7,0,570,132,99,0,18,113,4,0,366
2010,Rwanda,Rusizi : Point,81,53,0,26,148,10,0,318,80,49,0,22,41,1,0,193
2010,Rwanda,Rulindo : Point,23,11,0,4,35,0,0,73,15,11,0,2,16,0,0,44
2010,Rwanda,Ruhango : Point,11,8,0,3,34,1,0,57,20,11,0,1,10,1,0,43
2010,Rwanda,Rubavu : Commune,244,177,0,63,514,17,0,1015,252,140,0,33,266,13,0,704
2010,Rwanda,Nyaruguru : Point,21,7,0,3,41,0,0,72,27,4,0,4,13,0,0,48
2010,Rwanda,Nyarugenge : Commune,13,13,0,5,32,2,0,65,11,9,0,7,20,1,0,48
2010,Rwanda,Nyanza : Point,22,12,0,7,41,0,0,82,17,8,0,7,9,0,0,41
2010,Rwanda,Nyamasheke : Point,65,44,0,16,123,4,0,252,55,43,0,21,45,3,0,167
2010,Rwanda,Nyamagabe : Commune,28,15,0,4,49,3,0,99,26,19,0,3,21,1,0,70
2010,Rwanda,Nyabihu : Point,239,137,0,63,576,21,0,1036,224,145,0,66,240,19,0,694
2010,Rwanda,Ngororero : Point,83,61,0,39,221,12,0,416,90,36,0,22,98,5,0,251
2010,Rwanda,Ngoma : Commune,11,9,0,2,22,0,0,44,14,9,0,6,16,0,0,45
2010,Rwanda,Musanze : Point,82,56,0,27,236,4,0,405,104,39,0,20,88,6,0,257
2010,Rwanda,Muhanga : Point,29,13,0,5,40,3,0,90,15,8,0,0,24,1,0,48
2010,Rwanda,Kiziba : Point,1326,2077,0,1875,4682,463,0,10423,1140,2055,0,1732,3181,357,0,8465
2010,Rwanda,Kirehe : Point,22,15,0,4,34,0,0,75,13,12,0,11,33,3,0,72
2010,Rwanda,Kicukiro : Commune,4,1,0,1,9,0,0,15,2,5,0,0,7,0,0,14
2010,Rwanda,Kayonza : Commune,14,6,0,0,25,1,0,46,13,5,0,3,11,0,0,32
2010,Rwanda,Karongi : Point,117,89,0,38,263,9,0,516,121,71,0,24,74,8,0,298
2010,Rwanda,Kamonyi : Point,6,6,0,2,25,1,0,40,15,8,0,4,7,1,0,35
2010,Rwanda,Huye : Commune,29,20,0,6,59,1,0,115,27,16,0,7,23,2,0,75
2010,Rwanda,Gisagara : Point,7,5,0,1,18,1,0,32,9,10,0,2,9,0,0,30
2010,Rwanda,Gihembe : Point,1738,2469,0,1796,4438,392,0,10833,1713,2282,0,1708,3109,208,0,9020
2010,Rwanda,Gicumbi : Point,16,10,0,5,29,0,0,60,14,5,0,2,9,0,0,30
2010,Rwanda,Gatsibo : Point,1971,1883,0,1258,2995,173,0,8280,1943,1828,0,1118,1651,119,0,6659
2010,Rwanda,Gasabo : Point,6,9,0,1,19,0,0,35,8,4,0,1,11,0,0,24
2010,Rwanda,Gakenke : Point,13,6,0,4,26,3,0,52,17,13,0,4,12,1,0,47
2010,Rwanda,Burera : Point,19,14,0,6,53,2,0,94,15,6,0,6,20,0,0,47
2010,Rwanda,Bugesera : Point,53,41,0,16,101,4,0,215,50,22,0,12,37,1,0,122
2010,Rwanda,Nyagatare (Cyangugu) : Point,10,4,0,6,17,0,0,37,8,2,0,0,6,0,0,16
2010,Rwanda,Kigali-ngali : Prefecture,117,226,0,191,510,9,0,1053,127,198,0,193,477,12,0,1007
2010,Saudi Arabia,Riyadh : Point,4,39,0,28,100,3,0,174,8,34,0,47,163,7,0,259
2010,Saudi Arabia,Khobar : Point,0,0,0,0,5,1,0,6,0,1,0,0,8,0,0,9
2010,Saudi Arabia,Jeddah : Point,4,19,0,26,42,4,0,95,6,25,0,18,56,4,0,109
2010,Saudi Arabia,Arar : Point,0,0,0,0,0,0,0,0,0,0,0,0,2,0,0,2
2010,Saudi Arabia,Madinah : Emirate - Region,0,2,0,0,1,0,0,3,0,0,0,0,3,0,0,3
2010,Saudi Arabia,Al-Qateef : Point,0,2,0,1,1,0,0,4,0,0,0,4,1,0,0,5
2010,Sudan,Yei : Point,804,871,0,481,1459,128,0,3743,787,857,0,467,1109,75,0,3295
2010,Sudan,Yambio : Region,184,277,0,138,713,48,0,1360,202,250,0,129,682,41,0,1304
2010,Sudan,Warab : Wilayat - State,0,0,0,0,1,0,4150,4151,0,0,0,4,2,0,4150,4156
2010,Sudan,Wad Sherife : Point,892,1359,0,1401,4764,518,0,8934,959,1408,0,1387,2617,522,0,6893
2010,Sudan,Wad Medani : Point,0,1,0,0,0,0,0,1,0,0,0,0,0,1,0,1
2010,Sudan,Wad El Hileau : Point,26,40,0,26,65,10,0,167,16,35,0,17,61,10,0,139
2010,Sudan,Unity : Wilayat - State,0,0,0,1,0,0,1600,1601,0,0,0,0,0,0,1600,1600
2010,Sudan,Um Shalaya : Point,742,829,0,436,1563,279,0,3849,655,788,0,462,832,141,0,2878
2010,Sudan,Um Rakuba : Point,0,6,0,1,3,0,0,10,2,2,0,2,9,3,0,18
2010,Sudan,Um Gulja : Point,6,6,0,4,30,2,0,48,7,7,0,10,35,3,0,62
2010,Sudan,Um Gargur : Point,494,780,0,664,2125,219,0,4282,531,863,0,773,1832,360,0,4359
2010,Sudan,Um Dukhun : Point,0,0,0,0,0,0,4450,4450,0,0,0,0,0,0,4450,4450
2010,Sudan,Um Dafog,0,0,0,0,0,0,775,775,0,0,0,0,0,0,775,775
2010,Sudan,Um Bada,1,1,0,1,9,1,0,13,0,2,0,4,11,2,0,19
2010,Sudan,Tokar,0,0,0,0,0,0,0,0,0,0,0,0,1,0,0,1
2010,Sudan,Tendelti : Point,0,0,0,0,0,0,1250,1250,0,0,0,0,0,0,1250,1250
2010,Sudan,"Tambura, Wes : Point",152,161,0,170,246,8,0,737,165,148,0,149,268,4,0,734
2010,Sudan,Suwakin : Point,6,6,0,3,10,1,0,26,3,2,0,1,41,0,0,47
2010,Sudan,Sinkat,0,0,0,0,0,0,0,0,0,0,0,0,1,0,0,1
2010,Sudan,Shagarab 3 : Point,366,562,0,377,1400,110,0,2815,370,525,0,368,914,190,0,2367
2010,Sudan,Shagarab 2 : Point,541,827,0,526,1791,144,0,3829,587,861,0,592,1247,225,0,3512
2010,Sudan,Shagarab 1 : Point,880,1234,0,778,2978,236,0,6106,902,1330,0,855,2026,362,0,5475
2010,Sudan,Salmin,1,0,0,1,5,0,0,7,2,1,0,0,1,0,0,4
2010,Sudan,Port Sudan : Point,105,190,0,151,521,15,30,1012,119,185,0,157,932,25,30,1448
2010,Sudan,Pochalla : Point,333,528,0,197,856,50,0,1964,345,545,0,197,290,27,0,1404
2010,Sudan,"Nzara, WES",132,146,0,72,489,30,0,869,134,163,0,82,487,36,0,902
2010,Sudan,Nyala,0,0,0,1,2,0,0,3,0,0,0,1,11,3,0,15
2010,Sudan,New Halfa : Point,9,8,0,3,61,0,0,81,12,11,0,13,729,6,0,771
2010,Sudan,"Naandi, WES",95,115,0,59,265,11,0,545,100,116,0,62,219,14,0,511
2010,Sudan,Mukjar : Point,96,88,0,43,128,15,0,370,88,81,0,43,109,13,0,334
2010,Sudan,Malakal : Point,39,17,0,4,69,3,0,132,46,14,0,4,139,5,0,208
2010,Sudan,"Makpandu, WES",387,314,0,180,976,59,0,1916,338,303,0,178,1373,76,0,2268
2010,Sudan,Mafaza : Point,0,0,0,0,1,0,0,1,0,0,0,0,0,0,0,0
2010,Sudan,Lakes State,0,0,0,1,0,0,4900,4901,0,0,0,5,2,0,4900,4907
2010,Sudan,Kolain and Gelu,0,0,0,0,0,0,150,150,0,0,0,0,0,0,150,150
2010,Sudan,Kilo 7 : Point,20,34,0,18,127,13,0,212,30,37,0,30,111,22,0,230
2010,Sudan,Kilo 26 : Point,485,692,0,578,2036,191,0,3982,525,693,0,631,1490,287,0,3626
2010,Sudan,Khartoum Urban : Point,144,553,0,598,3133,99,0,4527,108,566,0,637,3787,157,0,5255
2010,Sudan,Khartoum North,0,5,0,10,49,4,0,68,0,5,0,4,50,4,0,63
2010,Sudan,Kassala : Point,266,350,0,330,1198,54,0,2198,270,380,0,370,1482,89,0,2591
2010,Sudan,Karkora : Point,0,0,0,5,4,2,0,11,0,1,0,2,6,1,0,10
2010,Sudan,Juba : Point,94,89,0,30,189,2,0,404,108,82,0,24,378,2,4,598
2010,Sudan,Ibba : Point,60,92,0,30,201,12,0,395,57,86,0,40,164,14,0,361
2010,Sudan,Hawata : Point,4,0,0,0,3,0,0,7,0,0,0,0,1,0,0,1
2010,Sudan,Habillah : Region,0,0,0,0,0,0,7500,7500,0,0,0,0,0,0,7500,7500
2010,Sudan,Gulsa : Point,3,8,0,5,12,1,0,29,3,2,0,4,1,1,0,11
2010,Sudan,Girba : Point,375,488,0,401,1564,149,0,2977,410,520,0,452,1026,221,0,2629
2010,Sudan,Gedaref : Point,50,92,0,95,239,9,0,485,77,106,0,107,349,22,0,661
2010,Sudan,Gari and Dabag,0,0,0,0,0,0,150,150,0,0,0,0,0,0,150,150
2010,Sudan,Fau Town : Point,0,1,0,0,1,0,0,2,1,2,0,0,0,0,0,3
2010,Sudan,Fau 5 : Point,57,87,0,52,236,22,0,454,73,94,0,53,219,35,0,474
2010,Sudan,Fath El Rahman : Point,13,24,0,28,86,16,0,167,17,23,0,22,69,23,0,154
2010,Sudan,"Ezo, Wes : Point",284,331,0,145,946,80,0,1786,280,346,0,169,885,73,0,1753
2010,Sudan,Es Showak : Point,3,5,0,5,13,1,0,27,3,6,0,3,15,2,0,29
2010,Sudan,El Geneina,0,0,0,0,0,0,0,0,0,0,0,0,70,0,0,70
2010,Sudan,El Fasher,0,0,0,0,0,0,0,0,0,0,0,0,60,0,0,60
2010,Sudan,Dordeab,1,2,0,3,4,0,0,10,1,0,0,0,2,0,0,3
2010,Sudan,Doka : Point,0,0,0,0,1,0,0,1,0,0,0,0,0,0,0,0
2010,Sudan,Bir Touk,0,0,0,0,0,0,125,125,0,0,0,0,0,0,125,125
2010,Sudan,Bir Khadija,0,0,0,0,0,0,100,100,0,0,0,0,0,0,100,100
2010,Sudan,Awad El Seid : Point,31,52,0,35,164,13,0,295,42,57,0,51,128,32,0,310
2010,Sudan,Aroma : Point,2,0,0,1,3,0,0,6,0,1,0,2,4,1,0,8
2010,Sudan,Armankul : Point,0,0,0,0,0,0,1150,1150,0,0,0,0,0,0,1150,1150
2010,Sudan,Abuda : Point,179,271,0,219,687,60,0,1416,166,284,0,229,566,84,0,1329
2010,Sudan,Abu Rakham area : Point,19,32,0,38,90,8,0,187,17,38,0,42,81,20,0,198
2010,Sudan,White Nile : Wilayat - State,0,0,0,1,1,0,0,2,1,0,0,0,1,0,0,2
2010,Sudan,Western Equatoria : Wilayat - State,0,0,0,1,2,0,16600,16603,1,0,0,2,2,0,16600,16605
2010,Sudan,Western Darfur : Wilayat - State,0,0,0,0,0,0,252000,252000,0,0,0,0,0,0,252000,252000
2010,Sudan,Western Bahr El Ghazal : Wilayat - State,1,0,0,4,2,0,1350,1357,2,0,0,5,6,0,1350,1363
2010,Sudan,Upper Nile : Wilayat - State,1,0,0,9,3,1,1600,1614,4,0,0,1,17,0,1600,1622
2010,Sudan,Sudan : Dispersed in the country / territory,0,0,0,0,0,0,3730,3730,0,0,0,0,0,0,3728,3728
2010,Sudan,Southern Kordofan : Wilayat - State,2,0,0,4,5,0,0,11,4,0,0,6,9,0,0,19
2010,Sudan,Southern Darfur : Wilayat - State,0,0,0,0,0,0,166050,166050,0,0,0,0,0,0,165050,165050
2010,Sudan,Red Sea : Wilayat - State,0,0,0,0,0,0,0,0,0,0,0,0,1,0,0,1
2010,Sudan,Northern Darfur : Wilayat - State,0,0,0,0,0,0,131000,131000,0,0,0,0,0,0,131000,131000
2010,Sudan,Northern Bahr El Ghazal : Wilayat - State,4,0,0,5,9,0,850,868,1,0,0,9,6,0,850,866
2010,Sudan,Northern : Wilayat - State,0,0,0,0,2,0,0,2,0,0,0,3,1,0,0,4
2010,Sudan,Khartoum : Wilayat - State,13,1,0,16,19,0,240397,240446,8,2,0,16,28,0,240396,240450
2010,Sudan,Kassala : Wilayat - State,0,0,0,0,5,0,0,5,0,1,0,2,3,0,0,6
2010,Sudan,Jonglei : Wilayat - State,4,0,0,2,4,0,0,10,2,0,0,4,6,1,0,13
2010,Sudan,Gadaref : Wilayat - State,0,1,0,1,3,1,0,6,0,0,0,2,2,1,0,5
2010,Sudan,Eastern Equatoria : Wilayat - State,137,0,0,197,297,8,0,639,138,0,0,185,139,10,0,472
2010,Sudan,Central Equatoria : Wilayat - State,168,0,0,320,369,9,2400,3266,169,0,0,329,210,9,2400,3117
2010,Sudan,Bir Saleeba area : Point,0,0,0,0,0,0,1500,1500,0,0,0,0,0,0,1500,1500
2010,Senegal,Richard Toll : Point,541,1024,0,721,1877,200,0,4363,640,739,0,587,1977,185,0,4128
2010,Senegal,Ourossogui : Point,932,1046,0,746,2460,255,0,5439,1025,811,0,968,2165,262,0,5231
2010,Senegal,Dakar/Thies : Point,47,71,0,52,169,4,0,343,50,81,0,49,237,16,0,433
2010,Senegal,Dakar : Point,31,40,0,52,762,17,0,902,36,67,0,62,1823,22,0,2010
2010,Singapore,Singapore,0,0,0,0,3,0,0,3,0,0,0,0,4,0,0,4
2010,Sierra Leone,Tobanda : Point,11,54,0,52,135,6,0,258,10,47,0,28,126,9,0,220
2010,Sierra Leone,Taiama : Point,10,88,0,43,148,5,0,294,14,66,0,45,131,3,0,259
2010,Sierra Leone,Largo : Point,3,45,0,34,99,5,0,186,5,43,0,28,68,6,0,150
2010,Sierra Leone,Kenema : Point,31,143,0,147,595,17,0,933,17,112,0,150,695,44,0,1018
2010,Sierra Leone,Jembe : Point,3,41,0,27,82,3,0,156,3,43,0,35,111,4,0,196
2010,Sierra Leone,Gondama : Point,12,113,0,111,262,2,0,500,24,137,0,92,260,8,0,521
2010,Sierra Leone,Gerihun : Point,10,34,0,31,75,5,0,155,6,25,0,33,101,5,0,170
2010,Sierra Leone,Freetown : Point,24,150,0,191,675,16,0,1056,30,155,0,178,791,21,0,1175
2010,Sierra Leone,Bo : Point,4,28,0,52,255,8,0,347,5,27,0,55,175,8,0,270
2010,Sierra Leone,Jimmi Bagbo : Point,14,35,0,36,108,3,0,196,4,36,0,37,153,5,0,235
2010,Sierra Leone,Bandajuma : Point,4,35,0,21,72,1,0,133,7,33,0,24,73,8,0,145
2010,El Salvador,San Salvador : Point,0,3,0,1,6,2,0,12,0,0,0,3,17,1,0,21
2010,El Salvador,La Union : Departamento ,0,0,0,0,6,0,0,6,0,0,0,0,13,1,0,14
2010,El Salvador,Cuscatlan : Departamento ,0,0,0,0,1,0,0,1,0,1,0,0,1,0,0,2
2010,Somalia,Puntland : Point,1,3,0,2,6,0,0,12,3,0,0,1,1,0,0,5
2010,Somalia,Hargeisa : Point,355,371,0,159,1066,9,11020,12980,343,410,0,164,1355,26,7346,9644
2010,Somalia,Bay,4597,4286,0,2758,7958,615,0,20214,4286,4597,0,2758,7349,616,0,19606
2010,Somalia,Banadir : District,42915,40000,0,25766,74392,5748,0,188821,40037,42944,0,25766,68644,5748,0,183139
2010,Somalia,Woqooyi Galbeed : Gobolka - Region,4075,3805,0,2448,7067,542,0,17937,3805,4075,0,2448,6524,541,0,17393
2010,Somalia,Togdheer : Gobolka - Region,2971,2774,0,1785,5152,396,0,13078,2774,2971,0,1785,4759,395,0,12684
2010,Somalia,Sool : Gobolka - Region,556,519,0,334,966,74,0,2449,520,556,0,334,890,74,0,2374
2010,Somalia,Shabelle Hoose : Gobolka - Region,57240,53430,0,34344,99231,7629,0,251874,53430,57240,0,34344,91593,7629,0,244236
2010,Somalia,Shabelle Dhexe : Gobolka - Region,5995,5596,0,3597,10393,799,0,26380,5596,5995,0,3597,9593,799,0,25580
2010,Somalia,Sanaag : Gobolka - Region,105,98,0,63,182,14,0,462,98,105,0,63,168,14,0,448
2010,Somalia,Nugaal : Gobolka - Region,742,684,0,431,1370,98,0,3325,707,733,0,444,1443,99,0,3426
2010,Somalia,Mudug : Gobolka - Region,9666,9016,0,5788,16785,1285,0,42540,9030,9657,0,5793,15530,1297,0,41307
2010,Somalia,Juba Hoose : Gobolka - Region,2973,2775,0,1784,5154,397,0,13083,2775,2973,0,1784,4758,397,0,12687
2010,Somalia,Juba Dhexe : Gobolka - Region,90,84,0,54,156,12,0,396,84,90,0,54,144,12,0,384
2010,Somalia,Hiraan : Gobolka - Region,5906,5501,0,3544,10230,790,0,25971,5507,5906,0,3544,9442,790,0,25189
2010,Somalia,Gedo : Gobolka - Region,7599,7085,0,4559,13153,1017,0,33413,7085,7599,0,4559,12147,1017,0,32407
2010,Somalia,Galgaduud : Gobolka - Region,17219,16041,0,10330,29820,2304,0,75714,16054,17219,0,10330,27526,2307,0,73436
2010,Somalia,Bari : Gobolka - Region,5888,5467,0,3501,10303,783,0,25942,5468,5849,0,3492,9952,784,0,25545
2010,Somalia,Bakool : Gobolka - Region,650,606,0,390,1127,86,0,2859,606,650,0,390,1040,87,0,2773
2010,Somalia,Awdal : Gobolka - Region,15,14,0,9,26,2,0,66,14,15,0,9,24,2,0,64
2010,Serbia and Kosovo (S/RES/1244 (1999)),Vojvodina,0,685,0,1721,12619,8725,0,23750,0,773,0,1856,14975,5147,0,22751
2010,Serbia and Kosovo (S/RES/1244 (1999)),Serbia : Dispersed in the country / territory,1000,800,0,800,1550,100,0,4250,1000,800,0,800,1550,100,0,4250
2010,Serbia and Kosovo (S/RES/1244 (1999)),Kosovo (Serbia),1202,1358,0,1357,4340,1459,0,9716,1271,1407,0,1376,5575,1462,0,11091
2010,Serbia and Kosovo (S/RES/1244 (1999)),Central and Southern Serbia,5,4850,0,7253,41911,15693,0,69712,6,5189,0,7580,42644,12385,0,67804
2010,Serbia and Kosovo (S/RES/1244 (1999)),Belgrade,32,3031,0,4903,29376,13470,0,50812,25,3211,0,5330,31015,9229,0,48810
2010,Suriname,Suriname : Dispersed in the country / territory,0,0,0,0,0,0,0,0,0,0,0,0,8,0,0,8
2010,Slovakia,Zilina - Kraj/Region,0,0,0,0,0,0,0,0,0,0,0,0,18,0,0,18
2010,Slovakia,Trnava - Kraj/Region,0,0,0,2,3,0,0,5,0,2,0,2,6,0,0,10
2010,Slovakia,Secovce : Point,4,2,0,0,2,0,0,8,0,0,0,0,38,0,0,38
2010,Slovakia,Medvedov : Point,0,0,0,0,0,0,0,0,0,0,0,0,16,0,0,16
2010,Slovakia,Kosice : Point,2,0,0,0,3,0,0,5,1,0,0,0,6,0,0,7
2010,Slovakia,Bratislava,0,2,0,1,3,0,0,6,0,2,0,0,4,0,0,6
2010,Slovakia,Trencin - Kraj/Region,0,0,0,0,0,0,0,0,0,0,0,0,3,0,0,3
2010,Slovakia,Bratislava - Stara Vajnorska,0,0,0,0,0,0,0,0,0,0,0,0,55,0,0,55
2010,Slovenia,Ljubljana : Point,0,1,0,2,0,0,0,3,0,0,0,11,6,0,0,17
2010,Slovenia,Maribor : Obcine - Municipality,0,17,0,12,52,1,0,82,0,15,0,20,294,1,0,330
2010,Slovenia,Ljubljana : Obcine - Municipality,0,0,0,0,0,0,0,0,0,0,0,0,1,0,0,1
2010,Sint Maarten (Dutch part),Philipsburg,0,0,0,0,1,0,0,1,0,1,0,1,1,0,0,3
2010,Syrian Arab Rep.,Tartus,27,57,0,74,215,21,0,394,29,81,0,71,235,0,34,450
2010,Syrian Arab Rep.,Khorasan,0,1,0,1,1,0,0,3,0,0,0,0,1,0,0,1
2010,Syrian Arab Rep.,Idlib,31,59,0,55,158,14,0,317,42,70,0,57,179,0,19,367
2010,Syrian Arab Rep.,Hims,212,378,0,322,1165,142,0,2219,215,367,0,335,1205,0,168,2290
2010,Syrian Arab Rep.,Hamah,15,36,0,38,118,15,0,222,32,41,0,41,123,0,16,253
2010,Syrian Arab Rep.,Halab,371,692,0,631,2206,261,0,4161,393,689,0,603,2525,0,289,4499
2010,Syrian Arab Rep.,Dimashq,4145,7583,0,7004,29088,4037,0,51857,4316,8237,0,7310,34799,0,4104,58766
2010,Syrian Arab Rep.,Dayr az Zawr,136,206,0,134,505,33,0,1014,153,198,0,174,471,0,43,1039
2010,Syrian Arab Rep.,Dar'a,104,206,0,152,476,46,0,984,126,199,0,189,466,0,42,1022
2010,Syrian Arab Rep.,As Suwayda,1,1,0,5,17,2,0,26,0,3,0,6,15,0,1,25
2010,Syrian Arab Rep.,Ar Raqqah,22,30,0,17,51,5,0,125,26,28,0,20,58,0,2,134
2010,Syrian Arab Rep.,Al Hol,23,29,0,37,104,9,0,202,31,25,0,21,145,0,11,233
2010,Syrian Arab Rep.,Al Haskah,462,685,0,497,1784,214,0,3642,472,762,0,492,1514,0,149,3389
2010,Syrian Arab Rep.,Syrian Arab Republic : Dispersed in the country / territory,170,279,0,280,1057,130,0,1916,163,301,0,293,1296,0,114,2167
2010,Syrian Arab Rep.,Al Qunaytirah,0,1,0,3,6,0,0,10,1,0,0,1,7,0,1,10
2010,Syrian Arab Rep.,Al Ladhiqiyah,41,108,0,83,322,51,0,605,54,124,0,112,439,0,52,781
2010,Chad,Yaroungou : Point,580,1348,0,884,2671,221,0,5704,509,1389,0,952,1846,144,0,4840
2010,Chad,Treguine : Point,1965,1697,0,1272,4267,477,0,9678,1958,1754,0,1389,2674,367,0,8142
2010,Chad,Touloum : Point,1853,3386,0,2758,5674,628,0,14299,1853,3129,0,2374,2497,348,0,10201
2010,Chad,Oure Cassoni : Point,2257,4721,0,3539,8037,744,0,19298,2305,4354,0,2846,3063,340,0,12908
2010,Chad,Ndjamena : Departement,29,29,0,13,96,2,0,169,24,41,0,14,259,12,0,350
2010,Chad,Moula : Point,449,762,0,297,1078,56,0,2642,490,784,0,354,839,58,0,2525
2010,Chad,Mile : Point,1554,2403,0,1575,4297,438,0,10267,1528,2239,0,1350,1742,256,0,7115
2010,Chad,Kounoungou : Point,1242,2529,0,1610,4189,335,0,9905,1219,2351,0,1540,1681,231,0,7022
2010,Chad,Iridimi : Point,1554,2578,0,2055,4322,438,0,10947,1551,2324,0,1965,1792,280,0,7912
2010,Chad,Haraze,426,549,0,512,1831,484,0,3802,335,487,0,370,1305,454,0,2951
2010,Chad,Goz Amer : Point,2613,2598,0,1766,5810,614,0,13401,2640,2661,0,1756,3635,515,0,11207
2010,Chad,Gondje : Point,494,1440,0,983,2138,84,0,5139,506,1413,0,1077,1388,63,0,4447
2010,Chad,Gaga : Point,1971,2668,0,1487,4563,336,0,11025,1914,2503,0,1619,2562,265,0,8863
2010,Chad,Farchana : Point,2128,2447,0,1822,5268,603,0,12268,2162,2385,0,1789,2988,391,0,9715
2010,Chad,Dosseye : Point,727,1483,0,946,2039,111,0,5306,682,1441,0,774,1104,126,0,4127
2010,Chad,Djabal : Point,1713,1794,0,1303,4231,403,0,9444,1730,1792,0,1383,2530,321,0,7756
2010,Chad,Daha : Point,1480,1225,0,474,2974,1040,0,7193,882,622,0,538,1996,587,0,4625
2010,Chad,Bredjing : Point,3578,3272,0,2613,8273,1006,0,18742,3644,3296,0,2803,5304,676,0,15723
2010,Chad,Amboko : Point,541,1562,0,1347,2342,124,0,5916,524,1466,0,1399,1684,122,0,5195
2010,Chad,Am Nabak : Point,1010,2595,0,1999,4843,500,0,10947,1103,2487,0,1522,1701,327,0,7140
2010,Togo,Tandjoare: Region,337,469,0,238,767,212,0,2023,353,526,0,202,445,115,0,1641
2010,Togo,Sotouboua : Region,786,1156,0,379,1674,168,0,4163,751,1227,0,563,1185,153,0,3879
2010,Togo,Lome : Point,22,38,0,41,168,3,0,272,29,39,0,42,276,2,0,388
2010,Togo,Dankpen : Region,185,273,0,90,395,40,0,983,169,276,0,126,267,34,0,872
2010,Thailand,Umpium,656,1025,0,821,3083,263,0,5848,706,1045,0,873,3041,229,0,5894
2010,Thailand,Tham Hin,330,379,0,331,1053,116,0,2209,301,443,0,275,939,115,0,2073
2010,Thailand,Nu Po,674,807,0,611,2302,219,0,4613,699,812,0,670,2270,198,0,4649
2010,Thailand,Mai Nai Soi,881,1146,0,739,2936,342,0,6044,947,1184,0,703,3027,347,0,6208
2010,Thailand,Mae Sot,154,312,0,276,1286,51,0,2079,159,364,0,314,1680,50,0,2567
2010,Thailand,Mae Ra Ma Luang,838,1174,0,842,2751,256,0,5861,782,1229,0,905,2649,323,0,5888
2010,Thailand,Mae La Oon,839,1054,0,788,2890,272,0,5843,838,1128,0,858,3036,288,0,6148
2010,Thailand,Mae La,1895,2684,0,2063,7298,873,0,14813,1925,2781,0,2273,6636,760,0,14375
2010,Thailand,Bangkok,176,223,0,207,1832,30,0,2468,211,285,0,227,3458,53,0,4234
2010,Thailand,Ban Mae Surin,144,159,0,146,566,45,0,1060,140,180,0,150,574,65,0,1109
2010,Thailand,Ban Don Yang,236,252,0,203,754,66,0,1511,259,252,0,216,637,67,0,1431
2010,Tajikistan,Dushanbe,5,10,0,15,22,1,0,53,2,8,0,7,25,3,0,45
2010,Turkmenistan,Ashgabat : Point,0,0,0,1,8,3,0,12,0,2,0,1,10,0,0,13
2010,Turkmenistan,Turkmenistan : Dispersed in the country / territory,0,0,0,0,0,0,10000,10000,0,0,0,0,0,0,10000,10000
2010,Turkmenistan,Turkmenbashi : Point,0,0,0,0,5,4,0,9,0,0,0,0,4,1,0,5
2010,Turkmenistan,Turkmenabat : Point,1,1,0,4,6,0,0,12,0,0,0,2,9,0,0,11
2010,Timor-Leste,Dili : Point,0,0,0,0,0,0,0,0,0,0,0,0,5,0,0,5
2010,Tonga,Tonga : Dispersed in the country / territory,1,0,0,0,1,0,0,2,0,0,0,0,1,0,0,1
2010,Trinidad and Tobago,Port of Spain : Region,0,1,0,1,13,0,0,15,2,1,0,3,110,0,0,116
2010,Tunisia,Tunis : Point,2,3,0,0,28,6,0,39,1,3,0,1,54,5,0,64
2010,Tunisia,Sousse : Wilayat - Governorate,0,0,0,0,1,0,0,1,0,0,0,0,1,0,0,1
2010,Tunisia,Sfax : Wilayat - Governorate,0,1,0,0,1,0,0,2,0,1,0,1,1,0,0,3
2010,Tunisia,Monastir : Mutamadiyat,0,0,0,0,1,0,0,1,0,0,0,0,0,0,0,0
2010,Tunisia,Bizerte : Wilayat - Governorate,0,0,0,0,1,0,0,1,0,0,0,0,0,0,0,0
2010,Turkey,Yozgat: Point Camp,0,2,0,0,2,0,0,4,0,1,0,1,1,0,0,3
2010,Turkey,Yozgat Urban : Point,7,18,0,18,81,9,0,133,13,20,0,11,78,4,0,126
2010,Turkey,Yozgat Camp : Point,0,1,0,2,1,0,0,4,0,0,0,0,2,0,0,2
2010,Turkey,Van: Point,83,142,0,132,499,9,0,865,79,172,0,156,719,16,0,1142
2010,Turkey,Urfa: Point,0,0,0,0,0,0,0,0,0,0,0,0,2,0,0,2
2010,Turkey,Tokat: Point,17,21,0,12,116,9,0,175,24,28,0,32,145,13,0,242
2010,Turkey,Sivas: Point,5,11,0,10,46,2,0,74,5,13,0,15,58,4,0,95
2010,Turkey,Sirnak: Point,0,4,0,0,10,0,0,14,1,4,0,3,33,0,0,41
2010,Turkey,Nigde: Point,11,27,0,26,154,4,0,222,13,21,0,23,230,3,0,290
2010,Turkey,Nevsehir: Point,18,23,0,23,273,12,0,349,18,24,0,30,475,8,0,555
2010,Turkey,Mugla : Province,0,0,0,0,0,0,0,0,0,0,0,0,1,1,0,2
2010,Turkey,Mersin: Point,0,0,0,0,6,0,0,6,0,0,0,0,9,0,0,9
2010,Turkey,Mardin : Province,2,0,0,2,7,0,0,11,1,2,0,0,7,0,0,10
2010,Turkey,Manisa : Province,0,0,0,0,1,0,0,1,0,0,0,0,3,0,0,3
2010,Turkey,Kutahya: Point,16,23,0,17,79,2,0,137,8,19,0,13,111,1,0,152
2010,Turkey,Konya: Point,24,37,0,26,182,2,0,271,33,31,0,27,242,2,0,335
2010,Turkey,Kirsehir: Point,21,13,0,15,98,5,0,152,15,14,0,19,161,9,0,218
2010,Turkey,Kirklareli: Point,2,4,0,2,18,1,0,27,5,0,0,5,31,1,0,42
2010,Turkey,Kirikkale: Point,4,8,0,6,30,1,0,49,7,4,0,7,30,0,0,48
2010,Turkey,Kilis : Province,0,0,0,0,0,0,0,0,0,0,0,0,2,0,0,2
2010,Turkey,Kayseri: Point,35,64,0,70,533,28,0,730,56,60,0,78,557,24,0,775
2010,Turkey,Kastamonu: Point,12,10,0,13,56,1,0,92,9,15,0,7,94,0,0,125
2010,Turkey,Karaman: Point,7,6,0,8,31,1,0,53,2,9,0,12,48,1,0,72
2010,Turkey,Izmit: Point,0,0,0,0,1,0,0,1,0,0,0,0,4,0,0,4
2010,Turkey,Izmir: Point,2,2,0,1,18,0,0,23,1,3,0,2,46,0,0,52
2010,Turkey,Istanbul: Point,66,82,0,89,462,24,0,723,89,111,0,105,983,28,0,1316
2010,Turkey,Isparta: Point,21,37,0,27,165,1,0,251,28,38,0,28,188,0,0,282
2010,Turkey,Hatay: Point,5,3,0,6,35,1,0,50,5,4,0,4,58,0,0,71
2010,Turkey,Hakkari: Point,0,0,0,1,8,0,0,9,0,0,0,3,6,0,0,9
2010,Turkey,Gaziantep : Province,55,75,0,52,242,9,0,433,58,91,0,76,482,6,0,713
2010,Turkey,Eskisehir: Point,36,42,0,31,272,12,0,393,43,67,0,39,379,16,0,544
2010,Turkey,Erzurum : Province,1,3,0,7,10,1,0,22,1,4,0,7,27,0,0,39
2010,Turkey,Edirne: Point,3,0,0,0,1,0,0,4,0,1,0,0,8,0,0,9
2010,Turkey,Edirne : Point,0,0,0,0,1,0,0,1,0,0,0,0,1,0,0,1
2010,Turkey,Diyarbakir,0,0,0,0,0,0,0,0,0,0,0,0,1,0,0,1
2010,Turkey,Corum: Point,40,45,0,38,191,7,0,321,47,55,0,40,251,5,0,398
2010,Turkey,Cankiri: Point,8,16,0,6,40,0,0,70,3,17,0,9,83,2,0,114
2010,Turkey,Bursa: Point,0,0,0,0,1,0,0,1,0,0,0,0,2,0,0,2
2010,Turkey,Burdur: Point,9,9,0,9,75,0,0,102,10,22,0,13,111,1,0,157
2010,Turkey,Burdur : Point,0,3,0,6,11,0,0,20,2,4,0,7,14,2,0,29
2010,Turkey,Bitlis : Province,0,0,0,0,1,0,0,1,0,0,0,0,3,0,0,3
2010,Turkey,Bilecik: Point,11,16,0,28,118,7,0,180,19,20,0,26,156,9,0,230
2010,Turkey,Antalya : Point,0,0,0,0,0,0,0,0,0,0,0,0,1,0,0,1
2010,Turkey,Ankara: Point,23,25,0,28,189,8,0,273,30,39,0,32,338,9,0,448
2010,Turkey,Ankara : Point,0,0,0,1,10,0,0,11,0,0,0,5,13,0,0,18
2010,Turkey,Amasya:Point,16,15,0,13,74,7,0,125,10,19,0,18,105,2,0,154
2010,Turkey,Amasya : Point,0,0,0,0,0,0,0,0,0,0,0,1,0,0,0,1
2010,Turkey,Aksaray: Point,15,24,0,26,90,6,0,161,18,22,0,33,125,2,0,200
2010,Turkey,Aksaray : Point,3,3,0,5,8,0,0,19,0,5,0,6,10,0,0,21
2010,Turkey,Agri: Point,12,21,0,15,66,0,0,114,15,18,0,27,150,3,0,213
2010,Turkey,Agri : Point,5,3,0,2,16,0,0,26,3,4,0,5,29,1,0,42
2010,Turkey,Afyon: Point,22,25,0,21,146,8,0,222,19,18,0,27,180,14,0,258
2010,Turkey,Afyon : Point,5,5,0,12,23,0,0,45,5,10,0,8,23,2,0,48
2010,Turkey,Adana: Point,2,5,0,6,17,0,0,30,2,10,0,3,26,0,0,41
2010,Turkey,Turkey : Dispersed in the country / territory,1,0,0,0,3,0,0,4,1,0,0,4,28,0,0,33
2010,United Rep. of Tanzania,Ulyankulu : Point,2942,6727,0,3987,10381,859,0,24896,2878,6408,0,4318,9445,606,0,23655
2010,United Rep. of Tanzania,Nyarugusu : Point,6505,7764,0,4640,13279,685,0,32873,6523,7602,0,4722,10369,637,0,29853
2010,United Rep. of Tanzania,National Milling Co-operation Transit Centre,4,7,0,2,4,0,0,17,0,4,0,3,8,0,0,15
2010,United Rep. of Tanzania,Mtabila 1 : Point,3839,4406,0,2274,7372,233,0,18124,3973,4531,0,2438,7425,298,0,18665
2010,United Rep. of Tanzania,Mishamo,3532,6591,0,5037,11741,1100,0,28001,3486,6520,0,4203,11370,1172,0,26751
2010,United Rep. of Tanzania,Katumba,3926,8256,0,6917,14745,1262,0,35106,3959,8055,0,6266,13784,1265,0,33329
2010,United Rep. of Tanzania,Dar es Salaam,2,2,0,3,2,0,0,9,0,3,0,1,3,0,0,7
2010,United Rep. of Tanzania,Chogo : Point,211,172,0,148,286,31,0,848,163,159,0,120,172,26,0,640
2010,Uganda,Rhino Camp : Point,87,186,0,156,318,25,0,772,78,170,0,184,238,17,0,687
2010,Uganda,Palorinya : Point,145,216,0,191,468,33,0,1053,158,248,0,162,375,15,0,958
2010,Uganda,Oruchinga : Point,163,171,0,102,273,18,0,727,124,173,0,105,288,26,0,716
2010,Uganda,Nakivale : Point,5935,6460,0,3403,12369,536,0,28703,5986,6391,0,3590,13364,521,0,29852
2010,Uganda,Kyangwali : Point,2370,2607,0,1488,4650,271,0,11386,2409,2609,0,1525,4526,213,0,11282
2010,Uganda,Kiryandongo : Point,293,494,0,352,1027,94,0,2260,292,480,0,396,895,76,0,2139
2010,Uganda,Kayaka II : Point,1850,2234,0,1297,3850,313,0,9544,1743,2186,0,1397,3530,320,0,9176
2010,Uganda,Kampala : District,1452,2830,0,2846,9599,303,0,17030,1507,2845,0,2820,13350,268,0,20790
2010,Uganda,Imvepi : Point,124,215,0,174,376,29,0,918,146,243,0,232,395,6,0,1022
2010,Uganda,Adjumani : District,555,907,0,625,1805,107,0,3999,545,937,0,657,1396,56,0,3591
2010,Uganda,Uganda : Dispersed in the country / territory,0,0,0,0,0,0,29,29,0,0,0,0,0,0,30,30
2010,Ukraine,Ukraine : Dispersed in the country / territory,18,39,0,73,414,30,804,1378,30,66,0,172,1977,25,1716,3986
2010,Uruguay,Montevideo : Point,5,3,0,7,47,9,0,71,10,7,0,9,123,9,0,158
2010,Uzbekistan,Termez : Point,0,1,0,2,9,0,0,12,1,2,0,1,15,2,0,21
2010,Uzbekistan,Tashkent : Point,10,8,0,23,76,9,0,126,10,12,0,24,102,4,0,152
2010,Venezuela (Bolivarian Republic of),Zulia : Point,321,320,0,439,951,60,26686,28777,398,477,0,360,1029,95,29961,32320
2010,Venezuela (Bolivarian Republic of),Venezuela : Dispersed in the country / territory,33,88,0,122,449,16,39740,40448,48,97,0,114,552,26,43142,43979
2010,Venezuela (Bolivarian Republic of),Tachira : Point,481,549,0,541,1006,92,20116,22785,462,597,0,542,1401,85,21561,24648
2010,Venezuela (Bolivarian Republic of),Caracas : Point,42,62,0,73,463,14,0,654,59,77,0,92,705,46,0,979
2010,Venezuela (Bolivarian Republic of),Apure : Point,269,394,0,347,787,68,7359,9224,332,400,0,341,854,100,7915,9942
2010,Venezuela (Bolivarian Republic of),Amazonas : Estado - State,1,5,0,5,53,1,1704,1769,0,6,0,9,50,0,1816,1881
2010,British Virgin Islands,Tortola : ADMIN_1,0,0,0,0,0,0,0,0,0,0,0,0,2,0,0,2
2010,Viet Nam,Binh Phuoc : Region,0,0,0,0,0,0,59,59,0,0,0,0,0,0,60,60
2010,Viet Nam,Binh Duong : Region,0,0,0,0,0,0,930,930,0,0,0,0,0,0,855,855
2010,Viet Nam,Viet Nam : Dispersed in the country / territory,0,0,0,0,0,0,3000,3000,0,0,0,0,0,0,0,0
2010,Viet Nam,Thu Duc : Municipality - Thanh Pho,0,0,0,0,0,0,5,5,0,0,0,0,0,0,5,5
2010,Viet Nam,Ho Chi Minh City : Region,0,0,0,0,0,0,3700,3700,0,0,0,0,0,0,3500,3500
2010,Viet Nam,Cu Chi : Municipality - Thanh Pho,0,0,0,0,0,0,7,7,0,0,0,0,0,0,7,7
2010,Vanuatu,Port Vila : Point,0,0,0,0,0,0,0,0,0,0,0,0,3,1,0,4
2010,Yemen,Taiz : Point,79,164,0,146,601,43,0,1033,95,142,0,123,335,25,0,720
2010,Yemen,Shabwa : Point,15,28,0,29,151,6,0,229,12,22,0,22,171,2,0,229
2010,Yemen,Sana'a : Point,2851,4212,0,4008,13813,709,0,25593,3052,4184,0,3713,13930,566,0,25445
2010,Yemen,Rada' : District,29,18,0,17,56,5,0,125,25,33,0,32,62,5,0,157
2010,Yemen,Mukalla : Point,450,408,0,251,1225,56,0,2390,418,396,0,207,2269,77,0,3367
2010,Yemen,Mahra : Point,32,62,0,61,157,7,0,319,32,70,0,70,182,7,0,361
2010,Yemen,Hodeidah : Point,20,40,0,41,109,24,0,234,19,55,0,55,104,19,0,252
2010,Yemen,Dhamar : Point,18,19,0,18,78,2,0,135,17,16,0,16,47,4,0,100
2010,Yemen,Al-Baida : Point,8,34,0,33,86,7,0,168,14,23,0,23,92,2,0,154
2010,Yemen,Al Kharaz : Point,1256,1735,0,1243,3324,91,0,7649,1421,1764,0,1116,2761,104,0,7166
2010,Yemen,Aden : Point,747,1195,0,2033,5152,154,0,9281,800,1171,0,3106,9113,125,0,14315
2010,Yemen,Yemen : Dispersed in the country / territory,793,946,0,2804,25401,87,0,30031,618,1634,0,6290,67397,60,0,75999
2010,Yemen,"S,adah : Muhafazah - Governorate",13151,20358,0,13278,35545,3011,0,85343,13003,21244,0,14119,34913,2856,0,86135
2010,Yemen,Hajjah : Muhafazah - Governorate,4741,12074,0,6639,15479,890,0,39823,4573,14103,0,8587,13772,1123,0,42158
2010,Yemen,Amran : Muhafazah - Governorate,2029,5436,0,3104,8063,461,0,19093,2160,5752,0,3335,6540,507,0,18294
2010,Yemen,Al Jawf : Muhafazah - Governorate,639,1911,0,982,2446,64,0,6042,521,1858,0,1319,2235,82,0,6015
2010,Zambia,Meheba : Point,1842,1979,0,1215,3357,324,0,8717,1730,1961,0,1123,3884,381,0,9079
2010,Zambia,Mayukwayukwa : Point,974,1093,0,822,1917,159,0,4965,991,1048,0,751,1841,287,0,4918
2010,Zambia,Lusaka Urban : Point,308,509,0,485,1276,39,0,2617,315,494,0,547,1972,62,0,3390
2010,Zambia,Zambia : Dispersed in the country / territory,517,1509,0,933,2635,263,0,5857,490,1479,0,914,3260,425,0,6568
2010,Zimbabwe,Tongogara : Point,296,412,0,245,730,11,0,1694,316,469,0,297,1007,14,0,2103
2010,Zimbabwe,Harare : District,76,103,0,66,231,5,0,481,81,100,0,71,315,6,0,573
2010,Zimbabwe,Zimbabwe : Dispersed in the country / territory,0,0,0,1,1,0,0,2,0,0,0,1,105,0,0,106
2011,Aruba,Oranjestad,0,0,0,0,2,0,0,2,0,0,0,0,2,0,0,2
2011,Afghanistan,Panjsher : Wolaswalei - District,14,47,0,40,110,4,0,215,17,49,0,43,128,9,0,246
2011,Afghanistan,Badakhshan : Wilayat - Province,29,120,0,62,178,10,0,399,30,117,0,116,844,22,0,1129
2011,Afghanistan,Zabul : Wilayat - Province,793,1513,0,964,2945,130,0,6345,839,1543,0,1002,2800,248,0,6432
2011,Afghanistan,Wardak : Wilayat - Province,1115,1989,0,1589,4832,195,0,9720,1156,2056,0,1572,4549,384,0,9717
2011,Afghanistan,Uruzgan : Wilayat - Province,2826,4076,0,3191,10014,431,0,20538,2990,4016,0,3051,9422,734,0,20213
2011,Afghanistan,Takhar : Wilayat - Province,735,1722,0,946,2689,139,0,6231,747,1794,0,1017,3113,247,0,6918
2011,Afghanistan,Sari Pul : Wilayat - Province,946,1769,0,1280,3471,275,0,7741,923,1720,0,1128,3308,259,0,7338
2011,Afghanistan,Samangan : Wilayat - Province,235,581,0,341,944,77,0,2178,249,596,0,324,918,61,0,2148
2011,Afghanistan,Parwan : Wilayat - Province,707,1798,0,1168,3254,127,0,7054,740,1913,0,1239,3448,243,0,7583
2011,Afghanistan,Panjsher : Wilayat - Province,29,42,0,34,90,4,0,199,27,42,0,33,88,5,0,195
2011,Afghanistan,Paktya : Wilayat - Province,1336,4334,0,2735,7315,384,0,16104,1471,4373,0,2991,5984,741,0,15560
2011,Afghanistan,Paktika : Wilayat - Province,309,774,0,471,1383,60,0,2997,328,807,0,486,1340,101,0,3062
2011,Afghanistan,Nuristan : Wilayat - Province,258,415,0,309,959,41,0,1982,271,394,0,301,907,70,0,1943
2011,Afghanistan,Nimroz : Wilayat - Province,20,62,0,46,112,10,0,250,40,82,0,47,138,16,0,323
2011,Afghanistan,Nangarhar : Wilayat - Province,20800,67372,0,37813,94214,4552,0,224751,21210,69187,0,40706,91834,6993,0,229930
2011,Afghanistan,Logar : Wilayat - Province,1326,5183,0,3241,8089,405,0,18244,1406,5448,0,3398,7096,679,0,18027
2011,Afghanistan,Laghman : Wilayat - Province,3276,9098,0,5347,13235,576,0,31532,3184,9335,0,5965,13085,1022,0,32591
2011,Afghanistan,Kunduz : Wilayat - Province,3485,10425,0,5538,14553,729,0,34730,3700,10773,0,5896,14156,1151,0,35676
2011,Afghanistan,Kunar : Wilayat - Province,4018,9097,0,5757,14778,648,0,34298,4101,9567,0,6152,14566,1174,0,35560
2011,Afghanistan,Khost : Wilayat - Province,1256,2541,0,1833,5387,274,0,11291,1354,2685,0,1963,5014,453,0,11469
2011,Afghanistan,Kapisa : Wilayat - Province,419,762,0,567,1607,63,0,3418,436,768,0,567,1605,123,0,3499
2011,Afghanistan,Kandahar : Wilayat - Province,6731,12808,0,7883,23886,1161,0,52469,7053,12979,0,8290,22903,1837,0,53062
2011,Afghanistan,Kabul : Wilayat - Province,6454,18533,0,12704,37243,1954,0,76888,6768,19440,0,13781,34916,3133,0,78038
2011,Afghanistan,Jawzjan : Wilayat - Province,1670,3723,0,2484,8280,790,0,16947,1728,3643,0,2405,8114,639,0,16529
2011,Afghanistan,Hirat : Wilayat - Province,6132,8880,0,7268,23232,1014,0,46526,6615,8878,0,6865,23219,1746,0,47323
2011,Afghanistan,Hilmand : Wilayat - Province,5929,9192,0,6795,20766,929,0,43611,6282,9231,0,6726,19661,1600,0,43500
2011,Afghanistan,Ghor : Wilayat - Province,860,1222,0,996,3108,130,0,6316,919,1214,0,943,3013,229,0,6318
2011,Afghanistan,Ghazni : Wilayat - Province,1684,5555,0,2586,8283,486,0,18594,1714,5789,0,2774,8147,791,0,19215
2011,Afghanistan,Faryab : Wilayat - Province,2967,4688,0,3462,11266,647,0,23030,3068,4564,0,3345,10471,801,0,22249
2011,Afghanistan,Farah : Wilayat - Province,1463,2114,0,1670,5036,227,0,10510,1547,2145,0,1595,4742,373,0,10402
2011,Afghanistan,Day Kundi : Wolaswalei - District,121,475,0,271,793,42,0,1702,121,474,0,320,801,62,0,1778
2011,Afghanistan,Day Kundi : Wilayat - Province,20,27,0,18,70,2,0,137,19,24,0,15,63,9,0,130
2011,Afghanistan,Bamyan : Wilayat - Province,86,182,0,136,489,41,0,934,60,194,0,162,560,63,0,1039
2011,Afghanistan,Balkh : Wilayat - Province,995,2293,0,1413,4334,302,0,9337,1030,2344,0,1493,4365,455,0,9687
2011,Afghanistan,Baghlan : Wilayat - Province,1069,3445,0,1944,5480,307,0,12245,1158,3524,0,2166,5448,530,0,12826
2011,Afghanistan,Badghis : Wilayat - Province,565,831,0,651,1993,83,0,4123,585,820,0,628,1961,151,0,4145
2011,Afghanistan,Afghanistan : Dispersed in the country / territory,129,917,0,470,1333,77,0,2926,129,917,0,470,1286,77,0,2879
2011,Albania,Tirana Urban : Point,1,1,0,3,11,3,0,19,1,5,0,1,16,1,0,24
2011,Albania,Tirana Camp : Point,4,1,0,2,14,1,0,22,5,2,0,4,23,2,0,36
2011,Albania,Peshkopi : Point,0,0,0,0,0,1,0,1,0,0,0,0,0,0,0,0
2011,Albania,Mamurras : Rreth - District,1,0,0,0,1,0,0,2,0,2,0,0,0,0,0,2
2011,United Arab Emirates,Abu Dhabi : Emirate - Region,39,82,0,193,42,0,0,356,45,81,0,183,54,3,0,366
2011,Argentina,Argentina : Dispersed in the country / territory,23,50,0,58,656,48,0,835,22,41,0,114,1377,34,0,1588
2011,Armenia,Yerevan : Point,19,40,0,57,499,186,0,801,31,41,0,57,559,111,0,799
2011,Armenia,Vayots Dzor : Marz - Province,0,0,0,0,4,0,0,4,0,0,0,0,1,0,0,1
2011,Armenia,Tavush : Marz - Province,0,0,0,0,18,26,0,44,0,0,0,0,15,12,0,27
2011,Armenia,Syunik : Marz - Province,0,0,0,0,64,19,0,83,0,0,0,0,63,7,0,70
2011,Armenia,Shirak : Marz - Province,0,0,0,0,21,4,0,25,0,0,0,0,19,4,0,23
2011,Armenia,Lori : Marz - Province,0,0,0,0,45,14,0,59,0,0,0,0,48,10,0,58
2011,Armenia,Kotayk : Marz - Province,0,0,0,0,112,72,0,184,0,0,0,0,132,41,0,173
2011,Armenia,Gergharkunik : Marz - Province,0,0,0,0,38,17,0,55,0,0,0,0,47,14,0,61
2011,Armenia,Armavir : Marz - Province,0,0,0,0,53,38,0,91,0,0,0,0,53,17,0,70
2011,Armenia,Ararat : Marz - Province,0,0,0,0,55,39,0,94,0,0,0,0,89,40,0,129
2011,Armenia,Aragatsotn : Marz - Province,0,0,0,0,40,20,0,60,0,0,0,0,33,10,0,43
2011,Azerbaijan,Baku : Point,93,148,0,91,429,30,0,791,97,151,0,108,624,22,0,1002
2011,Azerbaijan,Azerbaijan : Dispersed in the country / territory,27506,36489,0,37374,169758,34132,0,305259,27907,34080,0,36567,161198,34181,0,293933
2011,Burundi,Bujumbura : Point,1272,2538,0,2168,5970,304,0,12252,1266,2614,0,2111,5025,217,0,11233
2011,Burundi,Butare : Province,33,25,0,12,60,2,0,132,23,23,0,15,55,4,0,120
2011,Burundi,Bwagiriza : Point,637,664,0,469,1280,70,0,3120,668,717,0,446,1158,50,0,3039
2011,Burundi,Gasorwe : Commune,847,1370,0,726,2057,94,0,5094,876,1305,0,768,1644,56,0,4649
2011,Burundi,Musasa : Point,588,850,0,455,1268,56,0,3217,559,887,0,497,1145,25,0,3113
2011,Burundi,Burundi : Dispersed in the country / territory,588,719,0,317,1246,60,41713,44643,588,692,0,296,868,54,37083,39581
2011,Belgium,Belgium : Dispersed in the country / territory,0,0,0,0,0,0,9472,9472,0,0,0,0,0,0,12874,12874
2011,Benin,Agame : Point,238,227,0,166,639,20,0,1290,254,276,0,162,836,10,0,1538
2011,Benin,Cotonou : Departement,253,251,0,222,1044,27,0,1797,238,281,0,194,2015,22,0,2750
2011,Benin,Kpomasse : Point,11,4,0,5,61,2,0,83,12,10,0,15,79,1,0,117
2011,Burkina Faso,Ouagadougou : Point,56,74,0,64,268,4,0,466,28,59,0,60,592,6,0,745
2011,Bangladesh,Bandarban,4,6,0,3,20,1,0,34,2,7,0,6,25,3,0,43
2011,Bangladesh,Barguna,0,0,0,0,0,0,0,0,0,0,0,0,1,0,0,1
2011,Bangladesh,Chittagong,0,0,0,0,4,0,0,4,0,0,0,0,5,0,0,5
2011,Bangladesh,Cox's Bazar,2,2,0,3,15,0,0,22,2,3,0,3,41,3,0,52
2011,Bangladesh,Dhaka : Point,3,5,0,1,12,0,0,21,3,0,0,1,26,1,0,31
2011,Bangladesh,Gazipur,0,0,0,0,0,0,0,0,0,0,0,0,7,0,0,7
2011,Bangladesh,Kutupalong : Point,925,1349,0,1056,2513,121,0,5964,950,1395,0,1061,2223,113,0,5742
2011,Bangladesh,Narshingdi,0,2,0,0,1,0,0,3,0,0,0,0,2,0,0,2
2011,Bangladesh,Nayapara : Point,1255,2130,0,1675,3950,178,0,9188,1223,2253,0,1606,3267,192,0,8541
2011,Bangladesh,Rangamati,0,1,0,2,1,0,0,4,0,1,0,0,5,1,0,7
2011,Bulgaria,Sofia : Point,0,0,0,0,108,0,0,108,0,23,0,118,641,0,0,782
2011,Bahrain,Bahrain : Dispersed in the country / territory,26,16,0,20,110,7,0,179,15,18,0,11,125,11,0,180
2011,Bahamas,Bahamas : Dispersed in the country / territory,1,0,0,2,10,0,0,13,0,5,0,1,22,1,0,29
2011,Bosnia and Herzegovina,Republika Srpska : Entity,670,2340,0,2233,19660,7575,1066,33544,655,2337,0,2367,20623,5838,1110,32930
2011,Bosnia and Herzegovina,Federacija Bosne I Hercegovine : Entity,8,9,0,16,52,3,1535,1623,5,21,0,11,47,5,1599,1688
2011,Bosnia and Herzegovina,Brcko : Županija - County,4,9,0,10,89,36,0,148,4,10,0,12,82,23,0,131
2011,Bosnia and Herzegovina,Bosnia and Herzegovina : Dispersed in the country / territory,2,135,0,264,2390,587,25724,29102,3,164,0,212,2384,627,26805,30195
2011,Belarus,Minsk : Point,10,30,0,29,77,11,0,157,12,24,0,22,161,4,0,223
2011,Belarus,Vitebsk : Oblast - Region,0,2,0,1,8,2,0,13,1,3,0,3,21,1,0,29
2011,Belarus,Mogilev : Oblast - Region,0,1,0,3,12,0,0,16,0,0,0,0,21,1,0,22
2011,Belarus,Horad Minsk : Oblast - Region,1,4,0,4,30,2,0,41,4,3,0,8,29,1,0,45
2011,Belarus,Grodno : Oblast - Region,0,2,0,0,5,0,0,7,0,0,0,0,7,0,0,7
2011,Belarus,Gomel : Oblast - Region,1,1,0,6,20,3,0,31,3,4,0,4,34,3,0,48
2011,Belarus,Brest : Oblast - Region,0,0,0,0,0,0,0,0,0,0,0,0,5,1,0,6
2011,Belize,Belize : Dispersed in the country / territory,3,5,0,3,40,2,0,53,4,4,0,5,53,14,0,80
2011,Bolivia (Plurinational State of),Yapacani : Point,0,2,0,2,2,0,0,6,1,0,0,1,5,0,0,7
2011,Bolivia (Plurinational State of),Tarija : Point,0,0,0,0,1,0,0,1,0,0,0,0,1,0,0,1
2011,Bolivia (Plurinational State of),Sucre : Point,0,0,0,0,0,0,0,0,0,0,0,0,1,0,0,1
2011,Bolivia (Plurinational State of),Santa Cruz : Point,1,2,0,2,15,1,0,21,0,2,0,7,27,1,0,37
2011,Bolivia (Plurinational State of),Riveralta,0,0,0,0,0,0,0,0,0,0,0,0,1,0,0,1
2011,Bolivia (Plurinational State of),Palos Blanco : Point,0,1,0,0,2,0,0,3,0,0,0,0,3,0,0,3
2011,Bolivia (Plurinational State of),La Paz : Point,0,7,0,26,114,4,0,151,3,13,0,27,158,7,0,208
2011,Bolivia (Plurinational State of),Cochabamba : Point,2,4,0,4,14,0,0,24,0,3,0,10,26,0,0,39
2011,Bolivia (Plurinational State of),Bolivia : Dispersed in the country / territory,0,0,0,5,85,3,0,93,0,0,0,1,129,2,0,132
2011,Bolivia (Plurinational State of),Beni : Point,0,0,0,3,0,0,0,3,0,1,0,1,1,0,0,3
2011,Brazil,Acre : Estado - State,3,6,0,11,74,0,0,94,2,10,0,5,288,0,0,305
2011,Brazil,Bahia : Estado - State,0,1,0,0,1,0,0,2,0,0,0,0,4,0,0,4
2011,Brazil,Ceará : Estado - State,0,0,0,0,1,0,0,1,0,2,0,0,5,0,0,7
2011,Brazil,Distrito Federal : Estado - State,1,1,0,0,13,3,0,18,1,0,0,2,111,3,0,117
2011,Brazil,Mato Grosso : Estado - State,0,0,0,0,1,0,0,1,0,0,0,0,4,0,0,4
2011,Brazil,Mato Grosso do Sul : Estado - State,0,0,0,0,4,0,0,4,0,0,0,0,20,0,0,20
2011,Brazil,Minas Gerais : Estado - State,0,0,0,0,2,0,0,2,0,0,0,0,11,0,0,11
2011,Brazil,Pará : Estado - State,0,0,0,0,0,0,0,0,0,0,0,0,3,0,0,3
2011,Brazil,Paraná : Estado - State,0,2,0,1,7,0,0,10,0,2,0,0,24,0,0,26
2011,Brazil,Pernambuco : Estado - State,0,0,0,0,0,0,0,0,0,0,0,0,2,0,0,2
2011,Brazil,Rio De Janeiro : Estado - State,5,21,0,22,529,13,0,590,8,17,0,24,1443,24,0,1516
2011,Brazil,Rio Grande Do Norte : Estado - State,2,2,0,0,4,0,0,8,0,0,0,0,10,0,0,10
2011,Brazil,Rio Grande Do Sul : Estado - State,0,11,0,13,56,1,0,81,0,16,0,11,82,1,0,110
2011,Brazil,Roraima : Estado - State,0,0,0,0,1,0,0,1,0,0,0,0,6,0,0,6
2011,Brazil,Santa Catarina : Estado - State,0,1,0,0,3,0,0,4,0,0,0,0,11,0,0,11
2011,Brazil,Sao Paulo : Estado - State,7,29,0,32,411,22,0,501,6,24,0,37,1403,27,0,1497
2011,Brazil,Tocantins  - State,0,0,0,0,2,0,0,2,0,0,0,0,1,0,0,1
2011,Brazil,Brazil : Dispersed in the country / territory,5,18,0,32,77,2,0,134,4,21,0,70,3400,12,0,3507
2011,Brazil,Amazonas : Estado - State,1,5,0,8,157,1,1704,1876,0,8,0,10,475,2,1816,2311
2011,Botswana,Dukwi : Point,205,274,0,209,588,36,0,1312,207,291,0,171,1534,43,0,2246
2011,Central African Rep.,Momou : Point,350,800,0,740,2200,89,0,4179,400,1000,0,900,2000,163,0,4463
2011,Central African Rep.,Nana-Griizi : Point,555,858,0,1311,2693,56,0,5473,673,925,0,1411,3647,63,0,6719
2011,Central African Rep.,Ouham : Prefecture,1449,2336,0,3147,7400,312,0,14644,1215,2060,0,3310,7743,193,0,14521
2011,Central African Rep.,Ouham-pende : Prefecture,4789,5770,0,7587,13811,489,0,32446,4294,6201,0,6748,12856,478,0,30577
2011,Central African Rep.,Vakaga : Prefecture,685,807,0,557,1358,78,0,3485,712,798,0,565,1400,59,0,3534
2011,Central African Rep.,Zemio : Sous-prefecture,267,343,0,145,819,91,0,1665,280,318,0,169,759,96,0,1622
2011,Central African Rep.,Obo : Sous-prefecture,69,87,0,40,227,26,0,449,101,92,0,34,175,19,0,421
2011,Central African Rep.,Nana Mambere : Prefecture,972,1781,0,2347,5059,117,0,10276,810,1592,0,2632,5848,149,0,11031
2011,Central African Rep.,Mongoumba : Sous-prefecture,791,859,0,532,1179,312,0,3673,798,850,0,442,1040,175,0,3305
2011,Central African Rep.,Mboki : Point,114,110,0,59,318,14,0,615,116,117,0,67,270,19,0,589
2011,Central African Rep.,Hautte-kotto : Prefecture,327,700,0,840,2123,95,0,4085,300,800,0,1000,1800,121,0,4021
2011,Central African Rep.,Haut-mboumou : Prefecture,781,1050,0,1225,3800,187,0,7043,700,940,0,1151,3945,102,0,6838
2011,Central African Rep.,Bangui : Sous-prefecture,293,416,0,490,1007,41,0,2247,318,483,0,494,1351,42,0,2688
2011,Central African Rep.,Bamingui-bangora : Prefecture,800,1350,0,1600,3500,197,0,7447,615,1000,0,1250,3827,243,0,6935
2011,Central African Rep.,Bambari : Point,550,396,0,366,995,83,0,2390,563,354,0,398,1053,147,0,2515
2011,Canada,Canada : Dispersed in the country / territory,2599,4344,0,3543,26419,2069,0,38974,2615,4459,0,3686,31700,1253,0,43713
2011,Switzerland,Switzerland : Dispersed in the country / territory,1694,2060,0,1565,9391,627,11642,26979,1699,2304,0,1986,18528,371,15464,40352
2011,China,Beihai : Point,0,0,0,0,0,0,0,0,0,0,0,0,0,1,0,1
2011,China,Beijing : Point,1,1,0,1,5,1,0,9,2,2,0,0,13,1,0,18
2011,China,Fujian,0,0,0,0,0,0,13211,13211,0,0,0,0,0,0,14198,14198
2011,China,Guangdong,0,0,0,0,0,0,39884,39884,0,0,0,0,0,0,43654,43654
2011,China,Guangxi,0,0,0,0,0,0,53303,53303,0,0,0,0,0,0,58965,58965
2011,China,Guangzhou : Point,3,0,0,1,5,1,0,10,0,1,0,0,7,1,0,9
2011,China,Hai Nan,0,0,0,0,0,0,14867,14867,0,0,0,0,1,0,16608,16609
2011,China,Jianxi,0,0,0,0,0,0,824,824,0,0,0,0,0,0,891,891
2011,China,Langfang : Point,2,4,0,5,14,3,0,28,1,8,0,6,15,2,0,32
2011,China,Nanjing : Point,0,1,0,0,2,0,0,3,1,0,0,0,5,0,0,6
2011,China,Shanghai : Point,0,0,0,0,0,0,0,0,0,0,0,0,1,0,0,1
2011,China,Tian Jin,0,0,0,0,0,0,0,0,0,0,0,0,1,0,0,1
2011,China,Wuhan : Point,1,3,0,1,12,0,0,17,0,1,0,1,11,0,0,13
2011,China,Yiwu : Point,0,0,0,0,2,0,0,2,0,0,0,0,2,0,0,2
2011,China,Yunnan,0,0,0,0,0,0,21821,21821,0,0,0,0,0,0,22669,22669
2011,Côte d'Ivoire,Abidjan : Departement,166,249,0,251,1215,50,0,1931,164,341,0,244,1812,54,0,2615
2011,Côte d'Ivoire,Guiglo : Departement,350,800,0,526,2091,148,0,3915,328,894,0,479,1464,115,0,3280
2011,Côte d'Ivoire,Tabou : Departement,510,1580,0,883,3986,153,0,7112,459,1627,0,793,3005,151,0,6035
2011,Côte d'Ivoire,Cote d'Ivoire : Dispersed in the country / territory,23667,24021,0,20304,56221,4745,0,128958,23908,24131,0,20987,59701,5087,0,133814
2011,Cameroon,Adinkol,30,38,0,24,71,3,0,166,29,44,0,25,45,6,0,149
2011,Cameroon,Babongo,2,2,0,4,7,0,0,15,0,4,0,3,5,2,0,14
2011,Cameroon,Bafouck,50,94,0,49,131,6,0,330,52,66,0,51,135,12,0,316
2011,Cameroon,Bagodo,107,249,0,135,326,11,0,828,139,261,0,150,193,34,0,777
2011,Cameroon,Bamenda,0,0,0,0,0,0,0,0,0,0,0,0,1,0,0,1
2011,Cameroon,Batoua Godole,211,387,0,208,583,35,0,1424,200,401,0,210,354,49,0,1214
2011,Cameroon,Bazzama,57,117,0,63,180,7,0,424,65,109,0,64,110,13,0,361
2011,Cameroon,Bedobo,33,87,0,64,155,4,0,343,43,71,0,41,115,5,0,275
2011,Cameroon,Belel,0,0,0,1,1,0,0,2,0,2,0,0,8,0,0,10
2011,Cameroon,Betare Oya,0,0,0,0,1,0,0,1,0,0,0,0,9,0,0,9
2011,Cameroon,Borgop,42,88,0,42,99,12,0,283,47,71,0,41,68,4,0,231
2011,Cameroon,Boubara,40,93,0,75,190,10,0,408,55,85,0,62,161,20,0,383
2011,Cameroon,Boulembe,73,134,0,85,164,13,0,469,60,122,0,63,118,11,0,374
2011,Cameroon,Bouli,72,83,0,67,164,5,0,391,41,73,0,63,106,7,0,290
2011,Cameroon,Dakere Babongo,47,84,0,53,120,6,0,310,51,99,0,50,72,9,0,281
2011,Cameroon,Dang Patou,45,72,0,52,141,6,0,316,52,73,0,34,101,7,0,267
2011,Cameroon,Digou Adamou,15,16,0,12,32,1,0,76,13,20,0,9,28,5,0,75
2011,Cameroon,Dir,46,94,0,57,131,4,0,332,49,95,0,52,91,11,0,298
2011,Cameroon,Djalingo,47,76,0,36,126,9,0,294,43,94,0,53,77,7,0,274
2011,Cameroon,Djohong,57,69,0,48,111,6,0,291,49,63,0,34,94,8,0,248
2011,Cameroon,Douala : Point,1,1,0,0,1,0,0,3,1,1,0,1,5,1,0,9
2011,Cameroon,Fada,43,63,0,42,102,6,0,256,54,64,0,36,70,9,0,233
2011,Cameroon,Gado Badzere,55,99,0,76,150,13,0,393,57,105,0,74,101,16,0,353
2011,Cameroon,Gandinang,0,0,0,0,1,0,0,1,0,0,0,0,1,0,0,1
2011,Cameroon,Garga Libona,136,195,0,116,323,16,0,786,138,221,0,113,205,20,0,697
2011,Cameroon,Garga Sarali,63,105,0,64,205,15,0,452,92,136,0,76,185,12,0,501
2011,Cameroon,Gargapela,68,135,0,74,183,10,0,470,66,138,0,66,106,13,0,389
2011,Cameroon,Garoua-Boulai,445,918,0,620,1494,73,0,3550,449,974,0,615,964,94,0,3096
2011,Cameroon,Gbakim,34,65,0,35,112,4,0,250,36,50,0,48,101,10,0,245
2011,Cameroon,Gbiti,382,801,0,524,1526,53,0,3286,410,806,0,515,1221,129,0,3081
2011,Cameroon,Goro,61,124,0,56,143,9,0,393,65,109,0,56,112,12,0,354
2011,Cameroon,Goundjel,0,6,0,3,10,0,0,19,0,3,0,1,13,0,0,17
2011,Cameroon,Guiwa Yangamo,51,104,0,67,171,13,0,406,64,91,0,79,116,16,0,366
2011,Cameroon,Kenzou,188,427,0,288,724,34,0,1661,195,444,0,230,427,45,0,1341
2011,Cameroon,Kette,94,213,0,155,391,17,0,870,104,232,0,137,275,36,0,784
2011,Cameroon,Kole,27,49,0,50,76,2,0,204,24,59,0,33,39,4,0,159
2011,Cameroon,Kombo Laka,64,136,0,68,196,13,0,477,83,118,0,75,181,17,0,474
2011,Cameroon,Kouba,28,68,0,35,78,3,0,212,16,60,0,31,36,7,0,150
2011,Cameroon,Langui : Point,224,457,0,276,816,89,0,1862,245,439,0,248,899,54,0,1885
2011,Cameroon,Lokoti,81,126,0,70,197,12,0,486,59,141,0,85,157,17,0,459
2011,Cameroon,Mandjou,148,292,0,197,462,26,0,1125,139,289,0,174,269,37,0,908
2011,Cameroon,Mbarang,62,120,0,57,155,9,0,403,75,103,0,54,100,9,0,341
2011,Cameroon,Mbewe,11,17,0,16,21,2,0,67,16,11,0,8,28,0,0,63
2011,Cameroon,Mbile,63,132,0,84,215,6,0,500,61,111,0,95,148,10,0,425
2011,Cameroon,Mbondo,36,72,0,37,110,6,0,261,29,73,0,32,87,14,0,235
2011,Cameroon,Mbonga,33,73,0,52,110,7,0,275,32,73,0,50,86,12,0,253
2011,Cameroon,Mborguene,37,72,0,39,113,4,0,265,31,73,0,50,115,5,0,274
2011,Cameroon,Mboula,42,115,0,60,143,10,0,370,43,100,0,41,109,17,0,310
2011,Cameroon,Mboumama,85,143,0,106,270,8,0,612,86,154,0,88,234,18,0,580
2011,Cameroon,Meidougou,328,548,0,379,846,36,0,2137,316,629,0,349,547,66,0,1907
2011,Cameroon,Meiganga,171,362,0,232,528,23,0,1316,203,411,0,227,397,47,0,1285
2011,Cameroon,Mikila,44,74,0,56,119,3,0,296,44,80,0,52,82,11,0,269
2011,Cameroon,Mimbang,1,11,0,9,25,0,0,46,3,9,0,11,24,2,0,49
2011,Cameroon,Mobe,27,59,0,25,95,0,0,206,25,77,0,28,63,10,0,203
2011,Cameroon,Nabemo,66,107,0,61,164,6,0,404,78,124,0,65,124,12,0,403
2011,Cameroon,Nandoungue,83,167,0,92,222,13,0,577,91,166,0,85,146,18,0,506
2011,Cameroon,Ndanga Gandima,48,93,0,55,193,10,0,399,57,113,0,68,136,16,0,390
2011,Cameroon,Ndokayo,245,421,0,279,670,34,0,1649,208,416,0,294,584,68,0,1570
2011,Cameroon,Ngaoui,573,1158,0,710,1693,90,0,4224,643,1157,0,708,1030,151,0,3689
2011,Cameroon,Ngazi,22,21,0,12,35,4,0,94,13,23,0,11,26,0,0,73
2011,Cameroon,Nguindi,35,64,0,41,105,4,0,249,28,55,0,39,58,11,0,191
2011,Cameroon,Ngunbela,12,38,0,10,69,2,0,131,15,46,0,34,40,4,0,139
2011,Cameroon,Nyabi,147,343,0,250,603,26,0,1369,162,326,0,220,430,45,0,1183
2011,Cameroon,Ouro-Adde,109,189,0,126,252,14,0,690,105,202,0,124,171,12,0,614
2011,Cameroon,Samba,38,83,0,47,113,5,0,286,28,60,0,47,72,5,0,212
2011,Cameroon,Sandaye,21,26,0,21,39,2,0,109,20,25,0,18,28,1,0,92
2011,Cameroon,Tapare,11,35,0,14,40,3,0,103,16,42,0,17,29,6,0,110
2011,Cameroon,Timangolo,51,74,0,43,118,10,0,296,37,76,0,59,76,10,0,258
2011,Cameroon,Toktoyo,141,250,0,150,427,19,0,987,156,298,0,144,292,31,0,921
2011,Cameroon,Tongo Gandima,89,212,0,139,341,13,0,794,126,229,0,141,262,38,0,796
2011,Cameroon,Woumbou,34,65,0,45,123,4,0,271,23,66,0,45,103,6,0,243
2011,Cameroon,Yamba,154,311,0,143,381,26,0,1015,137,272,0,137,272,19,0,837
2011,Cameroon,Yaounde : Point,7,15,0,13,34,1,0,70,5,13,0,6,221,0,0,245
2011,Cameroon,Yarmbang,78,168,0,85,227,11,0,569,70,148,0,74,135,15,0,442
2011,Cameroon,Yokosire,56,152,0,122,271,19,0,620,53,170,0,101,176,39,0,539
2011,Cameroon,Zembe Borongo,210,374,0,255,653,30,0,1522,222,422,0,222,368,54,0,1288
2011,Cameroon,Cameroon : Dispersed in the country / territory,810,1299,0,946,3389,91,0,6535,816,1290,0,825,4754,120,0,7805
2011,Dem. Rep. of the Congo,BONDO,76,65,0,34,254,15,0,444,104,63,0,30,225,11,0,433
2011,Dem. Rep. of the Congo,DEMBA,0,0,0,0,0,2,0,2,0,0,0,0,1,0,0,1
2011,Dem. Rep. of the Congo,DILOLO,24,19,0,4,45,3,0,95,20,27,0,5,44,3,0,99
2011,Dem. Rep. of the Congo,GOMA,350,272,0,128,382,69,0,1201,361,323,0,121,228,44,0,1077
2011,Dem. Rep. of the Congo,KABARE,96,98,0,204,228,18,0,644,147,175,0,375,274,30,0,1001
2011,Dem. Rep. of the Congo,KALEHE,8,35,0,83,24,9,0,159,2,41,0,106,29,7,0,185
2011,Dem. Rep. of the Congo,MASISI,9344,8625,0,2639,13526,612,0,34746,8420,7892,0,2085,6446,354,0,25197
2011,Dem. Rep. of the Congo,MWENGA,5,2,0,0,7,0,0,14,3,7,0,19,10,2,0,41
2011,Dem. Rep. of the Congo,Zomfi : Point,3,3,0,2,5,0,0,13,2,2,0,2,4,0,0,10
2011,Dem. Rep. of the Congo,Walungu various : Point,3,12,0,4,11,1,0,31,2,9,0,2,2,0,0,15
2011,Dem. Rep. of the Congo,WALUNGU,17,21,0,19,46,2,0,105,17,23,0,29,2,7,0,78
2011,Dem. Rep. of the Congo,WALIKALE,319,236,0,42,498,17,0,1112,291,231,0,57,170,5,0,754
2011,Dem. Rep. of the Congo,Uvira Various : Point,39,56,0,17,74,7,0,193,55,47,0,20,41,0,0,163
2011,Dem. Rep. of the Congo,Uvira Rural : Point,345,362,0,356,1025,78,0,2166,411,395,0,412,1162,74,0,2454
2011,Dem. Rep. of the Congo,Tshimbumbulu : Point,28,19,0,9,23,9,0,88,17,17,0,11,22,8,0,75
2011,Dem. Rep. of the Congo,Tshifwameso : Point,4,9,0,10,22,0,0,45,6,10,0,10,13,0,0,39
2011,Dem. Rep. of the Congo,Tshabobo : Point,65,102,0,29,136,4,0,336,65,90,0,29,143,10,0,337
2011,Dem. Rep. of the Congo,Tseke-Zole : Point,34,38,0,27,85,6,0,190,42,49,0,34,126,18,0,269
2011,Dem. Rep. of the Congo,SHABUNDA,133,181,0,808,536,34,0,1692,194,364,0,1089,984,30,0,2661
2011,Dem. Rep. of the Congo,Sadi/Zulu : Point,1,2,0,3,3,0,0,9,1,2,0,1,11,0,0,15
2011,Dem. Rep. of the Congo,RUTSHURU,3011,2422,0,1144,4585,315,0,11477,3227,2328,0,1162,3336,270,0,10323
2011,Dem. Rep. of the Congo,Nlundu Matende : Point,4,5,0,6,25,5,0,45,7,7,0,8,21,6,0,49
2011,Dem. Rep. of the Congo,Nkondo : Point,26,39,0,23,67,6,0,161,6,22,0,33,30,64,0,155
2011,Dem. Rep. of the Congo,Napassa : Point,4,1,0,0,0,0,0,5,3,5,0,0,3,0,0,11
2011,Dem. Rep. of the Congo,MWENE DITU,20,23,0,8,37,1,0,89,17,21,0,8,43,1,0,90
2011,Dem. Rep. of the Congo,Mfuiki : Point,4,2,0,2,6,0,0,14,4,5,0,2,12,1,0,24
2011,Dem. Rep. of the Congo,Lusuku : Point,15,28,0,12,53,3,0,111,26,33,0,10,57,4,0,130
2011,Dem. Rep. of the Congo,Lubumbashi : Point,64,79,0,38,136,10,0,327,73,91,0,62,184,5,0,415
2011,Dem. Rep. of the Congo,Lualaba,1095,1220,0,611,1719,146,0,4791,1136,1228,0,673,1927,168,0,5132
2011,Dem. Rep. of the Congo,LIBENGE ET DONGO,925,1484,0,1026,2180,227,0,5842,874,1389,0,894,2509,384,0,6050
2011,Dem. Rep. of the Congo,Kulindji : Point,5,9,0,19,7,2,0,42,4,24,0,23,26,5,0,82
2011,Dem. Rep. of the Congo,Kinshasa : Point,680,1301,0,995,4282,990,0,8248,701,1250,0,1045,3782,871,0,7649
2011,Dem. Rep. of the Congo,Kinsalulu : Point,11,10,0,10,26,1,0,58,13,14,0,15,10,0,0,52
2011,Dem. Rep. of the Congo,Kinsafu : Point,7,11,0,11,15,1,0,45,5,7,0,7,9,0,0,28
2011,Dem. Rep. of the Congo,Kimpindi : Point,4,4,0,4,9,2,0,23,7,7,0,8,3,0,0,25
2011,Dem. Rep. of the Congo,Kimfwakata : Point,9,7,0,8,12,0,0,36,6,10,0,7,7,0,0,30
2011,Dem. Rep. of the Congo,Kimbianga : Point,3,4,0,2,8,1,0,18,2,5,0,4,3,3,0,17
2011,Dem. Rep. of the Congo,Kimaza : Point,40,73,0,107,1,0,0,221,42,88,0,220,16,0,0,366
2011,Dem. Rep. of the Congo,Kilueka : Point,42,87,0,51,155,12,0,347,70,82,0,46,127,14,0,339
2011,Dem. Rep. of the Congo,Katshia : Point,41,64,0,25,91,5,0,226,33,67,0,27,94,8,0,229
2011,Dem. Rep. of the Congo,Katanga (Kisenge) : Point,8,11,0,10,27,2,0,58,8,13,0,6,20,5,0,52
2011,Dem. Rep. of the Congo,Kasai-Oriental : Province,66,55,0,34,244,15,0,414,104,61,0,30,217,11,0,423
2011,Dem. Rep. of the Congo,KALEMIE,0,0,0,0,0,0,0,0,0,0,0,0,2,0,0,2
2011,Dem. Rep. of the Congo,Kahemba : Point,0,2,0,0,2,2,0,6,1,3,0,0,6,2,0,12
2011,Dem. Rep. of the Congo,Isiro : Point,4,3,0,7,14,1,0,29,2,5,0,5,18,0,0,30
2011,Dem. Rep. of the Congo,Ingbokolo : Point,110,105,0,100,327,15,0,657,94,96,0,100,278,19,0,587
2011,Dem. Rep. of the Congo,Goma : Point,79,133,0,113,238,4,0,567,73,120,0,95,274,2,0,564
2011,Dem. Rep. of the Congo,Fizi (Baraka) : Point,386,447,0,222,657,66,0,1778,413,465,0,270,632,53,0,1833
2011,Dem. Rep. of the Congo,Dungu : Point,2,0,0,2,2,0,0,6,1,0,0,0,5,0,0,6
2011,Dem. Rep. of the Congo,Doruma : Point,13,10,0,7,20,8,0,58,4,8,0,8,18,8,0,46
2011,Dem. Rep. of the Congo,Divuma : Point,30,24,0,16,49,5,0,124,27,31,0,19,38,9,0,124
2011,Dem. Rep. of the Congo,Democratic Republic of the Congo : Dispersed in the country / te,3909,3960,0,7116,9322,451,0,24758,4516,5743,0,9446,7918,557,0,28180
2011,Dem. Rep. of the Congo,Buta : Point,3,5,0,5,12,0,0,25,4,4,0,2,11,1,0,22
2011,Dem. Rep. of the Congo,Bukavu : Point,15,16,0,7,62,3,0,103,27,30,0,23,61,2,0,143
2011,Dem. Rep. of the Congo,Bas-Congo : Province,2403,5541,0,3433,12908,2044,0,26329,2415,5648,0,3870,10207,1581,0,23721
2011,Dem. Rep. of the Congo,Bangalu Afflux : Point,14,10,0,13,29,7,0,73,10,11,0,12,16,13,0,62
2011,Dem. Rep. of the Congo,Aru : Point,13,3,0,4,22,0,0,42,9,4,0,5,3,1,0,22
2011,Dem. Rep. of the Congo,Ariwara : Point,7,41,0,41,120,57,0,266,51,77,0,65,236,96,0,525
2011,Dem. Rep. of the Congo,Aba : Point,0,0,0,0,2,0,0,2,0,0,0,0,3,0,0,3
2011,Congo,Betou : Point,5098,8101,0,4301,13333,1204,0,32037,5126,8175,0,4297,10765,710,0,29073
2011,Congo,Brazzaville : Point,324,722,0,465,1455,55,0,3021,332,719,0,472,2201,36,0,3760
2011,Congo,Dolisie,22,39,0,25,59,1,0,146,27,24,0,25,64,5,0,145
2011,Congo,Dongou : Point,1379,1739,0,876,2663,264,0,6921,1407,1713,0,896,2268,200,0,6484
2011,Congo,Enyelle : Point,385,499,0,234,795,74,0,1987,428,493,0,266,639,56,0,1882
2011,Congo,Impfondo : Point,2804,3905,0,2269,6419,540,0,15937,2837,3963,0,2296,6151,332,0,15579
2011,Congo,Komi : Point,5,8,0,2,21,2,0,38,3,10,0,5,37,4,0,59
2011,Congo,Kondi Mbaka : Point,9,19,0,16,62,4,0,110,14,33,0,23,62,7,0,139
2011,Congo,Lekoumou,1,4,0,6,19,2,0,32,2,4,0,10,9,3,0,28
2011,Congo,Liranga : Point,2206,2850,0,1405,4456,301,0,11218,2137,2801,0,1317,3644,234,0,10133
2011,Congo,Loukolela : Point,155,277,0,137,382,14,0,965,175,296,0,138,595,23,0,1227
2011,Congo,Malolo : Point,21,45,0,19,78,8,0,171,20,44,0,21,56,7,0,148
2011,Congo,Ngo : Point,20,34,0,21,42,0,0,117,17,43,0,12,141,1,0,214
2011,Congo,Niari,13,13,0,10,30,4,0,70,15,17,0,6,36,2,0,76
2011,Congo,Nkayi,0,0,0,0,1,0,0,1,1,0,0,0,0,0,0,1
2011,Congo,Okoyo : District,12,18,0,0,0,0,0,30,14,12,0,0,0,0,0,26
2011,Congo,Ollombo : Point,18,37,0,19,51,2,0,127,6,36,0,14,104,0,0,160
2011,Congo,Oyo : Point,2,20,0,3,40,1,0,66,87,37,0,39,149,8,0,320
2011,Congo,Pointe Noire : Point,42,36,0,34,114,3,0,229,29,50,0,21,213,6,0,319
2011,Congo,Pool : Departement,66,91,0,53,242,2,0,454,46,80,0,41,300,4,0,471
2011,Congo,Sangha : Departement,97,164,0,80,220,8,0,569,60,142,0,63,391,5,0,661
2011,Congo,Tchiamba-Nza : Point,1,11,0,10,43,8,0,73,5,10,0,15,50,3,0,83
2011,Colombia,Apartadó : Point,0,0,0,0,1,0,0,1,0,0,0,0,1,0,0,1
2011,Colombia,Barcelona : Point,0,0,0,2,1,0,0,3,0,0,0,0,2,0,0,2
2011,Colombia,Barranquilla,0,0,0,0,1,0,0,1,1,0,0,0,1,0,0,2
2011,Colombia,Bogota : Point,8,6,0,4,46,7,0,71,6,10,0,12,173,6,0,207
2011,Colombia,Buenaventura : Point,0,1,0,2,2,0,0,5,0,3,0,0,1,0,0,4
2011,Colombia,Cajicá,0,0,0,0,0,0,0,0,0,0,0,0,1,0,0,1
2011,Colombia,Cali,0,0,0,0,1,0,0,1,0,0,0,0,1,2,0,3
2011,Colombia,Cartagena : Point,0,0,0,0,1,0,0,1,0,0,0,0,9,1,0,10
2011,Colombia,Charalá : Point,0,0,0,0,0,0,0,0,0,0,0,0,0,1,0,1
2011,Colombia,Cúcuta,1,0,0,0,3,0,0,4,1,0,0,1,3,1,0,6
2011,Colombia,Duitama,0,0,0,0,1,0,0,1,0,0,0,0,0,0,0,0
2011,Colombia,Ibagué : Point,0,0,0,0,1,0,0,1,0,0,0,0,1,0,0,1
2011,Colombia,Maicao,0,0,0,0,1,0,0,1,1,0,0,0,0,0,0,1
2011,Colombia,Medellín : Point,0,0,0,0,0,1,0,1,0,0,0,0,3,0,0,3
2011,Colombia,San Andres Islas,0,0,0,0,2,0,0,2,0,0,0,1,2,0,0,3
2011,Colombia,Tame,0,0,0,0,0,0,0,0,0,0,0,0,1,0,0,1
2011,Colombia,Tuluá,0,0,0,0,0,0,0,0,0,0,0,0,1,0,0,1
2011,Colombia,Colombia : Dispersed in the country / territory,0,1,0,0,3,0,1983260,1983264,1,0,0,0,11,0,1905049,1905061
2011,Costa Rica,Costa Rica : Dispersed in the country / territory,423,919,0,944,6224,217,0,8727,600,1188,0,1211,8198,588,0,11785
2011,Cuba,Artemisa,0,0,0,0,1,0,0,1,0,0,0,0,0,0,0,0
2011,Cuba,Camaguey : Municipio,0,0,0,0,0,0,0,0,0,0,0,0,22,1,0,23
2011,Cuba,Cienfuegos : Municipio,0,0,0,0,0,0,0,0,0,0,0,0,50,0,0,50
2011,Cuba,Granma : Provincia,0,0,0,0,0,0,0,0,0,0,0,0,29,0,0,29
2011,Cuba,Guantánamo : Point,0,0,0,0,0,0,0,0,0,0,0,0,55,0,0,55
2011,Cuba,Holguin : Municipio,0,0,0,0,0,0,0,0,0,0,0,0,31,0,0,31
2011,Cuba,La Habana : Provincia,0,0,0,0,11,1,0,12,0,1,0,1,26,0,0,28
2011,Cuba,Las Tunas : Municipio,0,0,0,0,0,0,0,0,0,0,0,0,18,0,0,18
2011,Cuba,Matanzas : Point,0,0,0,0,0,0,0,0,0,0,0,0,17,0,0,17
2011,Cuba,Mayabeque,0,0,0,0,0,0,0,0,0,0,0,0,2,0,0,2
2011,Cuba,Villa Clara : Provincia,0,0,0,0,1,0,0,1,0,0,0,0,18,0,0,18
2011,Cuba,Santiago De Cuba : Municipio,0,0,0,0,0,0,0,0,0,0,0,0,17,0,0,17
2011,Cuba,Sancti Spiritus : Municipio,0,0,0,0,0,0,0,0,0,0,0,0,27,0,0,27
2011,Cuba,Pinar Del Rio : Municipio,0,0,0,0,0,0,0,0,0,0,0,0,42,0,0,42
2011,Cuba,Isla De La Juventud : Provincia,0,0,0,0,0,0,0,0,0,0,0,1,12,0,0,13
2011,Cuba,Ciego De Avila : Municipio,0,0,0,0,0,0,0,0,0,0,0,0,4,0,0,4
2011,Curaçao,Willemstad : Point,0,1,0,1,5,0,0,7,1,1,0,0,3,0,0,5
2011,Cayman Islands,Cayman Islands : Dispersed in the country / territory,0,0,0,0,0,0,0,0,0,0,0,0,4,0,0,4
2011,Germany,Germany : Dispersed in the country / territory,7902,20689,0,28454,182517,31169,0,270731,8377,22285,0,31790,273586,27596,0,363634
2011,Djibouti,Ali-Addeh : Point,992,1576,0,1253,5157,168,0,9146,1044,1630,0,1023,6445,212,0,10354
2011,Djibouti,Djibouti: Point,129,142,0,82,621,3,0,977,99,194,0,110,1363,4,0,1770
2011,Dominican Rep.,Dominican Republic : Dispersed in the country / territory,1,0,0,0,3,0,1201,1205,1,1,0,0,6,0,1167,1175
2011,Algeria,Alger : Point,10,6,0,5,37,0,0,58,17,7,0,3,57,1,0,85
2011,Algeria,Algeria : Dispersed in the country / territory,31,7,0,6,182,0,0,226,32,8,0,8,536,6,0,590
2011,Ecuador,Ecuador : Dispersed in the country / territory,1221,4263,0,4025,26980,1196,0,37685,1252,4231,0,4192,27796,1494,0,38965
2011,Egypt,6th October : Point,81,229,0,175,834,89,0,1408,104,241,0,175,932,71,0,1523
2011,Egypt,Alexandria : Point,14,79,0,45,221,21,0,380,18,60,0,58,314,25,0,475
2011,Egypt,Cairo : Point,7304,10026,0,6656,21583,1279,0,46848,8038,7278,0,11747,26607,887,0,54557
2011,Egypt,Giza : Point,147,286,0,244,2011,97,0,2785,168,377,0,255,2326,91,0,3217
2011,Egypt,Helwan : Point,90,192,0,146,970,45,0,1443,93,208,0,159,950,39,0,1449
2011,Eritrea,Asmara : Point,9,8,0,3,16,0,0,36,8,10,0,5,14,1,0,38
2011,Eritrea,Elit : Point,9,18,0,19,18,8,0,72,11,20,0,15,50,5,0,101
2011,Eritrea,Emkulu : Point,1015,370,0,320,555,98,0,2358,917,363,0,298,529,7,0,2114
2011,Eritrea,Eritrea : Dispersed in the country / territory,1,0,0,0,1,0,0,2,0,0,0,0,5,0,0,5
2011,Estonia,Illuka : Linnad - District,0,0,0,1,4,0,0,5,0,0,0,0,6,0,0,6
2011,Estonia,Estonia : Dispersed in the country / territory,0,0,0,0,4,0,45860,45864,1,2,0,0,41,0,51889,51933
2011,Ethiopia,Adiharush : Point,298,525,0,208,2281,17,0,3329,324,550,0,254,11435,90,0,12653
2011,Ethiopia,Asaita : Point,314,475,0,271,1026,75,0,2161,383,583,0,362,1373,79,0,2780
2011,Ethiopia,Awbarre : Point,1241,2016,0,913,2756,174,0,7100,1323,1935,0,959,2018,91,0,6326
2011,Ethiopia,Berhale : Point,810,1330,0,541,2034,79,0,4794,873,1458,0,686,2182,218,0,5417
2011,Ethiopia,Bokolmanyo : Point,4684,5922,0,2160,7394,391,0,20551,4665,6173,0,2543,4154,415,0,17950
2011,Ethiopia,Buramino,552,587,0,237,779,50,0,2205,588,643,0,178,398,33,0,1840
2011,Ethiopia,Fugnido : Point,2643,2762,0,1807,5278,196,0,12686,2600,2825,0,1833,2692,56,0,10006
2011,Ethiopia,Gode (God-Dehar),176,151,0,41,520,78,0,966,185,122,0,6,63,12,0,388
2011,Ethiopia,Hilaweyn ,3460,3841,0,1311,4862,280,0,13754,3550,3884,0,1419,2847,293,0,11993
2011,Ethiopia,Kebribeyah : Point,1300,2412,0,1016,3439,193,0,8360,1323,2383,0,1100,2982,260,0,8048
2011,Ethiopia,Kobe Camp,3307,3720,0,1208,4853,383,0,13471,3457,4079,0,1429,3192,405,0,12562
2011,Ethiopia,Mai-Ayni : Point,434,394,0,418,3604,47,0,4897,519,392,0,1318,7248,58,0,9535
2011,Ethiopia,Melkadida : Point,4889,6543,0,2345,7775,439,0,21991,5074,6820,0,2395,3976,440,0,18705
2011,Ethiopia,Sheder : Point,892,1477,0,883,2593,138,0,5983,939,1613,0,994,1725,72,0,5343
2011,Ethiopia,Sherkole : Point,749,918,0,460,1532,47,0,3706,842,962,0,654,2732,66,0,5256
2011,Ethiopia,Tongo Camp,944,907,0,457,1692,142,0,4142,1023,912,0,565,2819,144,0,5463
2011,Ethiopia,Shimelba (Shire/Shiraro) : Point,521,500,0,386,1498,201,0,3106,556,491,0,433,3501,208,0,5189
2011,Ethiopia,Dollo Ado Transit Centre,993,1069,0,388,1339,100,0,3889,1024,1016,0,380,892,83,0,3395
2011,Ethiopia,Borena : Awrajja - Zone,277,336,0,219,539,97,0,1468,284,354,0,158,400,90,0,1286
2011,Ethiopia,Addis Ababa Urban : Point,130,194,0,148,603,26,0,1101,124,222,0,144,988,61,0,1539
2011,Ethiopia,Ad-Damazin Transit Centre,593,514,0,263,979,101,0,2450,569,515,0,274,942,107,0,2407
2011,Fiji,Suva : Point,0,0,0,0,1,1,0,2,0,0,0,0,6,0,0,6
2011,France,France : Dispersed in the country / territory,0,0,0,0,0,0,70878,70878,0,0,0,0,0,0,97603,97603
2011,Gabon,Akieni : Point,0,2,0,2,2,0,0,6,0,3,0,1,7,0,0,11
2011,Gabon,Bakumba : Point,0,12,0,9,23,1,0,45,0,8,0,7,0,0,0,15
2011,Gabon,Banda Mamba : Point,0,4,0,3,6,3,0,16,0,1,0,2,1,4,0,8
2011,Gabon,Bitam : Point,0,0,0,0,2,0,0,2,0,1,0,0,6,0,0,7
2011,Gabon,Bongoville : Point,0,0,0,0,1,0,0,1,0,0,0,0,1,0,0,1
2011,Gabon,Booue : Point,0,1,0,1,4,0,0,6,0,1,0,1,10,0,0,12
2011,Gabon,Boumango : Point,0,0,0,1,0,0,0,1,0,0,0,0,2,0,0,2
2011,Gabon,Dilemba : Point,10,24,0,25,101,19,0,179,5,25,0,31,94,15,0,170
2011,Gabon,Doussala : Point,0,1,0,4,4,1,0,10,0,4,0,4,7,0,0,15
2011,Gabon,Fougamou : Point,0,1,0,0,2,0,0,3,0,0,0,1,4,0,0,5
2011,Gabon,Franceville : Point,48,146,0,144,487,18,0,843,52,167,0,88,903,28,0,1238
2011,Gabon,Gamba : Point,0,14,0,12,71,0,0,97,0,13,0,9,78,1,0,101
2011,Gabon,Koulamoutou : Point,2,17,0,21,70,2,0,112,0,18,0,14,143,6,0,181
2011,Gabon,Koumou Doussala : Point,0,3,0,3,5,3,0,14,0,1,0,4,2,1,0,8
2011,Gabon,Lambarene : Point,0,6,0,2,15,0,0,23,3,11,0,3,30,2,0,49
2011,Gabon,Lastoursville : Point,1,5,0,10,34,1,0,51,0,9,0,9,49,3,0,70
2011,Gabon,Lebamba : Point,2,12,0,8,23,0,0,45,1,4,0,4,23,1,0,33
2011,Gabon,Lekindou : Point,0,2,0,3,11,0,0,16,0,4,0,2,5,2,0,13
2011,Gabon,Libreville : Point,52,263,0,275,1280,38,0,1908,69,233,0,295,2507,141,0,3245
2011,Gabon,Mabanda : Point,0,3,0,4,25,3,0,35,2,9,0,5,37,4,0,57
2011,Gabon,Makokou : Point,0,1,0,3,10,0,0,14,0,0,0,1,20,1,0,22
2011,Gabon,Mayumba : Point,0,2,0,2,14,0,0,18,0,2,0,1,16,0,0,19
2011,Gabon,Mekambo : Point,0,0,0,0,0,0,0,0,0,0,0,0,2,1,0,3
2011,Gabon,Mitzic : Point,0,0,0,0,1,0,0,1,0,0,0,0,3,0,0,3
2011,Gabon,Moanda : Point,2,107,0,93,258,28,0,488,3,90,0,137,342,18,0,590
2011,Gabon,Molengui Binza : Point,2,15,0,24,33,10,0,84,3,23,0,20,41,6,0,93
2011,Gabon,Mouila : Point,10,39,0,39,214,3,0,305,8,43,0,82,205,5,0,343
2011,Gabon,Mounana : Point,1,9,0,12,40,1,0,63,0,7,0,10,87,3,0,107
2011,Gabon,Ndende : Point,9,47,0,24,117,6,0,203,9,37,0,27,87,0,0,160
2011,Gabon,Ndjole : Point,0,0,0,0,0,0,0,0,0,0,0,0,5,0,0,5
2011,Gabon,Ngwoni : Point,0,1,0,0,1,0,0,2,0,0,0,0,11,0,0,11
2011,Gabon,Ntoum : Point,0,0,0,1,1,0,0,2,0,1,0,0,1,0,0,2
2011,Gabon,Nzinga : Point,0,2,0,4,6,3,0,15,0,3,0,2,8,0,0,13
2011,Gabon,Okondja : Point,0,5,0,1,4,0,0,10,0,2,0,1,40,0,0,43
2011,Gabon,Oyem : Point,0,0,0,1,6,0,0,7,0,2,0,1,17,0,0,20
2011,Gabon,Pana/Dienga : Point,0,0,0,0,1,0,0,1,0,0,0,1,3,0,0,4
2011,Gabon,Port-Gentil : Point,0,11,0,11,72,4,0,98,0,14,0,11,178,11,0,214
2011,Gabon,Rebe : Point,0,0,0,0,1,0,0,1,0,0,0,0,0,0,0,0
2011,Gabon,Rinanzala : Point,4,10,0,8,22,2,0,46,3,10,0,8,24,2,0,47
2011,Gabon,Tchibanga : Point,55,108,0,87,278,9,0,537,39,71,0,67,320,12,0,509
2011,Gabon,Voungou/Pont : Point,0,3,0,1,10,4,0,18,0,6,0,2,15,0,0,23
2011,Georgia,Martqop’i : Point,1,1,0,0,7,0,0,9,0,2,0,0,22,1,0,25
2011,Georgia,Tbilisi : Point,15,27,0,36,143,3,0,224,25,31,0,35,124,14,0,229
2011,Georgia,Vale : Point,0,0,0,0,0,0,0,0,0,0,0,0,1,0,0,1
2011,Georgia,Zugdidi : Raion - District,2,0,0,0,1,0,0,3,0,1,0,0,1,0,0,2
2011,Georgia,Georgia : Dispersed in the country / territory,1,7,0,5,681,156,0,850,1,4,0,3,608,112,0,728
2011,Ghana,Accra : Point,127,228,0,237,1087,39,0,1718,143,210,0,295,1920,58,0,2626
2011,Ghana,Ampain,304,390,0,399,1481,68,0,2642,332,371,0,359,1073,24,0,2159
2011,Ghana,Buduburam : Point,579,692,0,682,3406,107,0,5466,580,732,0,615,3672,68,0,5667
2011,Ghana,Eagle Star,2,11,0,13,64,0,0,90,5,27,0,25,199,0,0,256
2011,Ghana,Egyeikroum,60,93,0,71,361,12,0,597,79,86,0,69,421,6,0,661
2011,Ghana,Fetentaa,62,101,0,66,305,11,0,545,67,59,0,62,362,5,0,555
2011,Ghana,Host community- based ,45,64,0,58,326,26,0,519,46,63,0,64,344,24,0,541
2011,Ghana,Krisan : Point,42,63,0,35,208,11,0,359,51,45,0,96,405,10,0,607
2011,Ghana,Kumasi : District,0,0,0,0,1,0,0,1,0,2,0,0,5,0,0,7
2011,Ghana,Volta : Province,91,159,0,20,289,12,0,571,95,145,0,14,372,7,0,633
2011,Guinea,Beyla,27,32,0,11,70,4,0,144,27,25,0,13,26,4,0,95
2011,Guinea,Conakry : Point,112,245,0,282,1170,21,0,1830,104,304,0,307,1452,31,0,2198
2011,Guinea,Kouankan : Point,104,349,0,389,919,43,0,1804,113,337,0,343,769,39,0,1601
2011,Guinea,Kountaya : Point,0,2,0,5,18,1,0,26,5,6,0,4,13,1,0,29
2011,Guinea,Laine : Point,41,404,0,510,1250,67,0,2272,28,427,0,485,982,47,0,1969
2011,Guinea,Macenta : Point,324,642,0,536,1196,75,0,2773,284,552,0,563,1007,50,0,2456
2011,Guinea,Nzerekore : Point,2,2,0,2,4,0,0,10,1,2,0,0,4,0,0,7
2011,Gambia,Fogni area,653,881,0,487,1733,263,0,4017,716,865,0,604,1291,195,0,3671
2011,Gambia,Gambia : Dispersed in the country / territory,134,143,0,109,529,28,0,943,120,169,0,85,488,61,0,923
2011,Guinea-Bissau,Bigene,209,387,0,200,844,74,0,1714,235,378,0,204,595,91,0,1503
2011,Guinea-Bissau,Biombo,3,2,0,0,0,3,0,8,0,0,0,1,3,0,0,4
2011,Guinea-Bissau,Bissau : Point,8,10,0,8,36,0,0,62,8,13,0,4,128,4,0,157
2011,Guinea-Bissau,Canchungo,82,109,0,75,234,30,0,530,56,140,0,68,160,22,0,446
2011,Guinea-Bissau,Jolmete : Point,34,32,0,40,97,7,0,210,23,49,0,32,73,9,0,186
2011,Guinea-Bissau,Sao Domingos : ADMIN_2,216,330,0,151,848,129,0,1674,238,370,0,161,531,97,0,1397
2011,Grenada,Grenada : Dispersed in the country / territory,0,0,0,0,1,0,0,1,0,0,0,1,1,0,0,2
2011,Guatemala,Guatemala : Municipio,1,1,0,1,61,9,0,73,0,3,0,2,72,7,0,84
2011,Guyana,Guyana : Dispersed in the country / territory,0,0,0,1,3,0,0,4,0,1,0,1,2,0,0,4
2011,"China, Hong Kong SAR",Hong Kong : Dispersed in the country / territory,19,24,0,19,255,3,0,320,17,18,0,20,375,0,0,430
2011,Honduras,Ceiba : Point,0,0,0,0,0,0,0,0,0,0,0,0,2,0,0,2
2011,Honduras,Tegucigalpa : Point,0,0,0,2,1,0,0,3,0,0,0,0,3,0,0,3
2011,Honduras,Trujillo : Municipio,0,0,0,0,0,0,0,0,0,0,0,0,5,0,0,5
2011,Honduras,Islas De Bahia : Departamento,0,0,0,0,0,0,0,0,0,0,0,0,1,0,0,1
2011,Honduras,Comayagua : Departamento,0,0,0,0,3,0,0,3,0,0,0,0,0,0,0,0
2011,Croatia,Bjelovar : Point,0,0,0,0,0,0,0,0,0,0,0,0,1,0,0,1
2011,Croatia,Jezevo : Point,0,0,0,0,0,0,0,0,0,0,0,0,22,0,0,22
2011,Croatia,Kutina : Point,1,0,0,0,1,0,0,2,0,1,0,0,2,0,0,3
2011,Croatia,Rijeka : Point,0,0,0,0,0,0,0,0,0,0,0,0,2,0,0,2
2011,Croatia,Vinkovci : Point,0,0,0,0,1,0,0,1,0,0,0,0,0,0,0,0
2011,Croatia,Zagreb : Point,2,2,0,1,6,0,0,11,1,0,0,7,15,0,0,23
2011,Croatia,Croatia : Dispersed in the country / territory,6,26,0,14,268,206,10985,11505,8,33,0,49,303,131,10140,10664
2011,Haiti,Port au Prince,0,0,0,0,0,0,0,0,0,0,0,0,6,0,0,6
2011,Indonesia,Bandung,0,3,0,2,6,0,0,11,0,0,0,0,28,0,0,28
2011,Indonesia,Bekasi,0,0,0,0,0,0,0,0,0,0,0,1,0,0,0,1
2011,Indonesia,Belawan : Point,0,0,0,0,1,0,0,1,1,0,0,11,87,1,0,100
2011,Indonesia,Bogor,47,70,0,68,274,11,0,470,47,106,0,372,958,23,0,1506
2011,Indonesia,Brebes,0,0,0,0,0,0,0,0,0,0,0,0,1,0,0,1
2011,Indonesia,Depok,1,0,0,0,1,0,0,2,0,1,0,0,1,0,0,2
2011,Indonesia,ETC Romania : Point,1,1,0,0,2,0,0,4,0,0,0,0,13,0,0,13
2011,Indonesia,Kota Balikpapan,0,0,0,0,0,0,0,0,0,0,0,1,1,0,0,2
2011,Indonesia,Kota Bandarlampung,1,1,0,1,2,0,0,5,1,2,0,0,5,0,0,8
2011,Indonesia,Kota Surakarta,0,1,0,0,1,0,0,2,0,0,0,0,1,0,0,1
2011,Indonesia,Kota Yogyakarta,0,0,0,0,0,0,0,0,0,0,0,2,50,0,0,52
2011,Indonesia,Makassar : Point,2,1,0,1,10,0,0,14,1,0,0,9,65,2,0,77
2011,Indonesia,Semarang,0,0,0,0,1,0,0,1,0,0,0,0,0,0,0,0
2011,Indonesia,Sukabumi,0,0,0,0,2,0,0,2,0,0,0,0,2,0,0,2
2011,Indonesia,Tanjung Pinang : Point,2,5,0,1,7,0,0,15,1,1,0,27,293,3,0,325
2011,Indonesia,Sumatra Utara : Propinsi - Province,7,13,0,6,36,2,0,64,5,16,0,14,346,2,0,383
2011,Indonesia,Sulawesi Utara : Propinsi - Province,1,2,0,0,8,0,0,11,1,3,0,11,49,1,0,65
2011,Indonesia,Riau : Propinsi - Province,0,0,0,0,1,0,0,1,0,0,0,10,98,0,0,108
2011,Indonesia,Kupang : Kabupaten - Regencies,1,0,0,0,5,0,0,6,0,0,0,12,83,0,0,95
2011,Indonesia,Kalimantan Barat : Propinsi - Province,0,0,0,0,0,0,0,0,0,0,0,8,56,3,0,67
2011,Indonesia,Jawa Timur : Propinsi - Province,4,2,0,0,10,0,0,16,2,1,0,21,64,1,0,89
2011,Indonesia,Indonesia : Dispersed in the country / territory,7,10,0,4,25,1,0,47,4,4,0,41,114,1,0,164
2011,Indonesia,Dki Jakarta : Propinsi - Province,16,14,0,7,58,1,0,96,15,22,0,64,219,4,0,324
2011,Indonesia,Banten : Propinsi - Province,0,0,0,0,2,0,0,2,0,0,0,2,13,0,0,15
2011,Indonesia,Bali : Propinsi - Province,2,2,0,1,10,0,0,15,2,8,0,3,13,0,0,26
2011,India,Delhi : District,778,1261,0,1320,6174,456,0,9989,746,1380,0,1712,6242,415,0,10495
2011,India,Tamil Nadu : State,0,0,0,0,0,0,33549,33549,0,0,0,0,0,0,34603,34603
2011,Iran (Islamic Rep. of),Tehran : Shahrestan - County,2,17,0,46,102,3,0,170,13,25,0,76,146,5,0,265
2011,Iran (Islamic Rep. of),Markazi : Point,1,2,0,4,11,0,0,18,3,9,0,2,16,0,0,30
2011,Iran (Islamic Rep. of),Khorasan : Ostan - Province,0,0,0,3,5,0,0,8,0,2,0,5,11,0,0,18
2011,Iran (Islamic Rep. of),Kerman : Shahrestan - County,0,0,0,0,3,0,0,3,0,0,0,0,5,0,0,5
2011,Iran (Islamic Rep. of),Iran  (Islamic Republic of) : Dispersed in the country / territo,0,1,0,0,3,0,0,4,1,0,0,0,3,0,0,4
2011,Iraq,Anbar : Muhafazah - Province,337,377,0,377,1208,117,0,2416,352,388,0,388,1242,103,0,2473
2011,Iraq,Anbar/Al-Waleed : Point,21,31,0,39,86,6,0,183,21,41,0,27,138,13,0,240
2011,Iraq,Arbil : Qadaa - District,192,322,0,314,1047,82,0,1957,210,335,0,311,1315,87,0,2258
2011,Iraq,Babylon : Point,3319,3703,0,3703,11879,1154,0,23758,3463,3823,0,3823,12215,1010,0,24334
2011,Iraq,Baghdad : Point,10722,12249,0,12287,40182,4109,0,79549,11207,12597,0,12673,41449,3675,0,81601
2011,Iraq,Basrah : Muhafazah - Province,530,618,0,604,1927,185,0,3864,558,644,0,622,1982,161,0,3967
2011,Iraq,Dahuk : Muhafazah - Province,491,676,0,465,1319,106,0,3057,535,735,0,478,1497,95,0,3340
2011,Iraq,Diala : Muhafazah - Province,215,239,0,239,769,75,0,1537,224,248,0,248,790,66,0,1576
2011,Iraq,Kerbala : Point,503,561,0,561,1800,175,0,3600,525,579,0,579,1852,153,0,3688
2011,Iraq,Kirkuk : Qadaa - District,126,140,0,140,450,44,0,900,131,145,0,145,463,38,0,922
2011,Iraq,Makhmour : Point,897,1394,0,458,2191,179,0,5119,855,1289,0,494,2306,177,0,5121
2011,Iraq,Missan : Muhafazah - Province,314,350,0,350,1124,109,0,2247,328,362,0,364,1159,96,0,2309
2011,Iraq,Muthanna : Muhafazah - Province,77,85,0,85,274,27,0,548,80,88,0,88,282,23,0,561
2011,Iraq,Najaf : Qadaa - District,3138,3501,0,3501,11231,1091,0,22462,3273,3614,0,3614,11550,954,0,23005
2011,Iraq,Ninewa/Mousl : Point,287,342,0,321,1134,124,0,2208,294,351,0,328,1173,105,0,2251
2011,Iraq,Qadisiyah : Muhafazah - Province,97,109,0,109,348,34,0,697,102,112,0,112,358,30,0,714
2011,Iraq,Salaheldin : Muhafazah - Province,195,217,0,217,698,69,0,1396,203,226,0,225,718,59,0,1431
2011,Iraq,Sulaymaniyah : Point,204,459,0,492,1682,112,0,2949,238,470,0,495,1821,159,0,3183
2011,Iraq,Thiqar : Muhafazah - Province,216,241,0,241,773,75,0,1546,225,249,0,249,795,66,0,1584
2011,Iraq,Wasit : Muhafazah - Province,274,306,0,306,980,95,0,1961,286,315,0,315,1008,83,0,2007
2011,Iceland,Reykjavik : Point,5,3,0,5,21,0,0,34,3,4,0,1,64,0,0,72
2011,Iceland,Iceland : Dispersed in the country / territory,0,0,0,0,0,0,46,46,0,0,0,0,0,0,60,60
2011,Israel,Israel : Dispersed in the country / territory,212,354,0,506,11880,230,0,13182,350,285,0,610,33950,270,0,35465
2011,Jamaica,Jamaica : Dispersed in the country / territory,1,0,0,0,6,0,0,7,0,2,0,2,9,0,0,13
2011,Jordan,Ajlun : Governorate,4,7,0,5,13,0,0,29,2,4,0,5,20,0,0,31
2011,Jordan,Amman : Point,1447,2116,0,1553,8917,1638,0,15671,1546,2174,0,1705,9912,1368,0,16705
2011,Jordan,Aqaba : Governorate,1,13,0,3,26,4,0,47,7,10,0,2,36,4,0,59
2011,Jordan,Balqa : Governorate,6,9,0,17,56,6,0,94,16,20,0,14,69,4,0,123
2011,Jordan,Irbid : Governorate,107,174,0,94,346,37,0,758,120,137,0,95,506,38,0,896
2011,Jordan,Jarash : Governorate,6,10,0,1,7,1,0,25,7,10,0,0,15,0,0,32
2011,Jordan,Karak : Governorate,11,12,0,5,39,3,0,70,11,23,0,5,55,2,0,96
2011,Jordan,Ma'an : Governorate,7,7,0,4,23,2,0,43,10,11,0,2,41,2,0,66
2011,Jordan,Madaba : Governorate,12,19,0,11,50,6,0,98,14,19,0,13,74,4,0,124
2011,Jordan,Mafraq : Governorate,62,77,0,57,177,10,0,383,77,82,0,61,209,9,0,438
2011,Jordan,Tafilah : Governorate,4,5,0,2,3,1,0,15,2,3,0,2,6,1,0,14
2011,Jordan,Zarqa : Governorate,161,211,0,116,465,44,0,997,162,214,0,145,551,34,0,1106
2011,Jordan,Jordan : Dispersed in the country / territory,9,21,0,8,77,19,0,134,10,16,0,13,75,13,0,127
2011,Japan,Japan : Dispersed in the country / territory,0,0,0,0,0,0,2259,2259,0,0,0,0,0,0,5078,5078
2011,Kazakhstan,Almaty : Point,29,41,0,34,160,1,0,265,40,43,0,36,195,6,0,320
2011,Kazakhstan,Almaty Oblast,1,1,0,2,9,1,0,14,0,2,0,1,9,0,0,12
2011,Kazakhstan,South Kazakhstan Oblast,5,9,0,6,14,2,0,36,2,7,0,1,28,1,0,39
2011,Kazakhstan,Kazakhstan : Dispersed in the country / territory,0,163,0,303,1287,100,0,1853,0,179,0,323,1263,64,0,1829
2011,Kenya,Dadaab : Point,664,726,0,602,2015,215,0,4222,773,901,0,722,2172,145,0,4713
2011,Kenya,Dagahaley : Point,10149,16759,0,7676,25813,2152,0,62549,10192,17692,0,8717,21024,2040,0,59665
2011,Kenya,Hagadera : Point,10508,15933,0,8272,31089,2511,0,68313,11196,16548,0,9968,29096,2407,0,69215
2011,Kenya,IFO 2 E: Point,2862,4384,0,1447,5226,445,0,14364,2932,4822,0,1894,3775,435,0,13858
2011,Kenya,IFO 2 W: Point,3676,5582,0,1768,7008,625,0,18659,3966,6111,0,2291,5143,553,0,18064
2011,Kenya,Ifo : Point,9280,14044,0,7090,26399,2338,0,59151,9332,14774,0,8274,25155,2286,0,59821
2011,Kenya,Kakuma : Point,6440,8640,0,6025,18506,760,0,40371,6616,9647,0,7840,20962,426,0,45491
2011,Kenya,Kambioos : Point,1067,1701,0,567,1929,168,0,5432,1120,1984,0,780,1383,134,0,5401
2011,Kenya,Nairobi : District,1655,3334,0,3028,16639,821,0,25477,1682,3458,0,3095,18065,695,0,26995
2011,Kyrgyzstan,Bishkek : Point,18,84,0,56,250,45,0,453,32,66,0,58,320,36,0,512
2011,Kyrgyzstan,Osh : Point,3,4,0,1,245,130,0,383,0,3,0,4,211,102,0,320
2011,Kyrgyzstan,Ysyk-kol : Oblast - Region,0,0,0,0,670,380,0,1050,0,0,0,0,570,280,0,850
2011,Kyrgyzstan,Talas : Oblast - Region,0,0,0,0,870,490,0,1360,0,0,0,0,750,370,0,1120
2011,Kyrgyzstan,Osh : Oblast - Region,220,570,0,280,2400,1400,0,4870,180,480,0,260,2100,1010,0,4030
2011,Kyrgyzstan,Naryn : Oblast - Region,0,0,0,0,830,470,0,1300,0,0,0,0,700,350,0,1050
2011,Kyrgyzstan,Kyrgyzstan : Dispersed in the country / territory,7910,10660,0,10060,52900,5870,2800,90200,8970,11890,0,11540,48000,4200,2700,87300
2011,Kyrgyzstan,Jalal-abad : Oblast - Region,360,520,0,180,2300,1340,0,4700,430,480,0,300,2000,1090,0,4300
2011,Kyrgyzstan,Chuy : Oblast - Region,0,0,0,0,730,410,0,1140,0,0,0,0,620,310,0,930
2011,Kyrgyzstan,Batken : Oblast - Region,80,130,0,10,2100,190,0,2510,130,180,0,30,1300,600,0,2240
2011,Cambodia,Phnom Penh Urban : Point,1,3,0,4,20,3,0,31,4,10,0,3,63,2,0,82
2011,Rep. of Korea,Busan : Point,0,0,0,0,0,0,0,0,0,0,0,0,1,0,0,1
2011,Rep. of Korea,Cheongju : Point,0,0,0,0,1,0,0,1,0,0,0,0,2,0,0,2
2011,Rep. of Korea,Daegu : Point,2,0,0,0,3,0,0,5,0,0,0,0,3,0,0,3
2011,Rep. of Korea,Daejeon : Point,0,0,0,0,1,1,0,2,0,0,0,0,2,1,0,3
2011,Rep. of Korea,Euijeongbu : Point,0,0,0,0,1,0,0,1,0,0,0,0,2,0,0,2
2011,Rep. of Korea,Inchon : Do - Province,0,1,0,0,2,0,0,3,0,0,0,0,15,0,0,15
2011,Rep. of Korea,Jeju : Do - Province,0,0,0,0,0,0,0,0,0,0,0,0,1,0,0,1
2011,Rep. of Korea,Pohang : Point,0,0,0,0,0,0,0,0,0,0,0,0,1,0,0,1
2011,Rep. of Korea,Seoul : Point,15,18,0,1,192,4,0,230,21,18,0,9,1078,8,0,1134
2011,Rep. of Korea,Suwon : Point,0,0,0,0,0,0,0,0,0,0,0,0,6,1,0,7
2011,Rep. of Korea,Whasung : Point,0,0,0,0,3,1,0,4,0,0,0,0,7,1,0,8
2011,Kuwait,Kuwait : Dispersed in the country / territory,73,84,0,78,330,104,0,669,67,124,0,103,345,145,0,784
2011,Lebanon,Beqaa : Mohafazat - Governorates,27,33,0,20,101,0,6,187,27,34,0,40,154,14,0,269
2011,Lebanon,Beyrouth : Qadaa - District,49,64,0,28,245,0,14,400,72,72,0,41,689,23,0,897
2011,Lebanon,Liban Nord : Mohafazat - Governorates,444,485,0,346,1157,0,53,2485,513,479,0,374,1150,46,0,2562
2011,Lebanon,Liban Sud : Mohafazat - Governorates,40,53,0,29,89,0,3,214,58,65,0,29,310,9,0,471
2011,Lebanon,Mont Liban : Mohafazat - Governorates,380,417,0,288,1743,0,153,2981,421,473,0,342,3120,148,0,4504
2011,Lebanon,Lebanon : Dispersed in the country / territory,32,54,0,18,139,0,7,250,45,61,0,22,220,8,0,356
2011,Liberia,Bahn,520,588,0,251,1091,90,0,2540,527,567,0,297,978,112,0,2481
2011,Liberia,Bomi : County,1,0,0,0,1,0,0,2,0,0,0,0,0,0,0,0
2011,Liberia,Bong : County,4,6,0,3,7,2,0,22,0,2,0,7,13,0,0,22
2011,Liberia,Dougee,676,832,0,359,1370,202,0,3439,614,1011,0,559,1022,75,0,3281
2011,Liberia,Garmue,57,82,0,88,87,22,0,336,60,89,0,36,35,8,0,228
2011,Liberia,Grand Bassa : County,0,1,0,5,9,0,0,15,0,2,0,3,11,0,0,16
2011,Liberia,Grand Cape Mount : County,0,2,0,0,6,5,0,13,1,0,0,2,4,2,0,9
2011,Liberia,Grand Gedeh : County,4618,5594,0,2301,8912,1071,0,22496,4421,6490,0,3380,6582,572,0,21445
2011,Liberia,Grand Kru : County,6,9,0,3,11,0,0,29,5,7,0,2,8,0,0,22
2011,Liberia,Little Wlebbo,397,252,0,897,559,53,0,2158,361,246,0,677,536,39,0,1859
2011,Liberia,Lofa : County,6,5,0,2,23,0,0,36,14,8,0,3,15,0,0,40
2011,Liberia,Margibi : County,1,1,0,2,13,0,0,17,3,2,0,7,9,0,0,21
2011,Liberia,Maryland : County,922,1356,0,1014,1464,126,0,4882,998,1600,0,851,1350,65,0,4864
2011,Liberia,Monrovia : Point,17,24,0,19,36,9,0,105,12,14,0,22,74,9,0,131
2011,Liberia,Montserrado : County,51,67,0,92,276,20,0,506,81,91,0,103,402,16,1850,2543
2011,Liberia,Nimba : County,3835,5083,0,1855,9041,1011,0,20825,3793,5320,0,2138,5400,523,0,17174
2011,Liberia,PTP,465,489,0,212,967,60,0,2193,456,574,0,283,846,44,0,2203
2011,Liberia,River Ghee : County,508,223,0,967,612,43,0,2353,545,257,0,602,617,28,0,2049
2011,Liberia,Rivercess : County,0,0,0,0,1,0,0,1,0,0,0,2,1,0,0,3
2011,Liberia,Saclepea,88,218,0,129,405,32,0,872,90,222,0,150,454,34,0,950
2011,Liberia,Sinoe : County,1,2,0,5,41,1,0,50,2,6,0,8,33,0,0,49
2011,Liberia,Solo,742,851,0,373,1539,131,0,3636,773,945,0,527,1305,98,0,3648
2011,Liberia,Ziah,306,393,0,226,612,33,0,1570,309,382,0,198,440,13,0,1342
2011,Libya,Tripoli : Point,241,495,0,572,2752,168,0,4228,267,545,0,624,4416,355,0,6207
2011,Saint Lucia,Castries : Point,0,0,0,0,1,0,0,1,0,0,0,0,4,0,0,4
2011,Liechtenstein,Liechtenstein : Dispersed in the country / territory,0,0,0,0,0,0,12,12,0,0,0,0,0,0,45,45
2011,Sri Lanka,Ampara : Division,0,0,0,0,1,0,0,1,0,0,0,0,3,0,0,3
2011,Sri Lanka,Batticaloa : Point,0,0,0,0,1,0,0,1,0,0,0,1,7,0,0,8
2011,Sri Lanka,Colombo : Division,7,9,0,5,33,4,0,58,7,10,0,9,107,0,0,133
2011,Sri Lanka,Gampaha : Division,14,16,0,9,65,3,0,107,9,18,0,10,59,6,0,102
2011,Sri Lanka,Jaffna : Division,3,13,0,13,54,11,0,94,7,19,0,18,60,6,0,110
2011,Sri Lanka,Kalutara,0,0,0,0,6,0,0,6,0,0,0,0,2,0,0,2
2011,Sri Lanka,Kandy,0,0,0,2,4,0,0,6,0,1,0,0,2,1,0,4
2011,Sri Lanka,Mannar : Division,19,33,0,38,117,6,0,213,31,39,0,32,124,11,0,237
2011,Sri Lanka,Matale,0,0,0,0,0,0,0,0,0,0,0,0,1,0,0,1
2011,Sri Lanka,Puttalam : Division,0,0,0,0,0,0,0,0,0,0,0,0,1,0,0,1
2011,Sri Lanka,Vavuniya : Division,20,33,0,17,113,21,0,204,15,33,0,21,93,9,0,171
2011,Sri Lanka,Trincomalee : Division,36,37,0,38,172,16,0,299,31,57,0,34,171,12,0,305
2011,Sri Lanka,Kilinochchi : Division,2,3,0,7,12,4,0,28,2,4,0,4,12,4,0,26
2011,Lesotho,Maseru,1,1,0,1,10,0,0,13,2,2,0,2,18,0,0,24
2011,Lithuania,Elektrenai : Point,0,0,0,0,1,0,0,1,1,2,0,1,1,0,0,5
2011,Lithuania,FRC Pabrade : Point,5,3,0,2,15,0,0,25,4,3,0,8,34,0,0,49
2011,Lithuania,RRC Rukla : Point,1,3,0,0,5,0,0,9,1,3,0,6,14,0,0,24
2011,Lithuania,Vilnius : Savivaldybe - Municipality,0,0,0,0,1,0,0,1,1,0,0,0,1,0,0,2
2011,Lithuania,Lithuania : Dispersed in the country / territory,18,7,0,16,1545,419,0,2005,13,5,0,11,1024,422,0,1475
2011,Lithuania,Kaunas : Savivaldybe - Municipality,0,0,0,0,1,0,0,1,0,0,0,0,1,0,0,1
2011,Lithuania,Jonavos Raj. : Savivaldybe - Municipality,0,0,0,0,3,0,0,3,2,0,0,1,5,0,0,8
2011,Latvia,Latvia : Dispersed in the country / territory,3,1,0,4,11,0,0,19,3,5,0,3,38,0,0,49
2011,"China, Macao SAR",Macau : Dispersed in the country / territory,1,1,0,0,2,0,0,4,0,1,0,0,6,0,0,7
2011,Morocco,Rabat : Point,45,42,0,51,265,7,0,410,54,43,0,87,746,11,0,941
2011,Rep. of Moldova,Republic of Moldova : Dispersed in the country / territory,1,1,0,4,1117,133,0,1256,0,8,0,7,849,99,0,963
2011,Rep. of Moldova,Chisinau : Municipality,0,2,0,0,10,1,0,13,0,2,0,1,31,2,0,36
2011,Madagascar,Madagascar : Dispersed in the country / territory,0,0,0,2,3,0,0,5,0,1,0,0,5,0,0,6
2011,Mexico,Mexico City : Point,10,26,0,64,345,28,0,473,8,24,0,83,764,43,0,922
2011,The former Yugoslav Republic of Macedonia,Vizbegovo : Point,14,14,0,12,32,0,0,72,12,23,0,22,213,2,0,272
2011,The former Yugoslav Republic of Macedonia,Valandovo : Opština - Municipality,0,1,0,1,5,1,0,8,0,2,0,0,4,0,0,6
2011,The former Yugoslav Republic of Macedonia,Tetovo : Opština - Municipality,9,14,0,8,64,12,0,107,5,10,0,7,42,2,0,66
2011,The former Yugoslav Republic of Macedonia,Sveti Nikole : Region,0,0,0,0,0,1,0,1,0,0,0,0,0,0,0,0
2011,The former Yugoslav Republic of Macedonia,Strumica : Point,0,0,0,1,2,0,0,3,0,0,0,0,0,0,0,0
2011,The former Yugoslav Republic of Macedonia,Stip : Region,4,2,0,0,7,1,0,14,6,2,0,3,2,0,0,13
2011,The former Yugoslav Republic of Macedonia,Skopje : Region,104,121,0,102,508,29,0,864,104,136,0,89,415,27,0,771
2011,The former Yugoslav Republic of Macedonia,Radovis : Opština - Municipality,0,0,0,0,0,0,0,0,0,0,0,0,1,0,0,1
2011,The former Yugoslav Republic of Macedonia,Probistip : Point,0,0,0,0,0,1,0,1,0,0,0,0,0,0,0,0
2011,The former Yugoslav Republic of Macedonia,Prilep : Opština - Municipality,2,8,0,3,9,0,0,22,3,2,0,0,9,1,0,15
2011,The former Yugoslav Republic of Macedonia,Ohrid : Opština - Municipality,0,0,0,0,0,0,0,0,0,0,0,0,0,1,0,1
2011,The former Yugoslav Republic of Macedonia,Kumanovo : Opština - Municipality,10,9,0,11,67,3,0,100,12,13,0,11,43,8,0,87
2011,The former Yugoslav Republic of Macedonia,Kocani : Region,0,0,0,0,1,0,0,1,0,0,0,0,0,0,0,0
2011,The former Yugoslav Republic of Macedonia,Kicevo : Opština - Municipality,1,0,0,0,19,1,0,21,0,4,0,1,10,0,0,15
2011,The former Yugoslav Republic of Macedonia,Kavadarci : Opština - Municipality,0,0,0,0,2,0,0,2,0,0,0,0,1,0,0,1
2011,The former Yugoslav Republic of Macedonia,Gostivar : Opština - Municipality,7,7,0,5,28,1,0,48,7,7,0,4,12,6,0,36
2011,The former Yugoslav Republic of Macedonia,Gevgelija : Opština - Municipality,0,0,0,0,2,0,0,2,0,0,0,0,1,0,0,1
2011,The former Yugoslav Republic of Macedonia,Debar : Region,2,0,0,0,0,0,0,2,1,1,0,0,0,0,0,2
2011,The former Yugoslav Republic of Macedonia,Bitola : Region,13,11,0,0,19,0,0,43,13,6,0,4,14,0,0,37
2011,The former Yugoslav Republic of Macedonia,Berovo : Opština - Municipality,0,0,0,0,1,0,0,1,0,0,0,0,0,0,0,0
2011,Mali,Bamako : Point,190,199,0,274,1299,21,0,1983,203,260,0,295,2943,39,0,3740
2011,Mali,Faragouana : Point,4,3,0,2,15,1,0,25,6,5,0,4,8,0,0,23
2011,Mali,Kayes : Point,1272,1637,0,1029,1856,149,0,5943,1426,1734,0,1051,1997,194,0,6402
2011,Mali,Sikasso : Point,0,0,0,0,0,0,0,0,0,0,0,0,5,0,0,5
2011,Myanmar,Myanmar : Dispersed in the country / territory,65250,88489,0,153305,259605,34454,0,601103,58840,80253,0,131774,245824,29481,0,546172
2011,Montenegro,Cetinje : Point,0,0,0,1,8,1,0,10,0,1,0,0,3,1,0,5
2011,Montenegro,Pluzine : Point,0,0,0,0,1,0,0,1,0,0,0,0,0,0,0,0
2011,Montenegro,Ulcinj : Opština - Municipality,3,15,0,14,73,27,0,132,7,15,0,17,82,13,0,134
2011,Montenegro,Tivat : Opština - Municipality,4,11,0,15,129,55,0,214,0,13,0,28,134,47,0,222
2011,Montenegro,Rozaj : Opština - Municipality,5,8,0,14,69,9,0,105,6,14,0,22,49,11,0,102
2011,Montenegro,Podgorica : Opština - Municipality,197,381,0,339,1587,402,0,2906,203,404,0,405,1732,328,0,3072
2011,Montenegro,Pljevlja : Opština - Municipality,2,2,0,6,21,5,0,36,5,4,0,2,25,4,0,40
2011,Montenegro,Plav : Opština - Municipality,3,9,0,18,132,51,0,213,3,11,0,28,132,41,0,215
2011,Montenegro,Niksic : Opština - Municipality,7,16,0,35,153,38,0,249,10,19,0,34,146,22,0,231
2011,Montenegro,Mojkovac : Opština - Municipality,0,1,0,2,12,4,0,19,1,2,0,4,11,3,0,21
2011,Montenegro,Kotor : Opština - Municipality,0,6,0,3,50,31,0,90,3,3,0,6,83,15,0,110
2011,Montenegro,Kolasin : Opština - Municipality,1,4,0,5,25,19,0,54,1,3,0,9,35,10,0,58
2011,Montenegro,Herceg Novi : Opština - Municipality,0,13,0,25,278,124,0,440,3,16,0,22,258,90,0,389
2011,Montenegro,Danilovgrad : Point,1,10,0,13,103,45,0,172,2,11,0,20,100,29,0,162
2011,Montenegro,Budva : Opština - Municipality,4,18,0,19,175,57,0,273,2,19,0,25,160,45,0,251
2011,Montenegro,Bijelo Polje : Opština - Municipality,1,5,0,13,60,13,0,92,2,5,0,18,60,6,0,91
2011,Montenegro,Berane : Opština - Municipality,40,63,0,123,374,127,0,727,43,88,0,91,405,82,0,709
2011,Montenegro,Bar : Opština - Municipality,17,50,0,73,461,169,0,770,29,49,0,82,465,140,0,765
2011,Montenegro,Andrijevica : Opština - Municipality,3,7,0,12,89,34,0,145,2,8,0,18,69,24,0,121
2011,Mongolia,Ulaanbaatar : Point,0,0,0,0,1,0,0,1,0,0,0,0,5,0,0,5
2011,Mozambique,Cabo Delgado : Provincia,3,2,0,0,10,0,0,15,0,0,0,1,44,0,0,45
2011,Mozambique,Gaza : Point,2,3,0,2,7,0,0,14,0,7,0,2,16,0,0,25
2011,Mozambique,Inhambane : Point,0,3,0,2,10,0,0,15,0,3,0,6,14,0,0,23
2011,Mozambique,Manica : Point,3,1,0,3,19,0,0,26,1,5,0,1,51,0,0,58
2011,Mozambique,Maputo : Point,105,211,0,136,508,15,0,975,115,191,0,148,921,21,0,1396
2011,Mozambique,Maratane : Point,526,729,0,438,1389,62,0,3144,563,816,0,565,4452,36,0,6432
2011,Mozambique,Nampula : Distrito,42,68,0,35,191,2,0,338,48,74,0,42,670,10,0,844
2011,Mozambique,Niassa : Point,6,21,0,11,32,0,0,70,6,18,0,13,56,0,0,93
2011,Mozambique,Sofala : Point,1,5,0,2,10,0,0,18,0,5,0,3,16,1,0,25
2011,Mozambique,Tete : Point,0,2,0,1,8,0,0,11,0,1,0,1,9,2,0,13
2011,Mozambique,Zambezia : Point,2,7,0,3,21,0,0,33,3,7,0,5,53,0,0,68
2011,Mauritania,"Regions of Trarza, Brakna, Gorgol, Guidimakha and Assaba",131,209,0,101,272,23,0,736,173,176,0,73,188,21,0,631
2011,Mauritania,Nouakchott/Nouadhibou : Point,59,70,0,24,151,1,0,305,56,39,0,40,376,1,0,512
2011,Montserrat,Montserrat : Dispersed in the country / territory,0,0,0,0,0,0,0,0,0,0,0,0,5,0,0,5
2011,Malawi,Dzaleka : Point,1316,1772,0,1105,3165,100,0,7458,1446,1754,0,1369,4743,83,0,9395
2011,Malaysia,Kuala Lumpur : Wilayah Persekutuan - Federal State,4306,2922,0,2048,19545,444,0,29265,4500,3115,0,2594,57514,630,0,68353
2011,Namibia,Dukwe : Point,2,5,0,5,7,0,0,19,3,2,0,1,7,0,0,13
2011,Namibia,Osire : Point,424,651,0,484,1386,47,0,2992,430,667,0,519,1586,64,0,3266
2011,Namibia,Namibia : Dispersed in the country / territory,61,39,0,53,154,4,0,311,57,62,0,50,233,6,0,408
2011,Niger,Niamey : Point,15,34,0,22,92,5,0,168,10,39,0,21,180,7,0,257
2011,Nigeria,Amana : Point,150,160,0,105,361,35,0,811,124,100,0,104,81,18,0,427
2011,Nigeria,Benue : State,77,60,0,85,163,19,0,404,48,80,0,58,125,13,0,324
2011,Nigeria,Lagos : Point,171,210,0,274,1414,9,0,2078,155,195,0,354,2204,128,0,3036
2011,Nigeria,Oru Camp : Point,30,202,0,140,974,33,0,1379,38,137,0,220,1306,46,0,1747
2011,Nigeria,Ijebuode : Local Authority,11,9,0,8,22,0,0,50,9,8,0,5,57,0,0,79
2011,Nicaragua,Leon ,0,0,0,1,1,0,0,2,0,0,0,0,3,0,0,3
2011,Nicaragua,Managua : Point,2,2,0,0,31,0,0,35,0,2,0,1,34,0,0,37
2011,Nicaragua,Nandaime,0,0,0,0,1,0,0,1,0,1,0,1,3,0,0,5
2011,Nicaragua,Palacaguina,0,0,0,0,0,0,0,0,0,0,0,0,1,0,0,1
2011,Nicaragua,Rivas : Departamento,0,0,0,1,2,0,0,3,0,1,0,0,4,0,0,5
2011,Netherlands,Netherlands : Dispersed in the country / territory,0,0,0,0,0,0,3647,3647,0,0,0,0,0,0,6773,6773
2011,Norway,Norway : Dispersed in the country / territory,0,0,0,0,0,0,1248,1248,0,0,0,0,0,0,1525,1525
2011,Nepal,Beldangi 1 : Point,453,710,0,703,2992,337,0,5195,478,684,0,789,3053,433,0,5437
2011,Nepal,Beldangi 2 : Point,591,821,0,932,4292,525,0,7161,623,883,0,1043,4332,629,0,7510
2011,Nepal,Kathmandu : Point ,17,22,0,4,66,1,0,110,21,24,0,11,119,2,0,177
2011,Nepal,Khudunabari : Point,357,465,0,540,2864,304,0,4530,364,490,0,520,2731,397,0,4502
2011,Nepal,Sanischare : Point,442,645,0,712,2829,344,0,4972,426,737,0,700,2914,424,0,5201
2011,Nepal,Timai : Point,144,188,0,166,877,98,0,1473,154,195,0,183,852,135,0,1519
2011,Nepal,Nepal : Dispersed in the country / territory,2,10,0,8,46,6,408784,408856,0,12,0,7,81,7,408693,408800
2011,Nepal,Beldangi 2 Extension : Point,363,484,0,516,2480,300,0,4143,376,533,0,596,2547,357,0,4409
2011,Oman,Oman : Dispersed in the country / territory,11,8,0,9,41,2,0,71,5,8,0,7,32,3,0,55
2011,Pakistan,Azad Kashmir : Point,466,687,0,508,1338,90,0,3089,502,765,0,572,1670,189,0,3698
2011,Pakistan,Azakhel : Point,2241,2418,0,1618,3667,170,0,10114,2565,2618,0,1860,3902,339,0,11284
2011,Pakistan,Badaber : Point,2578,3393,0,2197,5251,316,0,13735,2695,3481,0,2399,5815,604,0,14994
2011,Pakistan,Baghicha : Point,60,51,0,48,103,9,0,271,60,53,0,43,105,12,0,273
2011,Pakistan,Bakka Khel : Point,56,62,0,34,102,11,0,265,66,72,0,66,155,19,0,378
2011,Pakistan,Barakai : Point,2259,3143,0,2489,5589,343,0,13823,2478,3314,0,2739,5082,657,0,14270
2011,Pakistan,Barari : Point,24,19,0,23,36,3,0,105,27,22,0,15,43,6,0,113
2011,Pakistan,Barary : Point,610,853,0,607,1457,98,0,3625,592,875,0,692,1566,165,0,3890
2011,Pakistan,Barawal : Point,4,30,0,21,47,3,0,105,2,26,0,22,59,7,0,116
2011,Pakistan,Basu Mera : Point,276,571,0,478,1074,51,0,2450,326,636,0,512,1017,131,0,2622
2011,Pakistan,Bizen Khel : Point,134,147,0,132,296,18,0,727,148,187,0,159,319,42,0,855
2011,Pakistan,Chagai : Point,8,25,0,13,35,2,0,83,23,20,0,14,40,6,0,103
2011,Pakistan,Chakdara : Point,1138,1637,0,1069,2375,131,0,6350,1223,1661,0,1209,2704,207,0,7004
2011,Pakistan,Chichana : Point,342,357,0,288,727,55,0,1769,386,351,0,350,924,123,0,2134
2011,Pakistan,Dabara : Point,166,127,0,44,118,8,0,463,264,145,0,53,193,15,0,670
2011,Pakistan,Daraban : Point,7,8,0,5,11,0,0,31,7,6,0,3,13,1,0,30
2011,Pakistan,Darsamand : Point,380,470,0,345,873,93,0,2161,432,498,0,396,967,139,0,2432
2011,Pakistan,Doaba : Point,500,530,0,441,1009,94,0,2574,559,539,0,498,1093,172,0,2861
2011,Pakistan,Dodpa : Point,0,35,0,17,41,2,0,95,0,23,0,29,49,5,0,106
2011,Pakistan,Domshivgar : Point,17,31,0,17,44,2,0,111,19,18,0,23,50,4,0,114
2011,Pakistan,Gambila : Point,126,166,0,85,252,27,0,656,176,155,0,120,291,51,0,793
2011,Pakistan,Gamkol : Point,3039,3511,0,2568,5959,368,0,15445,3122,3549,0,3078,6945,691,0,17385
2011,Pakistan,Gandaf : Point,1351,1431,0,1105,2315,196,0,6398,1439,1543,0,1157,2562,247,0,6948
2011,Pakistan,Ghazi : Point,15,23,0,3,30,2,0,73,17,25,0,8,34,5,0,89
2011,Pakistan,Ghiljo : Point,125,99,0,59,184,10,0,477,108,111,0,67,164,24,0,474
2011,Pakistan,Ghulam Banda : Point,732,905,0,699,1594,81,0,4011,784,983,0,803,1695,213,0,4478
2011,Pakistan,Girdi Jungle : Point,1990,2361,0,1395,3533,473,0,9752,2646,2487,0,2027,5019,809,0,12988
2011,Pakistan,Ichirian : Point,446,631,0,384,1046,72,0,2579,398,625,0,453,1072,122,0,2670
2011,Pakistan,Islamabad : Point,2402,3866,0,2613,7309,423,0,16613,2552,4220,0,3152,8185,845,0,18954
2011,Pakistan,Jalala : Point,1232,1599,0,1074,2654,166,0,6725,1275,1656,0,1269,2809,308,0,7317
2011,Pakistan,Jalozai : Point,2916,4097,0,1664,6416,358,0,15451,3067,5015,0,2366,6081,519,0,17048
2011,Pakistan,Jerma : Point,97,107,0,73,183,16,0,476,132,113,0,106,223,28,0,602
2011,Pakistan,Kababian : Point,1045,1270,0,838,2348,88,0,5589,1128,1290,0,957,3332,208,0,6915
2011,Pakistan,Kaghan : Point,174,263,0,131,360,25,0,953,196,263,0,167,352,32,0,1010
2011,Pakistan,Kalatak : Point,125,162,0,114,261,18,0,680,158,200,0,157,352,29,0,896
2011,Pakistan,Karachi : Point,1,7,0,10,35,1,0,54,2,6,0,13,52,0,0,73
2011,Pakistan,Kata Kanri : Point,515,670,0,502,1048,105,0,2840,538,724,0,519,1121,150,0,3052
2011,Pakistan,Kesu : Point,91,102,0,87,189,7,0,476,104,151,0,104,224,17,0,600
2011,Pakistan,Khaki : Point,1325,1893,0,1226,3001,224,0,7669,1394,1903,0,1464,2971,367,0,8099
2011,Pakistan,Khazana : Point,559,698,0,484,1115,79,0,2935,545,700,0,608,1329,127,0,3309
2011,Pakistan,Kheshki : Point,53,48,0,39,90,5,0,235,40,65,0,42,98,13,0,258
2011,Pakistan,Khoughani : Point,144,147,0,118,292,14,0,715,132,148,0,149,298,26,0,753
2011,Pakistan,Khurasan : Point,306,395,0,309,914,70,0,1994,310,379,0,312,1005,93,0,2099
2011,Pakistan,Khyber Pakhtunkhwa,39139,53173,0,38197,111508,6523,0,248540,41767,56693,0,44187,123473,11876,0,277996
2011,Pakistan,Koga : Point,970,1030,0,736,1723,95,0,4554,994,1063,0,867,1572,166,0,4662
2011,Pakistan,Kot Chandna : Point,1342,1750,0,1295,2887,152,0,7426,1406,1756,0,1360,2840,312,0,7674
2011,Pakistan,Kotkai : Point,285,331,0,275,615,90,0,1596,305,408,0,305,627,113,0,1758
2011,Pakistan,Kotwai : Point,481,725,0,500,1075,84,0,2865,517,765,0,494,895,179,0,2850
2011,Pakistan,Lakti Banda : Point,603,720,0,561,1226,162,0,3272,639,788,0,604,1207,238,0,3476
2011,Pakistan,Lejay Karez : Point,61,68,0,57,139,9,0,334,81,57,0,96,202,44,0,480
2011,Pakistan,Malgagai : Point,640,609,0,503,1113,124,0,2989,661,680,0,572,1265,215,0,3393
2011,Pakistan,Mayar : Point,208,243,0,187,357,37,0,1032,244,230,0,188,446,64,0,1172
2011,Pakistan,Mera Kachori : Point,471,573,0,407,983,72,0,2506,437,585,0,429,996,121,0,2568
2011,Pakistan,Munda : Point,956,1291,0,839,1921,117,0,5124,1004,1258,0,922,1791,242,0,5217
2011,Pakistan,Nagar : Point,34,30,0,16,45,2,0,127,31,38,0,16,69,3,0,157
2011,Pakistan,Naguman : Point,265,443,0,252,623,35,0,1618,269,418,0,338,666,75,0,1766
2011,Pakistan,Naurang : Point,92,133,0,115,237,20,0,597,102,156,0,105,264,37,0,664
2011,Pakistan,New Akora : Point,71,18,0,7,42,2,0,140,68,18,0,22,148,7,0,263
2011,Pakistan,New Durrani,994,1639,0,645,2846,243,0,6367,1136,2404,0,1440,2792,258,0,8030
2011,Pakistan,Oblan : Point,873,1079,0,789,1716,141,0,4598,926,1108,0,898,1720,224,0,4876
2011,Pakistan,Old Akora : Point,3813,4050,0,2887,7046,261,0,18057,3939,4374,0,3354,7202,810,0,19679
2011,Pakistan,Padhana : Point,676,1254,0,831,1971,124,0,4856,676,1306,0,919,2056,262,0,5219
2011,Pakistan,Panian : Point,4055,7934,0,4124,12101,734,0,28948,4384,8247,0,4529,11284,1427,0,29871
2011,Pakistan,Peshawar : Point,0,2,0,2,2,0,0,6,0,1,0,2,7,0,0,10
2011,Pakistan,Pir Alizai : Point,1052,1260,0,700,1641,98,0,4751,1012,1320,0,859,2031,270,0,5492
2011,Pakistan,Posti : Point,22,18,0,14,29,2,0,85,15,26,0,12,32,6,0,91
2011,Pakistan,Punjab : Province,12663,18726,0,12420,33076,2081,0,78966,13468,20064,0,15324,40576,4010,0,93442
2011,Pakistan,Pusha Pul : Point,78,93,0,44,104,9,0,328,73,87,0,94,174,28,0,456
2011,Pakistan,Quetta : Point,0,2,0,4,15,0,0,21,0,2,0,1,19,0,0,22
2011,Pakistan,Rakh Zandani : Point,0,1,0,0,1,0,0,2,1,1,0,2,4,0,0,8
2011,Pakistan,Rata Kulachi : Point,29,57,0,24,66,6,0,182,28,53,0,53,91,14,0,239
2011,Pakistan,Saranan : Point,1992,2440,0,1771,4136,233,0,10572,2080,2462,0,2055,4119,639,0,11355
2011,Pakistan,Shaikh Abad : Point,494,690,0,490,1070,83,0,2827,465,707,0,512,1156,111,0,2951
2011,Pakistan,Shindand : Point,167,202,0,158,288,20,0,835,151,200,0,172,315,36,0,874
2011,Pakistan,Sind : Province,5333,7094,0,5408,14417,757,0,33009,5617,7452,0,6642,16808,1751,0,38270
2011,Pakistan,Sund Rawal : Point,2,42,0,23,44,5,0,116,0,45,0,35,71,9,0,160
2011,Pakistan,Surkhab : Point,622,837,0,519,1403,88,0,3469,647,905,0,647,1517,237,0,3953
2011,Pakistan,Thall : Point,1132,1432,0,1124,2580,261,0,6529,1264,1523,0,1316,2405,431,0,6939
2011,Pakistan,Timer : Point,862,1439,0,925,2144,112,0,5482,879,1471,0,1025,2083,221,0,5679
2011,Pakistan,Togh Sarai,530,651,0,356,1131,102,0,2770,618,827,0,315,1011,94,0,2865
2011,Pakistan,Toor : Point,583,703,0,481,1071,76,0,2914,660,720,0,536,1161,134,0,3211
2011,Pakistan,Urguch : Point,1,7,0,5,9,0,0,22,4,4,0,3,21,0,0,32
2011,Pakistan,Utmanzai : Point,287,529,0,321,724,50,0,1911,348,536,0,340,752,115,0,2091
2011,Pakistan,Yakaghund : Point,310,308,0,177,373,24,0,1192,307,294,0,189,376,40,0,1206
2011,Pakistan,Zafarabad : Point,286,344,0,209,449,24,0,1312,322,358,0,294,578,83,0,1635
2011,Pakistan,Zangal Patai : Point,3,16,0,8,40,3,0,70,3,20,0,17,36,3,0,79
2011,Pakistan,Zar Karez : Point,350,545,0,307,782,58,0,2042,376,565,0,402,808,120,0,2271
2011,Pakistan,Pakistan : Dispersed in the country / territory,38,144,0,161,477,25,0,845,35,176,0,190,278,19,0,698
2011,Pakistan,Old Shamshatoo : Point,4657,5699,0,4255,10982,498,0,26091,4845,6152,0,4884,11444,1086,0,28411
2011,Pakistan,Mohammad Kheil : Point,388,686,0,283,1103,34,0,2494,398,761,0,423,1076,142,0,2800
2011,Pakistan,Kund/Khairabad : Point,1353,1586,0,933,2259,190,0,6321,1395,1619,0,1059,2232,295,0,6600
2011,Pakistan,Ghazgai Minara : Point,144,223,0,112,307,26,0,812,156,258,0,173,345,54,0,986
2011,Pakistan,Gandhi Khan Khel : Point,251,327,0,211,541,35,0,1365,303,320,0,220,487,78,0,1408
2011,Pakistan,Balochistan : Province,18062,29818,0,18829,50262,3713,0,120684,18764,31877,0,23479,55783,7877,0,137780
2011,Panama,Darien : Provincia,68,71,0,70,149,14,0,372,68,57,0,60,161,25,0,371
2011,Panama,Kuna Yala : Point,5,13,0,16,25,1,0,60,4,12,0,14,29,1,0,60
2011,Panama,Panama : Distrito,274,750,0,2101,3357,863,0,7345,265,827,0,2613,5170,976,0,9851
2011,Peru,Peru : Dispersed in the country / territory,6,25,0,60,455,38,0,584,11,45,0,61,831,106,0,1054
2011,Philippines,Region VI (Western Visayas) : Region,0,0,0,0,0,0,0,0,0,0,0,0,2,0,0,2
2011,Philippines,Region IV-B (Mimaropa) : Region,0,0,0,0,0,0,0,0,0,0,0,0,1,0,0,1
2011,Philippines,Region IV-A (Calabarzon) : Region,2,2,0,2,6,1,0,13,2,3,0,0,8,3,0,16
2011,Philippines,Region III (Central Luzon) : Region,0,0,0,0,0,0,0,0,0,0,0,0,1,0,0,1
2011,Philippines,Region I (Ilocos region) : Region,0,0,0,0,0,0,0,0,0,0,0,0,2,0,0,2
2011,Philippines,National Capital region (NCR) : Region,0,3,0,2,14,0,16,35,0,0,0,1,126,2,52,181
2011,Palau,Koror,0,0,0,0,0,0,0,0,0,0,0,0,2,0,0,2
2011,Papua New Guinea,Port Moresby : Point,1,0,0,0,1,0,0,2,0,0,0,0,7,0,0,7
2011,Papua New Guinea,Papua New Guinea : Dispersed in the country / territory,0,0,0,0,0,0,0,0,0,0,0,0,1,0,0,1
2011,Papua New Guinea,East Awin : Point,134,200,0,169,585,43,0,1131,135,230,0,195,627,48,0,1235
2011,Poland,Bialystok : Point,18,13,0,12,26,1,0,70,16,20,0,10,20,1,0,67
2011,Poland,Czerwony Bor : Point,10,21,0,3,24,0,0,58,23,12,0,1,25,0,0,61
2011,Poland,Debak : Point,9,8,0,5,26,2,0,50,10,11,0,6,70,4,0,101
2011,Poland,Grotniki : Point,18,13,0,7,25,1,0,64,14,8,0,1,35,0,0,58
2011,Poland,Grupa : Point,8,16,0,10,30,1,0,65,13,13,0,9,36,0,0,71
2011,Poland,Horbow : Point,21,14,0,2,33,0,0,70,12,16,0,5,31,0,0,64
2011,Poland,Linin : Point,15,8,0,7,21,1,0,52,12,16,0,6,19,0,0,53
2011,Poland,Lublin : Point,12,16,0,5,30,0,0,63,18,11,0,7,35,1,0,72
2011,Poland,Lukow : Point,13,11,0,7,24,0,0,55,15,18,0,13,23,0,0,69
2011,Poland,Moszna : Point,14,9,0,10,34,0,0,67,17,14,0,9,27,1,0,68
2011,Poland,Warszawa : Powiat - County,13,18,0,5,50,4,0,90,6,12,0,8,0,0,0,26
2011,Poland,Biala Podlaskae : Powiat - County,8,12,0,10,31,4,0,65,6,17,0,4,41,2,0,70
2011,Paraguay,Asuncion : Point,2,6,0,4,37,2,0,51,2,2,0,5,72,1,0,82
2011,Qatar,Qatar : Dispersed in the country / territory,10,4,0,7,43,3,0,67,8,3,0,8,35,8,0,62
2011,Romania,Otopeni,0,0,0,0,0,0,0,0,0,0,0,0,123,0,0,123
2011,Russian Federation,Sankt-peterburg : Oblast - Region,1,0,0,3,0,0,0,4,0,1,0,2,19,0,0,22
2011,Russian Federation,Moskva : Oblast - Region,2,1,0,4,19,0,0,26,2,1,0,24,1,0,0,28
2011,Rwanda,Bugesera : Point,45,32,0,11,76,3,0,167,42,26,0,8,27,1,0,104
2011,Rwanda,Burera : Point,12,6,0,3,26,1,0,48,12,2,0,1,10,1,0,26
2011,Rwanda,Gakenke : Point,17,8,0,2,29,1,0,57,13,9,0,2,6,1,0,31
2011,Rwanda,Gasabo : Point,16,6,0,4,31,0,0,57,13,13,0,7,15,3,0,51
2011,Rwanda,Gatsibo : Point,1030,2114,0,1322,3547,206,0,8219,1043,2054,0,1299,2078,149,0,6623
2011,Rwanda,Gicumbi : Point,14,7,0,3,22,1,0,47,6,10,0,2,5,0,0,23
2011,Rwanda,Gihembe : Point,1023,2259,0,1830,5171,471,0,10754,1046,2237,0,1726,3797,267,0,9073
2011,Rwanda,Gisagara : Point,14,5,0,7,30,0,0,56,13,7,0,4,18,1,0,43
2011,Rwanda,Huye : Commune,24,14,0,7,65,3,0,113,27,18,0,7,13,3,0,68
2011,Rwanda,Kamonyi : Point,11,12,0,5,24,1,0,53,11,10,0,3,8,0,0,32
2011,Rwanda,Karongi : Point,127,88,0,36,299,12,0,562,112,77,0,32,62,8,0,291
2011,Rwanda,Kayonza : Commune,3,2,0,2,4,0,0,11,4,0,0,0,8,0,0,12
2011,Rwanda,Kicukiro : Commune,10,8,0,2,18,2,0,40,12,5,0,3,12,1,0,33
2011,Rwanda,Kirehe : Point,11,6,0,5,22,0,0,44,10,6,0,4,20,0,0,40
2011,Rwanda,Kiziba : Point,1280,2046,0,1807,4841,466,0,10440,1077,1972,0,1711,3346,373,0,8479
2011,Rwanda,Muhanga : Point,11,10,0,2,35,0,0,58,6,5,0,4,16,0,0,31
2011,Rwanda,Musanze : Point,64,34,0,16,131,4,0,249,68,31,0,9,58,3,0,169
2011,Rwanda,Ngoma : Commune,14,5,0,0,30,0,0,49,13,7,0,0,10,0,0,30
2011,Rwanda,Ngororero : Point,56,33,0,15,132,9,0,245,64,25,0,19,42,3,0,153
2011,Rwanda,Nyabihu : Point,122,72,0,25,278,13,0,510,119,47,0,21,86,8,0,281
2011,Rwanda,Nyamagabe : Commune,40,16,0,15,83,4,0,158,34,17,0,5,14,3,0,73
2011,Rwanda,Nyamasheke : Point,96,98,0,26,219,4,0,443,105,68,0,32,53,12,0,270
2011,Rwanda,Nyanza : Point,25,17,0,8,55,2,0,107,18,13,0,2,18,1,0,52
2011,Rwanda,Nyarugenge : Commune,23,7,0,6,42,0,0,78,18,8,0,4,15,0,0,45
2011,Rwanda,Nyaruguru : Point,41,36,0,10,75,1,0,163,43,26,0,9,13,1,0,92
2011,Rwanda,Rubavu : Commune,127,93,0,39,260,22,0,541,118,67,0,23,108,8,0,324
2011,Rwanda,Ruhango : Point,30,20,0,8,58,0,0,116,19,14,0,10,16,1,0,60
2011,Rwanda,Rulindo : Point,16,11,0,2,30,2,0,61,15,3,0,4,12,1,0,35
2011,Rwanda,Rusizi : Point,67,44,0,25,126,7,0,269,73,41,0,18,50,6,0,188
2011,Rwanda,Rutsiro : Commune,98,41,0,12,187,8,0,346,71,44,0,27,87,4,0,233
2011,Rwanda,Rwamagana : Point,13,7,0,1,15,1,0,37,8,5,0,5,14,1,0,33
2011,Rwanda,Nyagatare (Cyangugu) : Point,4,2,0,3,8,0,0,17,4,1,0,0,2,0,0,7
2011,Rwanda,Kigali-ngali : Prefecture,138,236,0,184,498,7,0,1063,129,210,0,192,454,13,0,998
2011,Saudi Arabia,Arar : Point,0,0,0,0,0,0,0,0,0,0,0,0,2,0,0,2
2011,Saudi Arabia,Jeddah : Point,5,21,0,26,39,4,0,95,6,24,0,18,56,5,0,109
2011,Saudi Arabia,Khobar : Point,0,0,0,0,2,0,0,2,0,0,0,1,11,0,0,12
2011,Saudi Arabia,Riyadh : Point,7,40,0,30,101,4,0,182,9,38,0,49,159,7,0,262
2011,Saudi Arabia,Madinah : Emirate - Region,0,2,0,0,1,0,0,3,0,0,0,0,3,0,0,3
2011,Saudi Arabia,Al-Qateef : Point,0,2,0,1,1,0,0,4,0,0,0,4,1,0,0,5
2011,Sudan,Abu Rakham area : Point,20,33,0,38,87,9,0,187,18,37,0,42,79,20,0,196
2011,Sudan,Abuda : Point,176,269,0,218,681,61,0,1405,163,280,0,226,565,84,0,1318
2011,Sudan,Armankul : Point,0,0,0,0,0,0,1150,1150,0,0,0,0,0,0,1150,1150
2011,Sudan,Aroma : Point,2,0,0,1,3,0,0,6,0,1,0,2,4,1,0,8
2011,Sudan,Asotriba : Point,0,0,0,0,0,0,0,0,0,0,0,0,3,0,0,3
2011,Sudan,Awad El Seid : Point,31,52,0,35,164,13,0,295,42,57,0,51,128,32,0,310
2011,Sudan,BASONDA,0,0,0,0,1,0,0,1,2,0,0,0,0,0,0,2
2011,Sudan,Bir Khadija : Point,0,0,0,0,0,0,100,100,0,0,0,0,0,0,100,100
2011,Sudan,Bir Touk : Point,0,0,0,0,0,0,125,125,0,0,0,0,0,0,125,125
2011,Sudan,Dabag,0,0,0,0,0,0,75,75,0,0,0,0,0,0,75,75
2011,Sudan,DAIM,0,1,0,1,1,0,0,3,0,2,0,1,6,0,0,9
2011,Sudan,DEHAMA,0,0,0,0,0,0,0,0,0,0,0,0,2,0,0,2
2011,Sudan,Diam El-Nour : Point,17,27,0,30,106,2,0,182,18,27,0,25,221,9,0,300
2011,Sudan,Doka : Point,0,0,0,2,2,0,0,4,0,1,0,0,0,1,0,2
2011,Sudan,DORDEAB,1,2,0,3,4,0,0,10,1,0,0,0,2,0,0,3
2011,Sudan,El Fasher : Point,0,0,0,0,0,0,0,0,0,0,0,0,78,0,0,78
2011,Sudan,El Geneina : Point,0,0,0,0,0,0,0,0,0,0,0,0,28,0,0,28
2011,Sudan,Es Showak : Point,3,4,0,3,13,1,0,24,2,5,0,6,13,1,0,27
2011,Sudan,Fath El Rahman : Point,13,24,0,28,86,16,0,167,16,24,0,22,69,23,0,154
2011,Sudan,Fau 5 : Point,55,81,0,45,227,22,0,430,65,87,0,47,218,34,0,451
2011,Sudan,Fau Town : Point,0,1,0,0,1,0,0,2,1,2,0,0,0,0,0,3
2011,Sudan,GARADF,0,0,0,0,0,0,0,0,0,1,0,0,0,0,0,1
2011,Sudan,Gari,0,0,0,0,0,0,75,75,0,0,0,0,0,0,75,75
2011,Sudan,Gedaref : Point,57,106,0,98,262,9,0,532,89,111,0,114,370,21,0,705
2011,Sudan,Gelu,0,0,0,0,0,0,75,75,0,0,0,0,0,0,75,75
2011,Sudan,GEREF,2,4,0,3,11,0,0,20,2,1,0,6,17,1,0,27
2011,Sudan,Girba : Point,373,489,0,404,1562,148,0,2976,407,519,0,450,1020,222,0,2618
2011,Sudan,Gulsa : Point,2,8,0,7,19,1,0,37,2,2,0,8,4,3,0,19
2011,Sudan,Habillah : Region,0,0,0,0,0,0,7500,7500,0,0,0,0,0,0,7500,7500
2011,Sudan,Hawata : Point,5,0,0,0,4,0,0,9,0,2,0,0,0,0,0,2
2011,Sudan,KALAKLA,0,0,0,0,4,0,0,4,0,0,0,0,2,0,0,2
2011,Sudan,Karkora : Point,0,0,0,5,4,2,0,11,0,1,0,2,6,1,0,10
2011,Sudan,Kassala : Point,267,346,0,338,1245,68,0,2264,267,395,0,370,1519,95,0,2646
2011,Sudan,Khartoum Camp : Point,0,0,0,0,2,0,0,2,0,0,0,1,4,0,0,5
2011,Sudan,Khartoum Urban : Point,138,559,0,654,3433,138,0,4922,139,560,0,703,4127,215,0,5744
2011,Sudan,Kilo 26 : Point,479,692,0,578,2048,192,0,3989,524,696,0,635,1506,284,0,3645
2011,Sudan,Kilo 7 : Point,20,34,0,17,122,12,0,205,30,37,0,30,109,22,0,228
2011,Sudan,Kolain,0,0,0,0,0,0,75,75,0,0,0,0,0,0,75,75
2011,Sudan,Kosti,0,0,0,0,0,0,12500,12500,0,0,0,0,0,0,12500,12500
2011,Sudan,Laffa-Gulsa : Point,1,0,0,0,4,0,0,5,0,1,0,0,0,0,0,1
2011,Sudan,Mafaza : Point,0,0,0,0,1,0,0,1,0,0,0,0,0,0,0,0
2011,Sudan,Marghania : Point,8,9,0,4,39,0,0,60,5,9,0,11,77,1,0,103
2011,Sudan,Mukjar : Point,78,112,0,53,146,18,0,407,77,96,0,58,125,14,0,370
2011,Sudan,New Halfa : Point,8,9,0,5,65,0,0,87,11,14,0,12,741,6,0,784
2011,Sudan,Nyala : Region,0,0,0,0,2,0,0,2,1,1,0,0,24,0,0,26
2011,Sudan,Port Sudan : Region,53,103,0,71,234,9,0,470,69,84,0,76,442,8,0,679
2011,Sudan,SAFAWA,0,0,0,1,3,0,0,4,0,0,0,0,0,0,0,0
2011,Sudan,Salalab : Point,23,39,0,32,116,2,0,212,19,44,0,35,158,8,0,264
2011,Sudan,Salmin : Point,1,0,0,0,1,0,0,2,0,1,0,0,1,0,0,2
2011,Sudan,Shagarab 1 : Point,1034,1349,0,823,3252,243,0,6701,1085,1415,0,916,2577,375,0,6368
2011,Sudan,Shagarab 2 : Point,759,1062,0,638,2150,152,0,4761,791,1135,0,668,1420,254,0,4268
2011,Sudan,Shagarab 3 : Point,453,626,0,402,1523,118,0,3122,447,604,0,385,948,205,0,2589
2011,Sudan,Sinkat : Region,0,0,0,0,0,0,0,0,0,0,0,0,1,0,0,1
2011,Sudan,Suwakin : Point,6,5,0,3,10,0,0,24,3,2,0,1,40,0,0,46
2011,Sudan,Tendelti : Point,0,0,0,0,0,0,1250,1250,0,0,0,0,0,0,1250,1250
2011,Sudan,Tokar : Region,0,0,0,0,0,0,0,0,0,0,0,0,1,0,0,1
2011,Sudan,Um Ali : Point,4,15,0,4,11,0,0,34,3,6,0,6,4,3,0,22
2011,Sudan,Um Dafog : Point,0,0,0,0,0,0,813,813,0,0,0,0,0,0,713,713
2011,Sudan,Um Dukhun : Point,0,0,0,0,0,0,300,300,0,0,0,0,0,0,300,300
2011,Sudan,Um Gargur : Point,486,776,0,652,2102,216,0,4232,527,851,0,761,1823,356,0,4318
2011,Sudan,Um Gulja : Point,7,6,0,5,27,2,0,47,9,7,0,10,31,4,0,61
2011,Sudan,Um Rakuba : Point,0,6,0,1,3,0,0,10,2,2,0,2,7,2,0,15
2011,Sudan,Um Shalaya : Point,778,925,0,437,1684,289,0,4113,711,831,0,510,938,147,0,3137
2011,Sudan,Wad El Hileau : Point,26,35,0,25,64,10,0,160,16,35,0,17,63,8,0,139
2011,Sudan,Wad Medani : Point,0,1,0,0,1,0,0,2,1,1,0,0,0,1,0,3
2011,Sudan,Wad Sherife : Point,1066,1316,0,1308,4503,490,0,8683,1124,1374,0,1287,2506,507,0,6798
2011,Sudan,White Nile : Wilayat - State,0,0,0,0,0,0,2880,2880,0,0,0,0,0,0,2880,2880
2011,Sudan,Western Darfur : Wilayat - State,0,0,0,0,0,0,404018,404018,0,0,0,0,0,0,404018,404018
2011,Sudan,Sudan : Dispersed in the country / territory,34,85,0,75,242,22,0,458,53,88,0,86,90,13,0,330
2011,Sudan,Southern Kordofan : Wilayat - State,0,0,0,0,0,0,25000,25000,0,0,0,0,0,0,25000,25000
2011,Sudan,Southern Darfur : Wilayat - State,0,0,0,0,0,0,394686,394686,0,0,0,0,0,0,394686,394686
2011,Sudan,Red Sea : Wilayat - State,0,0,0,0,0,0,4500,4500,0,0,0,0,0,0,4500,4500
2011,Sudan,Northern Darfur : Wilayat - State,0,0,0,0,0,0,281939,281939,0,0,0,0,0,0,281938,281938
2011,Sudan,Northern and Western Darfur,0,0,0,0,0,0,8000,8000,0,0,0,0,0,0,8000,8000
2011,Sudan,Khartoum : Wilayat - State,23,12,0,21,56,0,217533,217645,14,22,0,13,68,2,217532,217651
2011,Sudan,Kassala : Wilayat - State,0,0,0,0,0,0,3625,3625,0,0,0,0,0,0,3625,3625
2011,Sudan,Gadaref : Wilayat - State,0,0,0,0,0,0,6225,6225,0,0,0,0,0,0,6225,6225
2011,Sudan,Bir Saleeba area : Point,0,0,0,0,0,0,1500,1500,0,0,0,0,0,0,1500,1500
2011,Senegal,Dakar : Point,83,120,0,117,970,23,0,1313,91,158,0,128,2094,35,0,2506
2011,Senegal,Dakar/Thies : Point,6,17,0,16,29,1,0,69,10,25,0,20,58,3,0,116
2011,Senegal,Richard Toll : Point,2011,2423,0,1125,4101,405,0,10065,2055,2278,0,1060,3075,340,0,8808
2011,Senegal,Saint Louis,1,2,0,0,9,0,0,12,3,1,0,0,13,1,0,18
2011,Singapore,Singapore : Dispersed in the country / territory,0,0,0,0,1,0,0,1,0,0,0,0,2,0,0,2
2011,Sierra Leone,Bandajuma : Point,4,29,0,18,63,1,0,115,9,28,0,24,62,8,0,131
2011,Sierra Leone,Bo : Point,1,33,0,48,248,10,0,340,3,29,0,50,178,10,0,270
2011,Sierra Leone,Freetown : Point,13,102,0,155,608,18,0,896,15,137,0,150,607,19,0,928
2011,Sierra Leone,Gerihun : Point,5,39,0,33,77,5,0,159,6,27,0,123,123,6,0,285
2011,Sierra Leone,Gondama : Point,11,169,0,96,272,2,0,550,17,135,0,90,285,7,0,534
2011,Sierra Leone,Jembe : Point,2,43,0,31,77,2,0,155,3,42,0,38,109,3,0,195
2011,Sierra Leone,Kenema : Point,13,182,0,146,600,91,0,1032,29,175,0,160,590,41,0,995
2011,Sierra Leone,Largo : Point,3,90,0,35,90,5,0,223,6,45,0,29,17,6,0,103
2011,Sierra Leone,Taiama : Point,9,94,0,44,149,5,0,301,11,97,0,120,226,20,0,474
2011,Sierra Leone,Tobanda : Point,8,53,0,45,134,6,0,246,7,57,0,27,126,7,0,224
2011,El Salvador,San Salvador : Point,0,2,0,0,1,1,0,4,0,0,0,2,8,0,0,10
2011,El Salvador,La Union : Departamento ,0,0,0,0,7,0,0,7,0,0,0,0,16,3,0,19
2011,El Salvador,Cuscatlan : Departamento ,0,0,0,0,1,0,0,1,0,1,0,0,1,0,0,2
2011,Somalia,Awdal : Gobolka - Region,922,860,0,553,1598,123,0,4056,860,923,0,553,1475,123,0,3934
2011,Somalia,Bakool : Gobolka - Region,2769,2583,0,1662,4800,370,0,12184,2584,2770,0,1662,4430,370,0,11816
2011,Somalia,Banadir : District,21278,19847,0,12770,36878,2840,0,93613,19854,21282,0,12770,34038,2843,0,90787
2011,Somalia,Bay : Gobolka - Region,4595,4286,0,2758,7963,614,0,20216,4287,4595,0,2758,7350,614,0,19604
2011,Somalia,Galgaduud : Gobolka - Region,17211,16053,0,10327,29828,2299,0,75718,16058,17214,0,10330,27531,2299,0,73432
2011,Somalia,Gedo : Gobolka - Region,8829,8235,0,5298,15300,1179,0,38841,8238,8830,0,5298,14123,1180,0,37669
2011,Somalia,Hargeisa : Point,298,318,0,132,841,4,240,1833,247,348,0,128,987,22,176,1908
2011,Somalia,Hiraan : Gobolka - Region,5903,5506,0,3542,10231,789,0,25971,5508,5906,0,3542,9444,789,0,25189
2011,Somalia,Juba Dhexe : Gobolka - Region,3116,2905,0,1869,5400,416,0,13706,2907,3116,0,1869,4984,418,0,13294
2011,Somalia,Juba Hoose : Gobolka - Region,3531,3293,0,2119,6120,473,0,15536,3295,3531,0,2119,5648,471,0,15064
2011,Somalia,Nugaal : Gobolka - Region,1096,1022,0,658,1899,146,0,4821,1022,1096,0,658,1752,146,0,4674
2011,Somalia,Sanaag : Gobolka - Region,105,98,0,63,182,14,0,462,98,105,0,63,168,14,0,448
2011,Somalia,Shabelle Dhexe : Gobolka - Region,5996,5592,0,3598,10392,801,0,26379,5594,5997,0,3598,9591,801,0,25581
2011,Somalia,Shabelle Hoose : Gobolka - Region,57248,53396,0,34355,99216,7645,0,251860,53415,57256,0,34355,91576,7648,0,244250
2011,Somalia,Sool : Gobolka - Region,556,519,0,334,964,74,0,2447,519,556,0,334,889,75,0,2373
2011,Somalia,Togdheer : Gobolka - Region,2972,2773,0,1783,5154,397,0,13079,2773,2973,0,1783,4755,397,0,12681
2011,Somalia,Woqooyi Galbeed : Gobolka - Region,5145,4799,0,3088,8917,687,0,22636,4800,5147,0,3087,8232,688,0,21954
2011,Somalia,Mudug : Gobolka - Region,9676,9037,0,5796,16817,1290,0,42616,9041,9684,0,5795,15549,1299,0,41368
2011,Somalia,Bari : Gobolka - Region,5952,5609,0,3535,10705,787,0,26588,5578,5984,0,3540,10601,802,0,26505
2011,Serbia and Kosovo (S/RES/1244 (1999)),Vojvodina : Region,0,633,0,1507,12240,8687,0,23067,0,717,0,1653,14480,5182,0,22032
2011,Serbia and Kosovo (S/RES/1244 (1999)),Serbia : Dispersed in the country / territory,1898,1861,0,1901,5277,1488,0,12425,1958,1911,0,1951,6546,1442,0,13808
2011,Serbia and Kosovo (S/RES/1244 (1999)),Central serbia,4,5,0,5,35,1,0,50,7,31,0,13,289,0,0,340
2011,Serbia and Kosovo (S/RES/1244 (1999)),Central and Southern Serbia,5,4824,0,7151,41722,15684,0,69386,6,5165,0,7487,42423,12406,0,67487
2011,Serbia and Kosovo (S/RES/1244 (1999)),Belgrade : Point,30,2999,0,4793,29142,13448,0,50412,17,3173,0,5207,30680,9246,0,48323
2011,South Sudan,"Andari, WES",26,29,0,8,94,9,0,166,38,31,0,3,69,6,0,147
2011,South Sudan,Cueibet,1,3,0,0,1,0,0,5,0,0,0,0,0,0,0,0
2011,South Sudan,"Ezo, Wes : Point",302,306,0,162,924,82,0,1776,332,286,0,156,782,63,0,1619
2011,South Sudan,"Gorom, CES",103,104,0,33,215,3,0,458,115,98,0,32,404,2,0,651
2011,South Sudan,Juba : Point,101,72,0,24,245,6,0,448,90,80,0,23,867,15,0,1075
2011,South Sudan,"Kajo Keji, CES",21,63,0,0,63,2,0,149,29,54,0,0,42,4,0,129
2011,South Sudan,"Lainya, CES",4,6,0,0,8,0,0,18,0,6,0,0,2,1,0,9
2011,South Sudan,"Lasu, CES",880,959,0,560,1681,157,0,4237,847,918,0,572,1238,88,0,3663
2011,South Sudan,"Magwi, EES",51,51,0,0,148,5,0,255,60,52,0,0,94,5,0,211
2011,South Sudan,"Makpandu, WES",474,385,0,218,1308,73,0,2458,431,391,0,205,1836,87,0,2950
2011,South Sudan,Malakal : Point,43,18,0,6,72,3,0,142,45,22,0,4,141,5,0,217
2011,South Sudan,"Maridi, WES",0,0,0,0,0,1,0,1,1,0,0,0,1,0,0,2
2011,South Sudan,"Morobo, CES",1,3,0,0,2,0,0,6,0,2,0,0,1,0,0,3
2011,South Sudan,"Mundri, WES",0,2,0,0,2,0,0,4,1,1,0,0,4,0,0,6
2011,South Sudan,"Naandi, WES",23,26,0,5,53,3,0,110,25,20,0,15,55,6,0,121
2011,South Sudan,Pochalla : Point,352,505,0,261,866,53,0,2037,361,522,0,255,293,31,0,1462
2011,South Sudan,"Source Yubu, WES",39,42,0,17,116,3,0,217,51,44,0,22,62,8,0,187
2011,South Sudan,"Torit, EES",0,1,0,0,1,0,0,2,2,1,0,0,0,0,0,3
2011,South Sudan,"Yambio, WES",0,0,0,0,0,0,0,0,0,0,0,0,1,0,0,1
2011,South Sudan,Yei : Point,2,15,0,0,9,3,0,29,4,12,0,0,7,0,0,23
2011,South Sudan,"Yida, Unity State",1658,2514,0,1843,3509,173,0,9697,2037,3172,0,2265,3969,186,0,11629
2011,South Sudan,Western Equatoria : Wilayat - State,502,503,0,281,1193,94,0,2573,494,485,0,280,1159,74,0,2492
2011,South Sudan,Twic East Jonglei State,0,1,0,0,1,0,0,2,1,1,0,0,0,0,0,2
2011,South Sudan,"Tambura, Wes : Point",71,51,0,15,125,1,0,263,59,61,0,16,96,0,0,232
2011,South Sudan,"South Bor, Jonglei State",0,3,0,0,2,1,0,6,1,3,0,0,0,2,0,6
2011,South Sudan,"Jammam, Upper Nile State",323,490,0,359,684,34,0,1890,397,618,0,441,773,37,0,2266
2011,South Sudan,"El Foj, Upper Nile State",1555,2358,0,1729,3291,162,0,9095,1911,2975,0,2124,3722,173,0,10905
2011,South Sudan,"Duk, Jonglei State",1,1,0,0,1,2,0,5,1,0,0,0,0,0,0,1
2011,South Sudan,"Doro, Upper Nile State",2232,3384,0,2481,4724,233,0,13054,2743,4720,0,3049,4893,250,0,15655
2011,South Sudan,"Darjo, Upper Nile State",90,137,0,100,191,9,0,527,111,172,0,123,216,10,0,632
2011,Suriname,Suriname : Dispersed in the country / territory,0,0,0,0,1,0,0,1,0,0,0,0,2,0,0,2
2011,Slovakia,Bratislava : Kraje - Region,9,0,0,5,21,0,0,35,8,0,0,3,197,0,0,208
2011,Slovakia,Humenne,0,0,0,0,0,0,0,0,0,0,0,2,28,0,0,30
2011,Slovakia,Humenne ETC,0,4,0,5,12,3,0,24,3,4,0,3,11,1,0,22
2011,Slovakia,Kosice : Point,5,5,0,0,12,0,0,22,2,1,0,1,38,1,0,43
2011,Slovakia,Medvedov : Point,0,0,0,0,0,0,0,0,0,0,0,0,7,0,0,7
2011,Slovakia,Opatovska : Point,1,2,0,2,10,0,0,15,5,2,0,6,7,0,0,20
2011,Slovakia,Rohovce : Point,0,0,0,0,0,0,0,0,0,0,0,2,54,0,0,56
2011,Slovakia,Secovce : Point,0,0,0,0,0,0,0,0,0,0,0,0,1,0,0,1
2011,Slovakia,Trencin : Kraje - Region,0,0,0,0,0,0,0,0,0,0,0,0,3,0,0,3
2011,Slovakia,Trnava : Kraje - Region,0,2,0,0,3,0,0,5,0,0,0,0,14,0,0,14
2011,Slovakia,Zvolen : Okresy,0,0,0,1,1,0,0,2,0,0,0,0,4,0,0,4
2011,Slovenia,Ljubljana : Point,0,0,0,0,20,0,0,20,0,0,0,10,70,0,0,80
2011,Sweden,Sweden : Dispersed in the country / territory,0,0,0,0,0,0,4241,4241,0,0,0,0,0,0,6103,6103
2011,Sint Maarten (Dutch part),Philipsburg : Point,0,0,0,0,1,0,0,1,0,0,0,1,1,0,0,2
2011,Syrian Arab Rep.,Al Hol : Point,11,8,0,15,38,6,0,78,14,6,0,7,71,6,0,104
2011,Syrian Arab Rep.,Damascus : Point,3225,6190,0,5540,22904,3294,0,41153,3460,6612,0,5756,19893,3431,0,39152
2011,Syrian Arab Rep.,Tartous : Mohafazat - Governorates,29,54,0,73,213,20,0,389,27,66,0,73,168,30,0,364
2011,Syrian Arab Rep.,Syrian Arab Republic : Dispersed in the country / territory,186,315,0,303,1078,93,0,1975,207,339,0,289,906,90,0,1831
2011,Syrian Arab Rep.,Raqqa : Mohafazat - Governorates,0,0,0,0,0,1,0,1,0,0,0,0,1,1,0,2
2011,Syrian Arab Rep.,Lattakia : Mohafazat - Governorates,21,64,0,58,211,24,0,378,30,77,0,71,205,36,0,419
2011,Syrian Arab Rep.,Idleb : Mohafazat - Governorates,31,42,0,39,122,6,0,240,32,54,0,43,111,9,0,249
2011,Syrian Arab Rep.,Homs : Mohafazat - Governorates,144,288,0,262,923,117,0,1734,160,277,0,294,783,146,0,1660
2011,Syrian Arab Rep.,Hassakeh : Mohafazat - Governorates,461,660,0,464,1793,199,0,3577,451,765,0,482,1110,158,0,2966
2011,Syrian Arab Rep.,Hama : Mohafazat - Governorates,15,37,0,26,114,14,0,206,28,31,0,29,91,17,0,196
2011,Syrian Arab Rep.,Dayr_Az_Zor : Mohafazat - Governorates,138,188,0,126,456,31,0,939,156,186,0,162,365,38,0,907
2011,Syrian Arab Rep.,Dara : Mohafazat - Governorates,103,207,0,161,523,56,0,1050,133,207,0,188,468,49,0,1045
2011,Syrian Arab Rep.,As_Suweida : Mohafazat - Governorates,19,29,0,15,45,3,0,111,21,26,0,13,42,1,0,103
2011,Syrian Arab Rep.,Aleppo : Mohafazat - Governorates,340,559,0,498,1804,196,0,3397,367,546,0,494,1663,233,0,3303
2011,Chad,Am Nabak : Point,1384,2608,0,2006,4846,499,0,11343,1492,2495,0,1524,1711,330,0,7552
2011,Chad,Amboko : Point,624,1672,0,1394,2343,128,0,6161,602,1603,0,1397,1741,123,0,5466
2011,Chad,Bredjing : Point,3469,3934,0,2628,8334,1011,0,19376,3548,3927,0,2844,5572,671,0,16562
2011,Chad,Djabal : Point,1882,2027,0,1302,4246,407,0,9864,1898,2052,0,1389,2564,316,0,8219
2011,Chad,Dosseye : Point,800,1519,0,935,2069,115,0,5438,758,1495,0,781,1126,126,0,4286
2011,Chad,Farchana : Point,2197,2842,0,1842,5365,615,0,12861,2199,2809,0,1847,3205,402,0,10462
2011,Chad,Gaga : Point,2238,2862,0,1530,4723,346,0,11699,2217,2720,0,1690,2859,289,0,9775
2011,Chad,Gondje : Point,573,1528,0,979,2155,97,0,5332,579,1517,0,1097,1418,63,0,4674
2011,Chad,Goz Amer : Point,2909,2957,0,1764,5827,596,0,14053,2854,3029,0,1797,3596,512,0,11788
2011,Chad,Iridimi : Point,1684,2844,0,2057,4312,440,0,11337,1715,2544,0,1968,1788,277,0,8292
2011,Chad,Kounoungou : Point,1434,2807,0,1671,4327,343,0,10582,1372,2620,0,1614,1815,248,0,7669
2011,Chad,Koy : Point,285,401,0,150,568,83,0,1487,277,337,0,119,155,29,0,917
2011,Chad,Mile : Point,1751,2679,0,1633,4465,452,0,10980,1725,2482,0,1420,1964,282,0,7873
2011,Chad,Moula : Point,581,816,0,320,1121,58,0,2896,622,815,0,373,874,60,0,2744
2011,Chad,Moyo : Point,549,539,0,228,856,79,0,2251,513,544,0,250,667,55,0,2029
2011,Chad,Ndjamena : Departement,35,33,0,16,99,2,0,185,24,44,0,18,296,12,0,394
2011,Chad,Oure Cassoni : Point,2585,5452,0,3748,8747,795,0,21327,2623,5085,0,3001,3747,385,0,14841
2011,Chad,Salamat : Departement,1060,1923,0,681,2842,428,0,6934,1009,1850,0,586,1648,314,0,5407
2011,Chad,Touloum : Point,2029,3686,0,2787,5732,636,0,14870,2005,3444,0,2391,2528,350,0,10718
2011,Chad,Treguine : Point,2045,2041,0,1284,4331,478,0,10179,2065,2123,0,1411,2947,374,0,8920
2011,Chad,Yaroungou : Point,748,1356,0,890,2666,226,0,5886,676,1399,0,951,1857,147,0,5030
2011,Togo,Dankpen : Region,185,273,0,90,395,40,0,983,169,276,0,126,267,34,0,872
2011,Togo,Lome : Point,152,196,0,152,936,31,0,1467,189,186,0,156,1231,15,0,1777
2011,Togo,Sotouboua : Region,786,1156,0,378,1670,168,0,4158,750,1227,0,561,1179,153,0,3870
2011,Togo,Tandjoare : Region,405,469,0,238,767,206,0,2085,410,526,0,202,445,111,0,1694
2011,Togo,Tropicana Site,159,191,0,123,770,11,0,1254,160,171,0,144,1041,9,0,1525
2011,Thailand,Ban Don Yang : Point,243,313,0,273,1003,87,0,1919,256,311,0,272,896,87,0,1822
2011,Thailand,Bangkok,1,7,0,10,42,3,0,63,1,6,0,8,55,4,0,74
2011,Thailand,Bangkok : Point,114,125,0,62,524,19,0,844,104,147,0,94,850,33,0,1228
2011,Thailand,Mae La : Point,1671,2535,0,1975,7071,858,0,14110,1753,2518,0,2214,6270,764,0,13519
2011,Thailand,Mae La Oon : Point,717,871,0,635,2524,258,0,5005,676,948,0,714,2595,266,0,5199
2011,Thailand,Mae Sot,0,13,0,11,75,2,0,101,2,6,0,10,127,3,0,148
2011,Thailand,Mai Nai Soi,794,1138,0,710,2973,342,0,5957,825,1176,0,679,3266,341,0,6287
2011,Thailand,Nu Po : Point,771,1358,0,1074,4198,337,0,7738,785,1343,0,1111,4695,310,0,8244
2011,Thailand,Tham Hin : Point,453,586,0,466,1895,182,0,3582,421,641,0,451,1903,152,0,3568
2011,Thailand,Umpium : Point,592,902,0,780,2934,259,0,5467,635,941,0,821,2924,229,0,5550
2011,Thailand,Mae Ra Ma Luang : Point,701,1027,0,727,2445,249,0,5149,709,1043,0,771,2299,298,0,5120
2011,Thailand,Ban Mae Surin : Point,117,150,0,122,505,43,0,937,128,159,0,131,506,55,0,979
2011,Tajikistan,Dushanbe : Point,5,19,0,12,36,1,0,73,11,20,0,16,39,6,0,92
2011,Tajikistan,Tajikistan : Dispersed in the country / territory,0,0,0,0,3,0,0,3,2,0,0,0,2,0,0,4
2011,Turkmenistan,Ashgabat : Point,1,0,0,0,7,2,0,10,0,2,0,0,10,0,0,12
2011,Turkmenistan,Turkmenistan : Dispersed in the country / territory,0,0,0,0,0,0,5500,5500,0,0,0,0,0,0,5500,5500
2011,Turkmenistan,Turkmenbashi : Point,0,0,0,0,5,4,0,9,0,0,0,0,4,1,0,5
2011,Turkmenistan,Turkmenabat : Point,1,1,0,4,6,0,0,12,0,0,0,2,9,0,0,11
2011,Timor-Leste,Dili : Point,0,0,0,0,0,0,0,0,0,0,0,0,2,0,0,2
2011,Tonga,Nuku'alofa,1,0,0,0,1,0,0,2,0,0,0,0,1,0,0,1
2011,Trinidad and Tobago,Port Of Spain : Region,1,2,0,0,9,0,0,12,1,1,0,2,26,0,0,30
2011,Tunisia,Bizerte : Wilayat - Governorate,0,0,0,0,1,0,0,1,0,0,0,0,0,0,0,0
2011,Tunisia,Dispersed in country territory,50,69,0,40,250,64,0,473,47,67,0,45,310,107,0,576
2011,Tunisia,Monastir : Mutamadiyat,0,0,0,0,1,0,0,1,0,0,0,0,0,0,0,0
2011,Tunisia,Sfax : Wilayat - Governorate,0,1,0,0,1,0,0,2,0,1,0,0,1,0,1,3
2011,Tunisia,Shousha,89,66,0,63,493,2,0,713,119,74,0,181,2222,25,0,2621
2011,Tunisia,Sousse : Wilayat - Governorate,0,0,0,0,0,1,0,1,0,0,0,0,0,0,1,1
2011,Tunisia,Tunis : Point,0,0,0,0,19,4,0,23,0,0,0,0,36,5,0,41
2011,Turkey,Adana : Point,18,23,0,22,94,3,0,160,18,29,0,26,154,2,0,229
2011,Turkey,Afyon : Point,31,44,0,34,191,15,0,315,37,42,0,49,232,22,0,382
2011,Turkey,Agri : Point,43,71,0,60,181,4,0,359,45,97,0,90,248,7,0,487
2011,Turkey,Aksaray : Point,24,42,0,37,145,9,0,257,29,45,0,60,185,13,0,332
2011,Turkey,Amasya : Point,41,37,0,42,164,21,0,305,21,57,0,52,229,14,0,373
2011,Turkey,Ankara:Point,22,28,0,26,203,8,0,287,17,29,0,42,390,15,0,493
2011,Turkey,Antalya : Point,0,0,0,0,1,0,0,1,1,1,0,0,2,0,0,4
2011,Turkey,Aydin : Point,0,0,0,0,0,0,0,0,0,0,0,2,0,0,0,2
2011,Turkey,Baghdad,0,0,0,0,0,0,0,0,0,0,0,0,1,0,0,1
2011,Turkey,Balikesir:Point,0,0,0,0,12,1,0,13,2,3,0,0,22,1,0,28
2011,Turkey,Batman : Point,0,1,0,1,2,0,0,4,3,4,0,1,2,0,0,10
2011,Turkey,Bayburt : Point,0,0,0,0,0,0,0,0,0,0,0,0,2,1,0,3
2011,Turkey,Bilecik:Point,7,15,0,15,90,7,0,134,15,21,0,20,122,10,0,188
2011,Turkey,Bitlis : Point,0,0,0,0,0,0,0,0,0,0,0,0,2,0,0,2
2011,Turkey,Bolu : Point,24,25,0,19,79,4,0,151,12,30,0,15,104,5,0,166
2011,Turkey,Burdur : Point,16,24,0,31,118,1,0,190,17,32,0,37,164,3,0,253
2011,Turkey,Bursa,0,0,0,0,1,0,0,1,0,0,0,0,2,0,0,2
2011,Turkey,Canakkale,0,0,0,0,0,0,0,0,0,0,0,0,2,0,0,2
2011,Turkey,Cankiri : Point,4,17,0,9,44,3,0,77,3,24,0,19,92,3,0,141
2011,Turkey,Corum : Point,47,88,0,67,263,14,0,479,66,104,0,54,312,16,0,552
2011,Turkey,Denizli : Point,1,4,0,3,35,2,0,45,4,7,0,9,51,0,0,71
2011,Turkey,Edirne: Point,2,1,0,1,6,1,0,11,0,0,0,1,14,1,0,16
2011,Turkey,Elazig : Point,0,0,0,0,0,0,0,0,0,0,0,0,1,0,0,1
2011,Turkey,Erzincan : Point,1,1,0,2,4,0,0,8,2,1,0,0,11,0,0,14
2011,Turkey,Erzurum: Point,40,61,0,41,160,5,0,307,28,62,0,62,225,7,0,384
2011,Turkey,Eskisehir: Point,23,52,0,35,238,18,0,366,36,70,0,46,324,20,0,496
2011,Turkey,Gaziantep : Point,56,94,0,81,292,21,0,544,61,114,0,84,466,18,0,743
2011,Turkey,Gumushane : Point,3,6,0,8,15,0,0,32,2,4,0,6,20,2,0,34
2011,Turkey,Hakkari : Point,0,0,0,0,6,0,0,6,0,0,0,1,10,0,0,11
2011,Turkey,Hatay : Point,10,8,0,11,53,0,0,82,11,7,0,12,100,0,0,130
2011,Turkey,IGDIR,0,0,0,0,2,0,0,2,0,0,0,0,4,0,0,4
2011,Turkey,Isparta : Point,39,55,0,31,186,4,0,315,51,58,0,38,222,3,0,372
2011,Turkey,Istanbul : Point,106,140,0,138,714,42,0,1140,134,156,0,239,1259,51,0,1839
2011,Turkey,Izmir : Point,0,1,0,1,23,0,0,25,2,5,0,4,43,0,0,54
2011,Turkey,Izmit : Point,0,0,0,0,1,0,0,1,0,0,0,0,2,0,0,2
2011,Turkey,K.Maras : Point,3,14,0,6,27,0,0,50,8,15,0,9,46,0,0,78
2011,Turkey,Karaman : Point,7,16,0,15,48,1,0,87,12,15,0,14,62,3,0,106
2011,Turkey,Kars : Point,0,0,0,0,1,0,0,1,0,0,0,0,0,0,0,0
2011,Turkey,Kastamonu : Point,21,29,0,12,107,2,0,171,15,29,0,24,178,2,0,248
2011,Turkey,Kayseri : Point,58,121,0,101,749,45,0,1074,79,146,0,140,815,47,0,1227
2011,Turkey,Kirikkale : Point,23,31,0,17,122,6,0,199,28,32,0,32,127,6,0,225
2011,Turkey,Kirklareli : Point,0,5,0,5,17,0,0,27,6,5,0,3,21,1,0,36
2011,Turkey,Kirsehir : Point,32,39,0,34,198,15,0,318,38,46,0,48,255,17,0,404
2011,Turkey,Konya : Point,37,58,0,46,228,5,0,374,47,62,0,43,307,10,0,469
2011,Turkey,Kutahya : Point,32,70,0,54,206,3,0,365,31,74,0,59,265,7,0,436
2011,Turkey,Malatya : Point,1,1,0,1,2,0,0,5,0,1,0,0,6,0,0,7
2011,Turkey,Manisa : Point,0,0,0,0,0,0,0,0,0,0,0,0,2,0,0,2
2011,Turkey,Mardin : Point,3,0,0,0,6,0,0,9,1,1,0,0,15,0,0,17
2011,Turkey,Mersin : Point,0,0,0,0,0,0,0,0,0,0,0,0,4,0,0,4
2011,Turkey,Mugla : Point,0,0,0,0,0,1,0,1,0,0,0,0,1,2,0,3
2011,Turkey,Nevsehir : Point,30,34,0,34,339,15,0,452,25,47,0,47,460,20,0,599
2011,Turkey,Nigde : Point,22,36,0,27,185,5,0,275,14,32,0,27,246,3,0,322
2011,Turkey,Sakarya : Point,59,77,0,71,300,21,0,528,84,111,0,94,465,19,0,773
2011,Turkey,Salah al-Din,0,0,0,0,1,0,0,1,0,0,0,0,0,0,0,0
2011,Turkey,Siirt : Point,0,0,0,0,0,0,0,0,0,0,0,2,0,0,0,2
2011,Turkey,Sirnak : Point,0,6,0,2,13,0,0,21,0,6,0,6,38,0,0,50
2011,Turkey,Sivas : Point,14,25,0,22,76,3,0,140,17,31,0,28,119,1,0,196
2011,Turkey,Tekirdag : Point,1,2,0,2,5,0,0,10,1,4,0,4,6,1,0,16
2011,Turkey,Tokat : Point,25,34,0,27,146,17,0,249,26,39,0,42,184,13,0,304
2011,Turkey,Trabzon : Point,0,0,0,0,1,0,0,1,0,0,0,0,0,0,0,0
2011,Turkey,Urfa : Point,1,4,0,1,6,0,0,12,4,5,0,3,8,0,0,20
2011,Turkey,Usak : Point,1,1,0,0,4,0,0,6,0,1,0,1,6,0,0,8
2011,Turkey,Van : Point,10,23,0,28,92,3,0,156,11,36,0,34,178,2,0,261
2011,Turkey,Yalova : Point,37,29,0,29,160,14,0,269,41,30,0,18,231,16,0,336
2011,Turkey,Yozgat Camp : Point,4,4,0,4,10,0,0,22,3,1,0,5,3,0,0,12
2011,Turkey,Yozgat Urban : Point,38,57,0,45,276,40,0,456,35,70,0,54,291,39,0,489
2011,Turkey,Turkey : Dispersed in the country / territory,2,2,0,2,17,0,0,23,4,3,0,5,26,1,0,39
2011,United Rep. of Tanzania,Kigoma villages,1742,2103,0,2009,4554,367,0,10775,1730,2279,0,1993,5028,422,0,11452
2011,United Rep. of Tanzania,Ulyankulu : Point,3040,6744,0,4123,10452,882,0,25241,2886,6434,0,4408,9665,673,0,24066
2011,United Rep. of Tanzania,Tanga/DSM/Mtw,0,0,0,8,13,0,0,21,0,13,0,65,200,0,0,278
2011,United Rep. of Tanzania,Nyarugusu : Point,5703,7160,0,5330,14139,905,0,33237,5846,7030,0,5290,11376,777,0,30319
2011,United Rep. of Tanzania,National Milling Co-operation Transit Centre : Point,3,5,0,0,3,0,0,11,1,2,0,2,7,0,0,12
2011,United Rep. of Tanzania,Mtwara,0,0,0,0,0,0,0,0,0,0,0,0,1,0,0,1
2011,United Rep. of Tanzania,Mtabila 1 : Point,3337,4203,0,2790,7840,300,0,18470,3479,4445,0,2885,7898,377,0,19084
2011,United Rep. of Tanzania,Mishamo : Point,3506,6542,0,5006,11572,1080,0,27706,3455,6424,0,4167,11328,1153,0,26527
2011,United Rep. of Tanzania,Katumba : Point,3638,7753,0,6155,14644,1262,0,33452,3789,7806,0,5497,13622,1265,0,31979
2011,United Rep. of Tanzania,Dar es Salaam : Point,0,2,0,6,6,0,0,14,0,4,0,5,20,0,0,29
2011,United Rep. of Tanzania,Chogo : Point,236,172,0,148,286,31,0,873,180,159,0,120,172,26,0,657
2011,Uganda,Adjumani : District,492,873,0,606,1578,111,0,3660,509,888,0,626,1097,46,0,3166
2011,Uganda,Imvepi : Point,112,196,0,183,388,28,0,907,142,213,0,238,427,6,0,1026
2011,Uganda,Kampala : District,1945,4412,0,5851,6544,205,0,18957,2029,4541,0,7472,9320,181,0,23543
2011,Uganda,Kayaka II : Point,1494,1846,0,1213,3405,282,0,8240,1458,1806,0,1283,3124,311,0,7982
2011,Uganda,Kiryandongo : Point,255,501,0,353,1065,103,0,2277,266,504,0,384,941,76,0,2171
2011,Uganda,Kyangwali : Point,2546,2961,0,1705,5224,311,0,12747,2572,2984,0,1724,5121,244,0,12645
2011,Uganda,Nakivale : Point,5120,6494,0,3938,12444,530,0,28526,5196,6452,0,3986,12843,585,0,29062
2011,Uganda,Oruchinga : Point,493,548,0,323,1089,64,0,2517,480,549,0,333,991,62,0,2415
2011,Uganda,Palorinya : Point,131,201,0,148,366,26,0,872,132,187,0,142,274,12,0,747
2011,Uganda,Rhino Camp : Point,83,157,0,162,330,28,0,760,77,150,0,174,263,17,0,681
2011,Ukraine,Ukraine : Dispersed in the country / territory,51,62,0,73,417,22,0,625,55,74,0,152,1665,14,0,1960
2011,Uruguay,Montevideo : Point,2,4,0,7,46,12,0,71,2,4,0,10,127,11,0,154
2011,Uzbekistan,Tashkent : Point,9,9,0,14,48,6,0,86,6,8,0,16,73,4,0,107
2011,Uzbekistan,Termez : Point,0,0,0,2,6,0,0,8,2,0,0,2,8,1,0,13
2011,Saint Vincent and the Grenadines,Saint Vincent and the Grenadines : Dispersed in the country / te,0,0,0,0,1,0,0,1,0,0,0,0,0,0,0,0
2011,Venezuela (Bolivarian Republic of),Zulia : Point,321,345,0,465,1092,52,26686,28961,419,501,0,399,1197,98,29961,32575
2011,Venezuela (Bolivarian Republic of),Venezuela : Dispersed in the country / territory,47,109,0,167,589,26,39740,40678,58,133,0,176,680,37,43142,44226
2011,Venezuela (Bolivarian Republic of),Tachira : Point,512,589,0,601,1184,100,20116,23102,510,653,0,670,1571,95,21561,25060
2011,Venezuela (Bolivarian Republic of),Caracas : Point,48,69,0,81,525,14,0,737,70,98,0,103,805,33,0,1109
2011,Venezuela (Bolivarian Republic of),Apure : Point,275,401,0,355,810,71,7359,9271,345,403,0,342,912,105,7915,10022
2011,British Virgin Islands,Tortola : District,0,0,0,0,0,0,0,0,0,0,0,0,2,0,0,2
2011,Viet Nam,Binh Duong : Region,0,0,0,0,0,0,446,446,0,0,0,0,0,0,401,401
2011,Viet Nam,Binh Phuoc : Region,0,0,0,0,0,0,59,59,0,0,0,0,0,0,60,60
2011,Viet Nam,Viet Nam : Dispersed in the country / territory,0,0,0,0,0,0,3000,3000,0,0,0,0,0,0,0,0
2011,Viet Nam,Thu Duc : Municipality - Thanh Pho,0,0,0,0,0,0,5,5,0,0,0,0,0,0,5,5
2011,Viet Nam,Ho Chi Minh City : Region,0,0,0,0,0,0,3700,3700,0,0,0,0,0,0,3500,3500
2011,Viet Nam,Cu Chi : Municipality - Thanh Pho,0,0,0,0,0,0,7,7,0,0,0,0,0,0,7,7
2011,Vanuatu,Port Vila : Point,0,0,0,1,0,0,0,1,0,0,0,0,1,0,0,1
2011,Yemen,Aden : Point,4416,16179,0,10878,32086,1537,0,65096,4633,17193,0,12262,39731,1617,0,75436
2011,Yemen,Al Kharaz : Point,1421,1888,0,1202,4046,115,0,8672,1614,1903,0,1111,3481,123,0,8232
2011,Yemen,Al-Baida : Point,8,34,0,33,86,7,0,168,14,23,0,23,92,2,0,154
2011,Yemen,Dhamar : Point,18,19,0,18,78,2,0,135,17,16,0,16,47,4,0,100
2011,Yemen,Hodeidah : Point,20,40,0,41,109,24,0,234,19,55,0,55,104,19,0,252
2011,Yemen,Mahra : Point,147,116,0,55,327,7,0,652,155,110,0,53,714,10,0,1042
2011,Yemen,Mukalla : Point,488,558,0,350,1681,88,0,3165,454,527,0,318,3537,106,0,4942
2011,Yemen,Rada' : District,29,18,0,17,56,5,0,125,25,33,0,32,62,5,0,157
2011,Yemen,Sana'a : Point,3115,7615,0,4831,20903,895,0,37359,3564,8779,0,5821,20678,955,0,39797
2011,Yemen,Shabwa : Point,15,28,0,29,151,6,0,229,12,22,0,22,171,2,0,229
2011,Yemen,Taiz : Point,79,164,0,146,601,43,0,1033,95,142,0,123,335,25,0,720
2011,Yemen,Yemen : Dispersed in the country / territory,821,980,0,2906,26325,90,0,31122,640,1693,0,6520,69848,62,0,78763
2011,Yemen,Shabwa : Muhafazah - Governorate,76,325,0,204,498,27,0,1130,72,310,0,209,359,27,0,977
2011,Yemen,"S,adah : Muhafazah - Governorate",2257,9516,0,6038,14649,814,0,33274,2323,10045,0,6777,11863,882,0,31890
2011,Yemen,Hajjah : Muhafazah - Governorate,3367,14355,0,9011,22000,1210,0,49943,3846,16634,0,11215,19253,1455,0,52403
2011,Yemen,Hadramout: Muhafazah - Governorate,40,172,0,108,263,15,0,598,47,201,0,136,233,18,0,635
2011,Yemen,Amran : Muhafazah - Governorate,1402,5977,0,3751,9160,504,0,20794,1443,6240,0,4207,7222,546,0,19658
2011,Yemen,Al-Bayda: Muhafazah - Governorate,33,144,0,91,221,12,0,501,34,145,0,98,168,13,0,458
2011,Yemen,Al Jawf : Muhafazah - Governorate,119,507,0,318,777,43,0,1764,122,529,0,357,612,46,0,1666
2011,Yemen,Abyan: Muhafazah - Governorate,15,64,0,40,98,5,0,222,15,67,0,45,77,6,0,210
2011,Zambia,Lusaka Urban : Point,279,430,0,345,1113,28,0,2195,295,387,0,367,1939,69,0,3057
2011,Zambia,Mayukwayukwa : Point,855,1110,0,830,1770,146,0,4711,862,1061,0,841,1692,279,0,4735
2011,Zambia,Meheba : Point,1731,2142,0,1509,2888,262,0,8532,1647,2071,0,2004,2977,300,0,8999
2011,Zambia,Zambia : Dispersed in the country / territory,517,1509,0,933,2635,263,0,5857,490,1479,0,914,3259,425,0,6567
2011,Zimbabwe,Harare : District,70,106,0,98,183,4,0,461,74,106,0,115,278,6,0,579
2011,Zimbabwe,Tongogara : Point,365,528,0,369,821,14,0,2097,359,608,0,454,1289,12,0,2722
2012,Aruba,Oranjestad : Point,0,0,0,0,2,0,0,2,0,0,0,0,4,0,0,4
2012,Afghanistan,Badakhshan : Wilayat - Province,39,131,0,78,216,10,0,474,36,128,0,131,844,26,0,1165
2012,Afghanistan,Badghis : Wilayat - Province,140,908,0,921,2175,145,0,4289,123,941,0,993,2522,225,0,4804
2012,Afghanistan,Baghlan : Wilayat - Province,1452,2902,0,1797,4844,243,0,11238,1526,2929,0,1924,4899,488,0,11766
2012,Afghanistan,Balkh : Wilayat - Province,1320,3037,0,2277,6413,430,0,13477,1369,3103,0,2465,6638,669,0,14244
2012,Afghanistan,Bamyan : Wilayat - Province,100,170,0,135,483,37,0,925,73,192,0,148,539,57,0,1009
2012,Afghanistan,Day Kundi : Wilayat - Province,63,313,0,147,463,23,0,1009,65,291,0,197,468,43,0,1064
2012,Afghanistan,Farah : Wilayat - Province,362,1259,0,1234,2865,190,0,5910,381,1362,0,1268,3115,273,0,6399
2012,Afghanistan,Faryab : Wilayat - Province,741,3245,0,2957,7457,501,0,14901,800,3396,0,3086,8287,817,0,16386
2012,Afghanistan,Ghazni : Wilayat - Province,927,5226,0,3282,8551,570,0,18556,912,5586,0,3655,9492,895,0,20540
2012,Afghanistan,Ghor : Wilayat - Province,212,2283,0,2418,5654,394,0,10961,220,2380,0,2596,6493,588,0,12277
2012,Afghanistan,Hilmand : Wilayat - Province,1596,7946,0,7211,17165,1185,0,35103,1613,8261,0,7959,19156,1799,0,38788
2012,Afghanistan,Hirat : Wilayat - Province,1716,10580,0,10976,27260,1811,0,52343,1841,11041,0,11624,31304,2695,0,58505
2012,Afghanistan,Jawzjan : Wilayat - Province,1308,3279,0,2468,7786,588,0,15429,1295,3443,0,2587,8076,872,0,16273
2012,Afghanistan,Kabul : Wilayat - Province,6844,14996,0,10735,31005,1485,0,65065,7138,15733,0,11626,29157,2594,0,66248
2012,Afghanistan,Kandahar : Wilayat - Province,2643,10703,0,7298,18162,1205,0,40011,2677,11137,0,8367,19836,1770,0,43787
2012,Afghanistan,Kapisa : Wilayat - Province,352,2086,0,2055,4883,318,0,9694,365,2158,0,2195,5441,488,0,10647
2012,Afghanistan,Khost : Wilayat - Province,443,1333,0,1114,2773,197,0,5860,454,1455,0,1285,2816,305,0,6315
2012,Afghanistan,Kunar : Wilayat - Province,4435,10930,0,7702,18480,980,0,42527,4472,11565,0,8493,19152,1707,0,45389
2012,Afghanistan,Kunduz : Wilayat - Province,4113,8128,0,4450,12288,583,0,29562,4400,8547,0,4890,12227,1022,0,31086
2012,Afghanistan,Laghman : Wilayat - Province,3344,8981,0,5429,13235,598,0,31587,3284,9197,0,6117,13245,1063,0,32906
2012,Afghanistan,Logar : Wilayat - Province,1632,4295,0,3132,7672,406,0,17137,1737,4528,0,3305,7211,734,0,17515
2012,Afghanistan,Nangarhar : Wilayat - Province,19929,67216,0,40088,95730,5035,0,227998,20051,69402,0,43791,96222,7729,0,237195
2012,Afghanistan,Nimroz : Wilayat - Province,31,100,0,96,227,17,0,471,54,118,0,97,274,26,0,569
2012,Afghanistan,Nuristan : Wilayat - Province,77,513,0,511,1185,80,0,2366,77,525,0,549,1343,118,0,2612
2012,Afghanistan,Paktika : Wilayat - Province,86,596,0,464,1113,71,0,2330,92,652,0,509,1243,104,0,2600
2012,Afghanistan,Paktya : Wilayat - Province,1780,3546,0,2357,6194,339,0,14216,1889,3530,0,2680,5163,653,0,13915
2012,Afghanistan,Panjsher : Wilayat - Province,42,99,0,97,237,13,0,488,39,110,0,98,253,19,0,519
2012,Afghanistan,Parwan : Wilayat - Province,718,1713,0,1285,3359,152,0,7227,751,1814,0,1387,3584,272,0,7808
2012,Afghanistan,Samangan : Wilayat - Province,256,555,0,331,882,55,0,2079,225,536,0,345,890,86,0,2082
2012,Afghanistan,Sari Pul : Wilayat - Province,620,2061,0,1778,4353,315,0,9127,659,2192,0,1946,4747,480,0,10024
2012,Afghanistan,Takhar : Wilayat - Province,767,1434,0,828,2195,107,0,5331,776,1503,0,873,2615,215,0,5982
2012,Afghanistan,Uruzgan : Wilayat - Province,264,2285,0,2240,5290,366,0,10445,250,2360,0,2412,5977,537,0,11536
2012,Afghanistan,Wardak : Wilayat - Province,376,1448,0,1367,3541,183,0,6915,365,1521,0,1457,3670,342,0,7355
2012,Afghanistan,Zabul : Wilayat - Province,302,1822,0,1558,3772,251,0,7705,314,1899,0,1731,4205,404,0,8553
2012,Afghanistan,Afghanistan : Dispersed in the country / territory,214,62,0,20,718,7,0,1021,218,71,0,15,3353,1,0,3658
2012,Albania,Mamurras : Point,0,1,0,0,1,0,0,2,0,2,0,0,0,0,0,2
2012,Albania,Peshkopi : Point,0,0,0,0,0,1,0,1,0,0,0,0,0,0,0,0
2012,Albania,Tirana Camp : Point,6,0,0,2,13,1,0,22,2,1,0,4,23,2,0,32
2012,Albania,Tirana Urban : Point,1,4,0,2,11,2,0,20,6,3,0,4,18,1,0,32
2012,Albania,Albania : Dispersed in the country / territory,0,0,0,0,1,0,0,1,0,0,0,0,2,0,0,2
2012,United Arab Emirates,Abu Dhabi : Emirate - Region,36,40,0,38,209,28,0,351,29,53,0,43,218,28,0,371
2012,Argentina,Argentina : Dispersed in the country / territory,15,68,0,82,852,70,0,1087,22,55,0,102,2151,46,0,2376
2012,Armenia,Aragatsotn : Marz - Province,0,0,0,0,40,19,0,59,0,0,0,0,32,10,0,42
2012,Armenia,Ararat : Marz - Province,0,0,0,0,38,34,0,72,0,0,0,0,67,40,0,107
2012,Armenia,Armavir : Marz - Province,0,0,0,0,52,38,0,90,0,0,0,0,51,17,0,68
2012,Armenia,Gergharkunik : Marz - Province,0,0,0,0,35,15,0,50,0,0,0,0,41,13,0,54
2012,Armenia,Kotayk : Marz - Province,0,0,0,0,98,60,0,158,0,0,0,0,102,36,0,138
2012,Armenia,Lori : Marz - Province,0,0,0,0,44,14,0,58,0,0,0,0,43,10,0,53
2012,Armenia,Shirak : Marz - Province,0,0,0,0,17,3,0,20,0,0,0,0,16,3,0,19
2012,Armenia,Syunik : Marz - Province,0,0,0,0,59,18,0,77,0,0,0,0,59,6,0,65
2012,Armenia,Tavush : Marz - Province,0,0,0,0,8,22,0,30,0,0,0,0,3,5,0,8
2012,Armenia,Vayots Dzor : Marz - Province,0,0,0,0,4,0,0,4,0,0,0,0,1,0,0,1
2012,Armenia,Yerevan : City,45,72,0,87,615,205,11,1035,57,75,0,87,703,129,13,1064
2012,Austria,Austria : Dispersed in the country / territory,0,0,0,0,0,0,5835,5835,0,0,0,0,0,0,15971,15971
2012,Azerbaijan,Baku : Point,79,118,0,83,348,32,0,660,73,121,0,90,536,26,0,846
2012,Burundi,Bujumbura : Province,1304,2422,0,2023,5404,279,0,11432,1320,2389,0,2012,4559,189,0,10469
2012,Burundi,Butare : Point,30,30,0,10,65,3,0,138,20,27,0,14,54,3,0,118
2012,Burundi,Bwagiriza : Point,1090,1165,0,711,2116,100,0,5182,1119,1289,0,702,1738,75,0,4923
2012,Burundi,Kinama Camp,797,1359,0,738,1982,93,0,4969,826,1314,0,774,1536,61,0,4511
2012,Burundi,Musasa : Point,609,893,0,517,1292,57,0,3368,591,911,0,540,1065,25,0,3132
2012,Burundi,Burundi : Dispersed in the country / territory,9050,11627,0,8637,24422,1700,40,55476,8999,11607,0,9309,27111,3387,73,60486
2012,Belgium,Belgium : Dispersed in the country / territory,0,0,0,0,0,0,10938,10938,0,0,0,0,0,0,14984,14984
2012,Benin,Agame : Point,136,204,0,118,551,18,0,1027,140,231,0,128,819,13,0,1331
2012,Benin,Benin : Dispersed in the country / territory,165,228,0,133,725,17,0,1268,198,206,0,159,887,21,0,1471
2012,Burkina Faso,Bobo-Dioulasso,136,183,0,166,432,32,0,949,129,184,0,116,508,40,0,977
2012,Burkina Faso,Damba,255,281,0,136,590,37,0,1299,263,342,0,160,603,70,0,1438
2012,Burkina Faso,Deou,152,244,0,148,401,39,0,984,173,281,0,128,421,53,0,1056
2012,Burkina Faso,Djibissi,329,446,0,250,761,43,0,1829,352,570,0,307,832,59,0,2120
2012,Burkina Faso,Fererio,500,710,0,307,1184,83,0,2784,526,764,0,342,1238,107,0,2977
2012,Burkina Faso,Gandafabou,283,328,0,166,609,83,0,1469,300,383,0,174,581,67,0,1505
2012,Burkina Faso,Gorom-Gorom,15,28,0,13,40,1,0,97,20,31,0,37,69,5,0,162
2012,Burkina Faso,Goudebo,389,527,0,312,1024,86,0,2338,443,637,0,350,1052,123,0,2605
2012,Burkina Faso,Gountoure Gnegne,284,414,0,185,623,34,0,1540,336,438,0,212,560,43,0,1589
2012,Burkina Faso,Mentao,577,795,0,418,1472,143,0,3405,685,755,0,482,1440,138,0,3500
2012,Burkina Faso,Ouagadougou : Point,89,117,0,93,378,10,0,687,76,109,0,109,735,18,0,1047
2012,Burkina Faso,Ouahigouya,8,9,0,5,14,1,0,37,5,2,0,1,16,2,0,26
2012,Burkina Faso,Sag-Nioniogo,225,278,0,132,557,48,0,1240,220,370,0,210,611,47,0,1458
2012,Burkina Faso,Tin-Hedja,59,106,0,49,156,9,0,379,67,126,0,87,199,16,0,495
2012,Bangladesh,Bandarban : Zila - District,3,6,0,3,17,1,0,30,1,7,0,8,26,3,0,45
2012,Bangladesh,Barguna : Zila - District,0,0,0,0,0,0,0,0,0,0,0,0,1,0,0,1
2012,Bangladesh,Chittagong : Zila - District,0,0,0,0,4,0,0,4,0,0,0,0,5,0,0,5
2012,Bangladesh,Cox's Bazar : Zila - District,2,1,0,4,15,0,0,22,0,4,0,4,39,4,0,51
2012,Bangladesh,Dhaka : Zila - District,1,7,0,1,12,0,0,21,2,1,0,1,20,2,0,26
2012,Bangladesh,Gazipur : Zila - District,1,0,0,0,1,0,0,2,0,0,0,0,6,0,0,6
2012,Bangladesh,Kutupalong : Point,983,1440,0,1121,2652,136,0,6332,1008,1467,0,1133,2321,143,0,6072
2012,Bangladesh,Narsingdi : Zila - District,0,2,0,0,1,0,0,3,0,0,0,0,2,0,0,2
2012,Bangladesh,Nayapara : Point,1374,2162,0,1702,4019,194,0,9451,1392,2238,0,1625,3157,203,0,8615
2012,Bangladesh,Rangamati : Zila - District,1,1,0,2,1,0,0,5,0,1,0,0,5,1,0,7
2012,Bulgaria,Bulgaria : Dispersed in the country / territory,0,0,0,0,0,0,152,152,0,0,0,0,0,0,1077,1077
2012,Bahrain,Bahrain : Dispersed in the country / territory,27,20,0,17,103,5,0,172,16,12,0,12,115,12,0,167
2012,Bahamas,Bahamas : Dispersed in the country / territory,0,0,0,0,4,0,0,4,1,2,0,1,44,0,0,48
2012,Bosnia and Herzegovina,Republika Srpska : Entity,1,0,0,4,13,0,30981,30999,0,0,0,2,5,0,32244,32251
2012,Bosnia and Herzegovina,Federacija Bosna i Hercegovina : Entity,6,14,0,12,46,3,21714,21795,3,21,0,11,60,2,22599,22696
2012,Bosnia and Herzegovina,Brcko : Županija - County,1,1,0,1,12,2,251,268,0,1,0,2,11,2,261,277
2012,Bosnia and Herzegovina,Bosnia and Herzegovina : Dispersed in the country / territory,0,128,0,262,2375,582,30501,33848,0,159,0,208,2371,624,31767,35129
2012,Belarus,Brest : Oblast - Region,0,0,0,0,0,0,0,0,0,0,0,0,7,1,0,8
2012,Belarus,Gomel : Oblast - Region,5,4,0,5,19,3,0,36,5,4,0,3,39,3,0,54
2012,Belarus,Grodno : Oblast - Region,0,0,0,0,4,0,0,4,0,0,0,0,7,0,0,7
2012,Belarus,Horad Minsk : City,12,27,0,28,74,10,0,151,15,22,0,21,152,4,0,214
2012,Belarus,Minsk : Oblast - Region,0,4,0,4,29,2,0,39,2,3,0,6,31,0,0,42
2012,Belarus,Mogilev : Oblast - Region,0,0,0,2,14,0,0,16,0,0,0,0,20,0,0,20
2012,Belarus,Vitebsk : Oblast - Region,1,1,0,2,11,2,0,17,1,4,0,3,21,1,0,30
2012,Belize,Belize : Dispersed in the country / territory,4,9,0,2,25,1,0,41,3,3,0,12,38,7,0,63
2012,Bolivia (Plurinational State of),Beni,0,0,0,3,0,0,0,3,0,1,0,1,1,0,0,3
2012,Bolivia (Plurinational State of),Cochabamba,1,6,0,5,13,0,0,25,3,5,0,6,22,0,0,36
2012,Bolivia (Plurinational State of),La Paz,0,7,0,27,113,4,0,151,3,14,0,27,156,7,0,207
2012,Bolivia (Plurinational State of),Palos Blanco,0,1,0,0,2,0,0,3,0,0,0,0,3,0,0,3
2012,Bolivia (Plurinational State of),Santa Cruz,5,0,0,5,16,1,0,27,1,2,0,7,31,1,0,42
2012,Bolivia (Plurinational State of),Sucre,0,0,0,0,0,0,0,0,0,0,0,0,2,0,0,2
2012,Bolivia (Plurinational State of),Tarija,0,0,0,0,1,0,0,1,0,0,0,0,1,0,0,1
2012,Bolivia (Plurinational State of),Yapacani,0,1,0,1,4,0,0,6,0,1,0,0,5,0,0,6
2012,Bolivia (Plurinational State of),Bolivia : Dispersed in the country / territory,0,0,0,5,85,3,0,93,0,0,0,1,129,2,0,132
2012,Brazil,Acre : Estado - State,3,7,0,21,245,0,0,276,3,10,0,45,1362,15,0,1435
2012,Brazil,Bahia : Estado - State,0,0,0,0,1,0,0,1,0,0,0,0,4,0,0,4
2012,Brazil,Ceará : Estado - State,0,0,0,0,1,0,0,1,0,0,0,0,6,0,0,6
2012,Brazil,Espirito Santo,0,0,0,0,0,0,0,0,0,0,0,0,1,0,0,1
2012,Brazil,Goias,0,0,0,0,1,1,0,2,0,1,0,0,3,0,0,4
2012,Brazil,Mato Grosso : Estado - State,0,0,0,0,3,0,0,3,0,0,0,0,8,0,0,8
2012,Brazil,Mato Grosso do Sul : Estado - State,0,0,0,0,4,0,0,4,0,0,0,1,11,0,0,12
2012,Brazil,Minas Gerais : Estado - State,0,0,0,1,1,0,0,2,0,0,0,0,12,0,0,12
2012,Brazil,Pará : Estado - State,0,0,0,0,0,0,0,0,0,0,0,0,4,0,0,4
2012,Brazil,Paraná : Estado - State,0,2,0,1,10,0,0,13,0,2,0,1,40,1,0,44
2012,Brazil,Pernambuco : Estado - State,0,0,0,0,0,0,0,0,0,0,0,0,2,0,0,2
2012,Brazil,Rio De Janeiro : Estado - State,8,26,0,26,581,15,0,656,10,24,0,31,1516,25,0,1606
2012,Brazil,Rio Grande Do Norte : Estado - State,3,2,0,0,5,0,0,10,0,0,0,0,11,0,0,11
2012,Brazil,Rio Grande Do Sul : Estado - State,1,11,0,16,64,1,0,93,1,20,0,15,100,1,0,137
2012,Brazil,Rondonia,0,0,0,0,0,0,0,0,0,0,0,0,1,0,0,1
2012,Brazil,Roraima : Estado - State,1,0,0,0,2,0,0,3,0,0,0,0,9,0,0,9
2012,Brazil,Santa Catarina : Estado - State,0,0,0,1,5,0,0,6,0,0,0,1,23,0,0,24
2012,Brazil,Sao Paulo : Estado - State,10,35,0,40,482,26,0,593,13,41,0,51,1802,30,0,1937
2012,Brazil,Distrito Federal : Distrito Federal - Federal District,1,2,0,1,19,3,0,26,1,2,0,2,220,3,0,228
2012,Brazil,Brazil : Dispersed in the country / territory,5,18,0,32,77,2,0,134,4,21,0,70,117,12,0,224
2012,Brazil,Amazonas : Estado - State,0,5,0,37,550,1,1704,2297,3,6,0,107,3439,36,1816,5407
2012,Barbados,Barbados : Dispersed in the country / territory,0,0,0,0,0,0,0,0,0,0,0,0,0,1,0,1
2012,Botswana,Dukwi : Point,195,263,0,199,568,34,0,1259,210,267,0,179,1479,46,0,2181
2012,Central African Rep.,Bangui : Commune,253,372,0,288,821,30,0,1764,263,432,0,271,905,29,0,1900
2012,Central African Rep.,Mboki : Point,14,9,0,8,50,3,0,84,12,20,0,11,52,8,0,103
2012,Central African Rep.,Obo : Sous-prefecture,37,31,0,23,105,17,0,213,36,42,0,24,76,12,0,190
2012,Central African Rep.,Zemio : Sous-prefecture,259,286,0,156,718,75,0,1494,280,291,0,156,672,73,0,1472
2012,Central African Rep.,Mongoumba : Sous-prefecture,597,766,0,418,1171,129,0,3081,626,800,0,444,941,98,0,2909
2012,Central African Rep.,Bambari : Sous-prefecture,215,263,0,148,388,36,0,1050,223,291,0,118,237,48,0,917
2012,Canada,Canada : Dispersed in the country / territory,1408,1948,0,1465,13677,1065,0,19563,1447,1966,0,1605,17773,583,0,23374
2012,Switzerland,Switzerland : Dispersed in the country / territory,1615,2145,0,1611,9840,642,13827,29680,1692,2292,0,2047,18027,380,18338,42776
2012,Chile,Chile : Dispersed in the country / territory,0,0,0,0,0,0,133,133,0,0,0,0,0,0,145,145
2012,China,Beijing : Municipality,1,1,0,1,9,1,0,13,2,2,0,0,29,1,0,34
2012,China,Fujian : Province,0,0,0,0,0,0,13211,13211,0,0,0,0,0,0,14198,14198
2012,China,Gan Su: Province,0,0,0,0,1,0,0,1,0,1,0,1,1,0,0,3
2012,China,Guangdong : Province,4,5,0,6,33,2,39884,39934,3,8,0,6,40,1,43654,43712
2012,China,Guangxi : Autonomous Region,0,0,0,0,1,0,53303,53304,0,0,0,0,0,0,58965,58965
2012,China,Hainan : Province,0,0,0,0,0,0,14867,14867,0,0,0,0,1,0,16608,16609
2012,China,Ji Lin: Province,0,0,0,1,2,0,0,3,0,0,0,0,2,0,0,2
2012,China,Jiangxi : Province,0,0,0,0,0,0,824,824,0,0,0,0,0,0,891,891
2012,China,Langfang : Point,3,2,0,2,11,3,0,21,1,3,0,6,16,2,0,28
2012,China,Nanjing : Point,0,1,0,2,5,0,0,8,1,0,0,0,8,0,0,9
2012,China,Shaanxi: Province,0,0,0,0,1,0,0,1,1,0,0,0,1,0,0,2
2012,China,Shan Dong: Province,2,0,0,0,1,0,0,3,0,1,0,2,3,0,0,6
2012,China,Shanghai : Municipality,0,0,0,0,0,0,0,0,0,0,0,0,1,0,0,1
2012,China,Tianjin : Municipality,0,0,0,0,0,0,0,0,0,0,0,0,2,0,0,2
2012,China,Wuhan : Point,6,4,0,6,67,0,0,83,4,4,0,4,58,0,0,70
2012,China,Yiwu : Point,0,0,0,0,1,0,0,1,2,0,0,0,4,0,0,6
2012,China,Yunnan : Province,0,0,0,0,0,0,21821,21821,0,0,0,0,0,0,22669,22669
2012,Côte d'Ivoire,Tabou : Departement,152,233,0,151,490,13,0,1039,166,219,0,135,507,16,0,1043
2012,Côte d'Ivoire,Guiglo : Departement,68,93,0,80,291,35,0,567,79,128,0,82,175,20,0,484
2012,Côte d'Ivoire,Abidjan : Departement,66,127,0,87,470,15,0,765,66,148,0,91,597,32,0,934
2012,Côte d'Ivoire,Cote d'Ivoire : Dispersed in the country / territory,9871,13044,0,11281,31727,2115,0,68038,10576,13396,0,12339,33841,2820,0,72972
2012,Cameroon,Adinkol : Point,27,39,0,26,78,3,0,173,34,44,0,30,49,7,0,164
2012,Cameroon,Babongo : Point,0,4,0,3,7,0,0,14,1,4,0,3,5,2,0,15
2012,Cameroon,Bafouck : Point,44,102,0,48,140,6,0,340,49,66,0,54,139,12,0,320
2012,Cameroon,Bagodo : Point,103,245,0,148,333,11,0,840,126,254,0,168,203,35,0,786
2012,Cameroon,Batoua Godole : Point,204,390,0,235,597,33,0,1459,179,399,0,248,370,52,0,1248
2012,Cameroon,Bazzama : Point,58,106,0,78,187,9,0,438,61,102,0,74,119,12,0,368
2012,Cameroon,Bedobo : Point,34,82,0,67,163,4,0,350,35,76,0,47,117,6,0,281
2012,Cameroon,Belel : Point,0,0,0,1,1,0,0,2,0,1,0,1,8,0,0,10
2012,Cameroon,Betare Oya : Point,0,0,0,0,1,0,0,1,0,0,0,0,9,0,0,9
2012,Cameroon,Borgop : Point,33,88,0,49,102,11,0,283,43,76,0,43,70,6,0,238
2012,Cameroon,Boubara : Point,42,80,0,89,194,10,0,415,39,88,0,74,164,20,0,385
2012,Cameroon,Boulembe : Point,64,134,0,94,174,13,0,479,68,116,0,76,121,11,0,392
2012,Cameroon,Bouli : Point,79,85,0,63,171,6,0,404,41,76,0,61,113,9,0,300
2012,Cameroon,Dakere Babongo : Point,49,89,0,55,128,5,0,326,54,103,0,54,77,10,0,298
2012,Cameroon,Dang Patou : Point,52,75,0,50,149,6,0,332,51,73,0,41,103,9,0,277
2012,Cameroon,Digou Adamou : Point,17,17,0,12,32,2,0,80,9,24,0,10,28,4,0,75
2012,Cameroon,Dir : Point,55,92,0,62,137,4,0,350,46,97,0,60,90,12,0,305
2012,Cameroon,Djalingo : Point,46,68,0,49,128,12,0,303,37,95,0,64,83,7,0,286
2012,Cameroon,Djohong : Point,48,78,0,49,119,6,0,300,48,64,0,36,95,12,0,255
2012,Cameroon,Douala : Point,0,0,0,0,1,0,0,1,0,0,0,0,1,0,0,1
2012,Cameroon,Fada : Point,40,65,0,48,106,6,0,265,44,70,0,40,72,11,0,237
2012,Cameroon,Gado Badzere : Point,56,97,0,77,159,14,0,403,60,100,0,81,110,16,0,367
2012,Cameroon,Gandinang : Point,2,3,0,1,3,0,0,9,0,2,0,1,2,0,0,5
2012,Cameroon,Garga Libona : Point,117,198,0,125,338,19,0,797,120,218,0,133,208,24,0,703
2012,Cameroon,Garga Sarali : Point,69,96,0,73,210,15,0,463,72,147,0,76,195,14,0,504
2012,Cameroon,Gargapela : Point,66,129,0,86,190,13,0,484,72,139,0,74,110,14,0,409
2012,Cameroon,Garoua-Boulai : Point,419,907,0,662,1561,84,0,3633,422,934,0,682,1011,107,0,3156
2012,Cameroon,Gbakim : Point,35,60,0,40,115,3,0,253,32,55,0,45,109,9,0,250
2012,Cameroon,Gbiti : Point,400,763,0,554,1589,57,0,3363,408,775,0,574,1261,145,0,3163
2012,Cameroon,Goro : Point,55,113,0,65,144,9,0,386,55,107,0,52,112,17,0,343
2012,Cameroon,Goundjel : Point,0,6,0,2,11,0,0,19,0,3,0,1,13,0,0,17
2012,Cameroon,Guiwa Yangamo : Point,53,96,0,80,175,14,0,418,75,86,0,82,126,18,0,387
2012,Cameroon,Kenzou : Point,171,399,0,319,753,41,0,1683,179,434,0,263,436,55,0,1367
2012,Cameroon,Kette : Point,76,201,0,165,417,19,0,878,91,228,0,148,291,38,0,796
2012,Cameroon,Kole : Point,26,47,0,47,88,2,0,210,19,56,0,39,44,4,0,162
2012,Cameroon,Kombo Laka : Point,56,133,0,79,198,17,0,483,69,120,0,83,187,19,0,478
2012,Cameroon,Kouba : Point,17,61,0,51,75,4,0,208,12,49,0,41,36,7,0,145
2012,Cameroon,Langui : Point,49,57,0,27,108,6,0,247,45,59,0,16,129,3,0,252
2012,Cameroon,Lokoti : Point,67,134,0,77,204,12,0,494,49,141,0,94,163,13,0,460
2012,Cameroon,Mandjou : Point,130,286,0,221,487,30,0,1154,134,282,0,191,290,41,0,938
2012,Cameroon,Mbarang : Point,67,114,0,69,157,10,0,417,77,98,0,65,102,11,0,353
2012,Cameroon,Mbewe : Point,11,18,0,17,21,2,0,69,20,11,0,7,26,4,0,68
2012,Cameroon,Mbile : Point,64,120,0,90,227,9,0,510,50,116,0,95,156,12,0,429
2012,Cameroon,Mbondo : Point,29,74,0,43,114,6,0,266,21,73,0,36,93,14,0,237
2012,Cameroon,Mbonga : Point,30,61,0,62,115,7,0,275,28,72,0,52,92,12,0,256
2012,Cameroon,Mborguene : Point,32,80,0,49,117,5,0,283,34,70,0,65,115,7,0,291
2012,Cameroon,Mboula : Point,50,102,0,72,147,10,0,381,44,102,0,45,112,18,0,321
2012,Cameroon,Mboumama : Point,82,139,0,114,285,8,0,628,101,145,0,99,237,19,0,601
2012,Cameroon,Meidougou : Point,309,534,0,405,885,41,0,2174,309,586,0,399,581,66,0,1941
2012,Cameroon,Meiganga : Point,146,352,0,255,559,24,0,1336,195,394,0,261,416,53,0,1319
2012,Cameroon,Mikila : Point,38,78,0,57,129,3,0,305,40,77,0,53,89,13,0,272
2012,Cameroon,Mimbang : Point,1,11,0,8,26,0,0,46,2,9,0,12,24,3,0,50
2012,Cameroon,Mobe : Point,26,56,0,29,100,2,0,213,27,71,0,34,62,12,0,206
2012,Cameroon,Nabemo : Point,68,100,0,73,165,6,0,412,72,125,0,70,132,14,0,413
2012,Cameroon,Nandoungue : Point,85,162,0,106,230,14,0,597,96,161,0,96,159,16,0,528
2012,Cameroon,Ndanga Gandima : Point,45,99,0,57,198,10,0,409,58,99,0,90,138,18,0,403
2012,Cameroon,Ndokayo : Point,246,396,0,304,704,36,0,1686,202,397,0,324,607,71,0,1601
2012,Cameroon,Ngaoui : Point,544,1118,0,823,1751,102,0,4338,598,1128,0,803,1113,161,0,3803
2012,Cameroon,Ngazi : Point,19,21,0,15,36,4,0,95,14,21,0,12,27,0,0,74
2012,Cameroon,Nguindi : Point,33,63,0,45,109,4,0,254,27,55,0,38,64,11,0,195
2012,Cameroon,Ngunbela : Point,10,34,0,14,72,2,0,132,16,44,0,35,44,5,0,144
2012,Cameroon,Nyabi : Point,139,325,0,264,627,29,0,1384,145,306,0,248,446,51,0,1196
2012,Cameroon,Ouro-Adde : Point,103,181,0,133,272,16,0,705,91,209,0,129,187,13,0,629
2012,Cameroon,Samba : Point,38,75,0,55,123,5,0,296,27,61,0,47,78,6,0,219
2012,Cameroon,Sandaye : Point,19,31,0,20,41,2,0,113,19,28,0,19,30,1,0,97
2012,Cameroon,Tapare : Point,12,29,0,21,40,3,0,105,14,44,0,19,30,6,0,113
2012,Cameroon,Timangolo : Point,47,77,0,48,121,10,0,303,41,69,0,61,82,11,0,264
2012,Cameroon,Toktoyo : Point,133,251,0,168,436,22,0,1010,133,321,0,167,299,38,0,958
2012,Cameroon,Tongo Gandima : Point,88,206,0,144,358,14,0,810,113,218,0,165,269,41,0,806
2012,Cameroon,Woumbou : Point,31,64,0,51,131,4,0,281,21,59,0,56,106,7,0,249
2012,Cameroon,Yamba : Point,140,296,0,171,397,26,0,1030,116,271,0,163,283,21,0,854
2012,Cameroon,Yaounde : Point,0,3,0,0,7,0,0,10,2,1,0,0,52,0,0,55
2012,Cameroon,Yarmbang : Point,72,167,0,91,242,10,0,582,71,137,0,88,141,16,0,453
2012,Cameroon,Yokosire : Point,64,139,0,133,282,19,0,637,68,155,0,112,186,41,0,562
2012,Cameroon,Zembe Borongo : Point,198,357,0,281,679,34,0,1549,204,420,0,254,382,56,0,1316
2012,Cameroon,Cameroon : Dispersed in the country / territory,711,1289,0,955,3464,102,0,6521,726,1301,0,870,4722,146,0,7765
2012,Dem. Rep. of the Congo,Zongo/Worobe,55,58,0,16,111,4,0,244,55,43,0,28,149,8,0,283
2012,Dem. Rep. of the Congo,Walungu : Point,0,4,0,1,11,0,0,16,1,6,0,0,12,0,0,19
2012,Dem. Rep. of the Congo,Uvira : Point,471,668,0,422,1215,111,0,2887,460,613,0,394,1398,96,0,2961
2012,Dem. Rep. of the Congo,Tshabobo : Point,65,102,0,28,137,5,0,337,37,89,0,31,149,11,0,317
2012,Dem. Rep. of the Congo,Shabunda : Point,42,121,0,109,510,1,0,783,32,179,0,146,563,6,0,926
2012,Dem. Rep. of the Congo,Mwenga : Point,89,144,0,102,368,8,0,711,89,134,0,83,218,10,0,534
2012,Dem. Rep. of the Congo,Mwene Ditu : Point,34,49,0,33,63,8,0,187,33,36,0,36,66,11,0,182
2012,Dem. Rep. of the Congo,Mbandaka,27,17,0,14,59,1,0,118,29,25,0,22,93,0,0,169
2012,Dem. Rep. of the Congo,Lusuku : Point,19,28,0,12,53,3,0,115,31,33,0,10,57,4,0,135
2012,Dem. Rep. of the Congo,Lubumbashi : Point,51,85,0,34,137,13,0,320,53,85,0,52,162,5,0,357
2012,Dem. Rep. of the Congo,Kinshasa : Province,432,922,0,655,2747,790,0,5546,353,800,0,708,2440,600,0,4901
2012,Dem. Rep. of the Congo,Kimaza : Point,25,55,0,22,124,2,0,228,29,52,0,35,235,18,0,369
2012,Dem. Rep. of the Congo,Katshia : Point,33,48,0,23,66,5,0,175,32,44,0,27,61,8,0,172
2012,Dem. Rep. of the Congo,Katanga : Province,1279,1950,0,1236,3181,296,0,7942,1308,2012,0,1234,3235,294,0,8083
2012,Dem. Rep. of the Congo,Kalehe : Point,116,123,0,94,383,9,0,725,130,166,0,121,435,33,0,885
2012,Dem. Rep. of the Congo,Kahemba : Point,12,21,0,29,33,4,0,99,14,42,0,33,46,7,0,142
2012,Dem. Rep. of the Congo,Kabare : Point,9,22,0,10,51,2,0,94,9,21,0,8,51,2,0,91
2012,Dem. Rep. of the Congo,Isiro : Point,4,3,0,7,14,1,0,29,2,5,0,5,18,0,0,30
2012,Dem. Rep. of the Congo,Ingbokolo : Point,110,105,0,100,327,15,0,657,94,96,0,100,278,19,0,587
2012,Dem. Rep. of the Congo,Goma : Point,89,144,0,111,216,4,0,564,74,122,0,100,203,3,0,502
2012,Dem. Rep. of the Congo,Fizi : Point,217,401,0,238,712,72,0,1640,251,448,0,232,696,76,0,1703
2012,Dem. Rep. of the Congo,Fizi (Baraka) : Point,10,19,0,11,13,2,0,55,5,21,0,9,13,9,0,57
2012,Dem. Rep. of the Congo,Equateur : Province,5563,5839,0,2839,9270,834,0,24345,5582,5938,0,2934,6976,543,0,21973
2012,Dem. Rep. of the Congo,Dungu : Point,2,0,0,2,2,0,0,6,1,0,0,0,5,0,0,6
2012,Dem. Rep. of the Congo,Doruma : Point,27,20,0,20,49,15,0,131,14,19,0,20,34,21,0,108
2012,Dem. Rep. of the Congo,Dilolo : Point,22,26,0,4,43,4,0,99,28,31,0,14,37,2,0,112
2012,Dem. Rep. of the Congo,Buta : Point,3,5,0,5,12,0,0,25,4,4,0,2,11,1,0,22
2012,Dem. Rep. of the Congo,Bukavu : Point,30,30,0,10,93,3,0,166,31,38,0,29,90,3,0,191
2012,Dem. Rep. of the Congo,Bondo : Point,107,85,0,66,330,12,0,600,106,79,0,33,299,14,0,531
2012,Dem. Rep. of the Congo,Bas-Congo : Province,1880,5252,0,3424,11412,2082,0,24050,1942,5166,0,3857,9275,1606,0,21846
2012,Dem. Rep. of the Congo,Aru : Point,13,3,0,4,22,0,0,42,9,4,0,5,3,1,0,22
2012,Dem. Rep. of the Congo,Ariwara : Point,7,41,0,41,120,57,0,266,51,77,0,65,236,96,0,525
2012,Dem. Rep. of the Congo,Aba : Point,0,0,0,0,2,0,0,2,0,0,0,0,3,0,0,3
2012,Dem. Rep. of the Congo,Nord Kivu and Sud Kivu: Provinces,2913,6779,0,4201,9441,395,0,23729,3568,5002,0,4001,7025,189,0,19785
2012,Congo,Tchiamba-Nza : Point,2,7,0,4,22,1,0,36,3,6,0,4,23,0,0,36
2012,Congo,Sangha : Departement,95,175,0,113,237,12,0,632,98,182,0,104,425,4,0,813
2012,Congo,Pool : Departement,51,76,0,53,135,1,0,316,49,89,0,42,273,2,0,455
2012,Congo,Pointe Noire : Point,25,22,0,19,84,4,0,154,19,34,0,17,189,7,0,266
2012,Congo,Oyo : Point,12,39,0,27,55,3,0,136,9,43,0,30,133,0,0,215
2012,Congo,Okoyo : District,9,18,0,0,0,0,0,27,8,13,0,0,0,0,0,21
2012,Congo,Niari : Departement,0,0,0,0,1,0,0,1,0,0,0,0,2,1,0,3
2012,Congo,Ngo : Point,16,43,0,29,42,1,0,131,16,47,0,17,168,1,0,249
2012,Congo,Banda,0,0,0,1,4,2,0,7,0,1,0,0,3,0,0,4
2012,Congo,Betou : Point,2669,4995,0,2924,7906,748,0,19242,2623,5046,0,2734,7237,451,0,18091
2012,Congo,Brazzaville : Capital,275,746,0,557,1532,63,0,3173,311,741,0,576,2341,52,0,4021
2012,Congo,Dolisie : Point,0,2,0,6,2,0,0,10,0,2,0,3,3,0,0,8
2012,Congo,Dongou : Point,627,1107,0,615,1682,205,0,4236,659,1082,0,640,1538,133,0,4052
2012,Congo,Enyelle : Point,208,412,0,215,626,76,0,1537,266,416,0,254,514,44,0,1494
2012,Congo,Impfondo : Point,1489,2728,0,1623,4459,407,0,10706,1505,2665,0,1628,4389,247,0,10434
2012,Congo,Kibangou,1,0,0,0,2,0,0,3,1,0,0,0,4,1,0,6
2012,Congo,Komi : Point,1,9,0,4,26,4,0,44,5,6,0,9,30,8,0,58
2012,Congo,Kondi Mbaka : Point,8,16,0,23,66,6,0,119,10,37,0,23,81,8,0,159
2012,Congo,Liranga : Point,1563,2697,0,1408,4222,323,0,10213,1515,2637,0,1366,3427,238,0,9183
2012,Congo,Loukolela : Point,154,277,0,137,378,14,0,960,174,295,0,137,593,22,0,1221
2012,Congo,Malolo : Point,13,45,0,15,90,14,0,177,12,39,0,30,68,9,0,158
2012,Colombia,Barcelona : Point,0,0,0,2,1,0,0,3,0,0,0,0,1,0,0,1
2012,Colombia,Bogota : Capital District,5,7,0,5,32,8,0,57,4,2,0,7,120,8,0,141
2012,Colombia,Bucaramanga,0,1,0,0,1,0,0,2,0,0,0,1,1,0,0,2
2012,Colombia,Buenaventura : Point,0,1,0,1,3,0,0,5,0,0,0,2,1,0,0,3
2012,Colombia,Cali : Point,0,0,0,0,1,0,0,1,0,0,0,0,5,1,0,6
2012,Colombia,Cartagena : Point,0,0,0,0,1,1,0,2,0,0,0,0,9,0,0,9
2012,Colombia,Colombia : Dispersed in the country / territory,0,0,0,0,0,0,2012514,2012514,0,0,0,0,0,0,1930995,1930995
2012,Colombia,Cúcuta : Point,1,0,0,0,3,0,0,4,1,0,0,2,5,1,0,9
2012,Colombia,Duitama : Point,0,0,0,0,1,0,0,1,0,0,0,1,1,0,0,2
2012,Colombia,Ibagué : Point,0,0,0,0,1,0,0,1,0,0,0,0,2,0,0,2
2012,Colombia,Leticia,0,0,0,0,2,0,0,2,0,0,0,0,2,0,0,2
2012,Colombia,Maicao : Point,0,0,0,0,1,0,0,1,1,0,0,0,0,0,0,1
2012,Colombia,Medellín : Point,0,0,0,1,8,3,0,12,0,1,0,2,14,6,0,23
2012,Colombia,Pasto,0,0,0,0,0,0,0,0,0,0,0,0,2,0,0,2
2012,Colombia,Pereira,0,0,0,0,0,0,0,0,0,0,0,0,1,0,0,1
2012,Colombia,San Andres Islas : Department,0,0,0,0,1,1,0,2,0,0,0,0,1,1,0,2
2012,Colombia,Tuluá : Point,0,0,0,0,0,0,0,0,0,0,0,0,1,0,0,1
2012,Colombia,Tumaco,0,0,0,0,0,0,0,0,0,0,0,0,2,0,0,2
2012,Colombia,Villavicencio,0,1,0,0,1,0,0,2,0,1,0,0,0,0,0,1
2012,Costa Rica,Costa Rica : Dispersed in the country / territory,436,940,0,968,6393,240,0,8977,603,1197,0,1241,8456,609,0,12106
2012,Cuba,Villa Clara : Provincia,0,0,0,0,1,0,0,1,0,0,0,0,32,0,0,32
2012,Cuba,Santiago de Cuba : Provincia,0,0,0,0,0,0,0,0,0,0,0,0,16,0,0,16
2012,Cuba,Sancti Spiritus : Provincia,0,0,0,0,0,0,0,0,0,0,0,0,26,0,0,26
2012,Cuba,Pinar del Rio : Provincia,0,0,0,0,4,0,0,4,0,0,0,0,32,0,0,32
2012,Cuba,Mayabeque : Provincia,0,0,0,0,0,0,0,0,0,0,0,0,1,0,0,1
2012,Cuba,Matanzas : Provincia,0,0,0,0,0,0,0,0,0,0,0,0,16,0,0,16
2012,Cuba,Las Tunas : Provincia,0,0,0,0,0,0,0,0,0,0,0,0,18,0,0,18
2012,Cuba,La Habana : Provincia,1,0,0,2,11,0,0,14,0,0,0,5,26,0,0,31
2012,Cuba,Holguin : Provincia,0,0,0,0,0,0,0,0,0,0,0,0,34,0,0,34
2012,Cuba,Guantánamo : Provincia,0,0,0,0,0,0,0,0,0,0,0,0,50,0,0,50
2012,Cuba,Granma : Provincia,0,0,0,0,0,0,0,0,0,0,0,0,24,0,0,24
2012,Cuba,Cienfuegos : Provincia,0,0,0,0,1,0,0,1,0,0,0,0,48,0,0,48
2012,Cuba,Ciego de Avila : Provincia,0,0,0,0,0,0,0,0,0,0,0,0,6,0,0,6
2012,Cuba,Camaguey : Point,0,0,0,0,0,0,0,0,0,0,0,0,19,0,0,19
2012,Cuba,Artemisa : Provincia,0,0,0,0,0,0,0,0,0,0,0,0,1,0,0,1
2012,Curaçao,Willemstad : Point,0,1,0,1,7,0,0,9,1,1,0,0,29,0,0,31
2012,Cayman Islands,Cayman Islands : Dispersed in the country / territory,0,0,0,0,0,0,0,0,0,0,0,0,3,0,0,3
2012,Czech Rep.,Czech Republic : Dispersed in the country / territory,0,0,0,0,0,0,1665,1665,0,0,0,0,0,0,2469,2469
2012,Germany,Germany : Dispersed in the country / territory,9648,21742,0,28747,193579,33804,0,287520,10353,23681,0,32514,290733,30496,0,387777
2012,Djibouti,Hol-Hol : Point,88,167,0,88,224,6,0,573,107,170,0,87,167,11,0,542
2012,Djibouti,Djibouti : Point,213,224,0,130,856,14,0,1437,176,264,0,133,1731,24,0,2328
2012,Djibouti,Ali-Addeh : Point,961,1483,0,1114,4824,199,0,8581,966,1485,0,967,5141,214,0,8773
2012,Denmark,Denmark : Dispersed in the country / territory,0,0,0,0,0,0,1703,1703,0,0,0,0,0,0,1920,1920
2012,Dominican Rep.,Dominican Republic : Dispersed in the country / territory,87,128,0,118,422,40,0,795,81,110,0,109,395,35,0,730
2012,Algeria,Alger : Wilaya - Province,7,4,0,4,29,0,0,44,11,9,0,10,53,1,0,84
2012,Algeria,Algeria : Dispersed in the country / territory,62,23,0,27,353,3,0,468,75,27,0,70,1089,7,0,1268
2012,Ecuador,Ecuador : Dispersed in the country / territory,770,3713,0,3863,23846,1201,0,33393,746,3850,0,4092,26332,1634,0,36654
2012,Egypt,The Red Sea,2,2,0,1,9,0,0,14,1,2,0,0,10,0,0,13
2012,Egypt,Suez,0,0,0,0,3,1,0,4,0,0,0,0,5,0,0,5
2012,Egypt,South Sinai,0,0,0,0,2,1,0,3,0,0,0,1,2,2,0,5
2012,Egypt,Sohag,0,0,0,0,0,0,0,0,0,0,0,0,1,1,0,2
2012,Egypt,Sharkia,1,4,0,5,25,4,0,39,6,8,0,5,61,2,0,82
2012,Egypt,Saloum,51,49,0,26,150,2,0,278,60,65,0,760,227,0,0,1112
2012,Egypt,Qena,0,1,0,0,4,0,0,5,0,1,0,0,2,0,0,3
2012,Egypt,Port-Said,0,1,0,2,9,1,0,13,1,1,0,2,5,3,0,12
2012,Egypt,North Sinai,0,0,0,0,3,1,0,4,0,0,0,0,19,1,0,20
2012,Egypt,New Valley,0,0,0,0,0,0,0,0,0,0,0,0,1,0,0,1
2012,Egypt,NEW LOCATION : to be defined,1,0,0,0,3,0,0,4,0,2,0,0,3,0,0,5
2012,Egypt,Monofiya,4,11,0,7,39,0,0,61,3,9,0,8,46,2,0,68
2012,Egypt,Menia,0,0,0,1,3,0,0,4,0,0,0,0,5,0,0,5
2012,Egypt,Matrouh,0,0,0,0,1,0,0,1,0,0,0,1,11,0,0,12
2012,Egypt,Luxor,0,0,0,0,0,0,0,0,0,0,0,0,5,0,0,5
2012,Egypt,Lattakia,0,0,0,1,3,0,0,4,1,1,0,0,2,0,0,4
2012,Egypt,Kalyobiya,9,22,0,10,102,6,0,149,13,8,0,16,115,9,0,161
2012,Egypt,Kafr El Shiekh,0,2,0,4,8,0,0,14,0,5,0,0,18,1,0,24
2012,Egypt,Ismailia,0,0,0,1,8,0,0,9,1,0,0,1,16,2,0,20
2012,Egypt,Idleb,0,0,0,0,0,0,0,0,0,0,0,0,1,0,0,1
2012,Egypt,Homs,0,0,0,0,4,0,0,4,0,2,0,1,3,0,0,6
2012,Egypt,Helwan : Muhafazah - Governorate,17,70,0,88,1035,32,0,1242,25,57,0,69,1033,48,0,1232
2012,Egypt,Hama,0,0,0,0,0,0,0,0,0,0,0,0,1,0,0,1
2012,Egypt,Giza : Muhafazah - Governorate,39,85,0,133,1981,84,0,2322,57,89,0,144,2380,109,0,2779
2012,Egypt,Gharbeya,1,0,0,0,15,0,0,16,0,3,0,4,31,1,0,39
2012,Egypt,Fayoum,0,0,0,0,0,0,0,0,0,0,0,0,2,0,0,2
2012,Egypt,El-Beheira,0,0,0,0,6,1,0,7,0,0,0,0,15,0,0,15
2012,Egypt,Damietta,42,46,0,56,292,15,0,451,36,55,0,64,307,19,0,481
2012,Egypt,Dakahliya,1,8,0,6,40,3,0,58,1,4,0,11,56,2,0,74
2012,Egypt,Cairo,200,376,0,459,5328,266,0,6629,193,419,0,500,7568,237,0,8917
2012,Egypt,Basrah,2603,5836,0,4845,4905,1107,0,19296,3064,3437,0,3419,8825,655,0,19400
2012,Egypt,Bani Souwaif,0,0,0,0,1,0,0,1,0,0,0,0,0,0,0,0
2012,Egypt,Aswan,0,0,0,0,2,0,0,2,0,0,0,0,18,0,0,18
2012,Egypt,Assiut,0,0,0,0,0,0,0,0,0,0,0,0,1,0,0,1
2012,Egypt,Alexandria : Muhafazah - Governorate,115,163,0,208,1044,76,0,1606,132,178,0,251,1243,104,0,1908
2012,Egypt,Aleppo,0,1,0,0,1,0,0,2,0,0,0,3,2,0,0,5
2012,Egypt,6th October : Muhafazah - Governorate,130,215,0,212,1260,92,0,1909,137,195,0,200,1595,131,0,2258
2012,Egypt,Egypt : Dispersed in the country / territory,7861,10910,0,6978,18291,1152,0,45192,8582,8180,0,12168,17897,714,0,47541
2012,Eritrea,Gesh Barka,17,10,0,2,30,0,0,59,13,14,0,11,51,1,0,90
2012,Eritrea,Emkulu : Point,307,424,0,228,646,30,0,1635,367,436,0,262,713,33,0,1811
2012,Eritrea,Asmara : Point,5,10,0,4,21,0,0,40,2,11,0,7,22,1,0,43
2012,Estonia,Illuka : Vald - Rural Municipality,0,0,0,0,1,1,0,2,0,0,0,0,5,0,0,5
2012,Estonia,Estonia : Dispersed in the country / territory,0,0,0,0,9,0,0,9,2,2,0,0,50,0,0,54
2012,Ethiopia,Tongo Camp : Point,936,1172,0,544,1878,166,0,4696,1025,1167,0,639,1840,163,0,4834
2012,Ethiopia,Shimelba (Shire/Shiraro) : Point,444,477,0,338,1398,167,0,2824,483,461,0,364,2028,178,0,3514
2012,Ethiopia,Sherkole : Point,707,895,0,455,1423,42,0,3522,755,923,0,604,1691,56,0,4029
2012,Ethiopia,Sheder : Point,978,1514,0,929,2694,146,0,6261,1061,1661,0,1030,1797,72,0,5621
2012,Ethiopia,Melkadida : Point,4576,7226,0,2742,7808,428,0,22780,4774,7406,0,2961,3983,461,0,19585
2012,Ethiopia,Mai-Ayni : Point,577,455,0,543,3808,41,0,5424,656,459,0,1542,7701,60,0,10418
2012,Ethiopia,Kobe Camp : Point,3741,4857,0,1618,5660,450,0,16326,3809,5154,0,1921,3940,506,0,15330
2012,Ethiopia,Kebribeyah : Point,1278,2295,0,1041,3326,202,0,8142,1261,2355,0,1083,2919,249,0,7867
2012,Ethiopia,Hilaweyn : Point,3716,5037,0,1681,5655,328,0,16417,3738,5130,0,1866,3445,364,0,14543
2012,Ethiopia,Fugnido : Point,3782,4388,0,2557,8147,458,0,19332,3706,4654,0,2811,3633,111,0,14915
2012,Ethiopia,Dollo Ado Transit Centre : Point,58,63,0,10,61,9,0,201,55,73,0,17,25,4,0,174
2012,Ethiopia,Buramino : Point,4662,5400,0,1841,6358,393,0,18654,4565,5513,0,2035,4037,403,0,16553
2012,Ethiopia,Borena : Awrajja - Zone,301,344,0,231,571,101,0,1548,315,359,0,165,413,92,0,1344
2012,Ethiopia,Bokolmanyo : Point,4303,6595,0,2433,7662,414,0,21407,4278,6828,0,2940,4519,451,0,19016
2012,Ethiopia,Berhale : Point,810,1330,0,541,2034,79,0,4794,873,1458,0,686,2182,218,0,5417
2012,Ethiopia,Bambasi Camp,1460,1328,0,641,2547,216,0,6192,1502,1366,0,705,2221,213,0,6007
2012,Ethiopia,Awbarre : Point,947,1951,0,1165,2954,181,0,7198,824,1896,0,1271,2044,98,0,6133
2012,Ethiopia,Asaita : Point,314,492,0,282,1054,77,0,2219,392,602,0,370,1424,79,0,2867
2012,Ethiopia,Adiharush : Point,390,772,0,553,3896,31,0,5642,427,823,0,981,15613,81,0,17925
2012,Ethiopia,Ad-Damazin Transit Centre : Point,274,321,0,130,615,60,0,1400,300,313,0,170,599,84,0,1466
2012,Ethiopia,Addis Ababa : Astedader akabibi - Chartered City,208,299,0,226,1041,43,0,1817,207,353,0,242,1610,118,0,2530
2012,Finland,Finland : Dispersed in the country / territory,0,0,0,0,0,0,1467,1467,0,0,0,0,0,0,2431,2431
2012,Fiji,Suva : Point,0,0,0,2,3,0,0,5,0,1,0,0,7,0,0,8
2012,France,France : Dispersed in the country / territory,0,0,0,0,0,0,83827,83827,0,0,0,0,0,0,117617,117617
2012,Gabon,Tchibanga : Point,1,8,0,9,41,0,0,59,1,10,0,7,32,1,0,51
2012,Gabon,Rebe : Point,0,0,0,0,1,0,0,1,0,0,0,0,0,0,0,0
2012,Gabon,Port-Gentil : Point,0,8,0,5,37,4,0,54,0,6,0,4,100,17,0,127
2012,Gabon,Pana/Dienga : Point,0,0,0,0,0,0,0,0,0,0,0,0,2,0,0,2
2012,Gabon,Oyem : Point,0,0,0,1,4,0,0,5,0,0,0,1,8,0,0,9
2012,Gabon,Okondja : Point,0,5,0,1,4,0,0,10,0,2,0,0,38,1,0,41
2012,Gabon,Ntoum : Point,0,0,0,1,1,0,0,2,0,1,0,0,1,0,0,2
2012,Gabon,Ngwoni : Point,0,1,0,0,3,0,0,4,0,0,0,0,4,0,0,4
2012,Gabon,Ndjole : Point,0,0,0,0,0,0,0,0,0,0,0,0,5,0,0,5
2012,Gabon,Ndende : Point,0,0,0,1,1,0,0,2,0,0,0,1,3,0,0,4
2012,Gabon,Mounana : Point,0,3,0,2,7,0,0,12,0,1,0,2,54,2,0,59
2012,Gabon,Moulengui Binza,0,1,0,2,0,0,0,3,0,0,0,1,1,0,0,2
2012,Gabon,Mouila : Point,0,4,0,9,38,1,0,52,0,9,0,11,61,4,0,85
2012,Gabon,Moanda : Point,1,9,0,13,43,1,0,67,0,6,0,17,113,6,0,142
2012,Gabon,Mitzic : Point,0,0,0,0,1,0,0,1,0,0,0,0,3,0,0,3
2012,Gabon,Mekambo : Point,0,0,0,0,0,0,0,0,0,0,0,0,2,2,0,4
2012,Gabon,Mayumba : Point,0,0,0,0,1,0,0,1,0,0,0,0,1,0,0,1
2012,Gabon,Makokou : Point,0,0,0,0,7,0,0,7,0,0,0,1,16,0,0,17
2012,Gabon,Libreville : Point,25,112,0,135,591,22,0,885,29,114,0,131,1046,103,0,1423
2012,Gabon,Lastoursville : Point,1,0,0,5,11,1,0,18,0,6,0,4,22,2,0,34
2012,Gabon,Lambarene : Point,0,0,0,1,3,0,0,4,0,1,0,0,11,1,0,13
2012,Gabon,Koulamoutou : Point,1,11,0,13,45,2,0,72,0,9,0,12,101,4,0,126
2012,Gabon,Gamba : Point,0,1,0,2,1,0,0,4,0,1,0,0,5,1,0,7
2012,Gabon,Franceville : Point,4,42,0,31,187,3,0,267,8,54,0,27,513,15,0,617
2012,Gabon,Dilemba : Point,1,3,0,1,7,2,0,14,1,1,0,1,4,1,0,8
2012,Gabon,Booue : Point,0,1,0,1,1,0,0,3,0,1,0,0,5,0,0,6
2012,Gabon,Bongoville : Point,0,0,0,0,0,0,0,0,0,0,0,0,1,0,0,1
2012,Gabon,Bitam : Point,0,0,0,0,2,0,0,2,0,1,0,0,5,0,0,6
2012,Gabon,Akieni : Point,0,2,0,1,3,0,0,6,0,2,0,4,3,0,0,9
2012,Georgia,Zugdidi : Raion - District,2,3,0,1,5,0,0,11,4,0,0,0,5,0,0,9
2012,Georgia,Vale : Point,0,0,0,0,2,0,0,2,0,0,0,0,1,0,0,1
2012,Georgia,Tbilisi : City,0,2,0,0,11,1,0,14,1,4,0,2,20,0,0,27
2012,Georgia,Rustavi,0,0,0,0,0,0,0,0,0,0,0,0,1,0,0,1
2012,Georgia,Martqop’i : Point,0,0,0,0,2,0,0,2,0,0,0,0,7,1,0,8
2012,Georgia,Georgia : Dispersed in the country / territory,24,47,0,52,675,136,0,934,21,59,0,72,685,106,0,943
2012,Ghana,Volta : Region,69,161,0,43,469,11,0,753,71,149,0,27,453,7,0,707
2012,Ghana,Kumasi : District,0,0,0,0,1,0,0,1,0,2,0,0,5,0,0,7
2012,Ghana,Krisan : Point,27,47,0,33,113,7,0,227,27,36,0,80,232,9,0,384
2012,Ghana,Fetentaa : Point,98,127,0,87,438,10,0,760,89,94,0,85,475,6,0,749
2012,Ghana,Egyeikroum : Point,109,139,0,99,476,18,0,841,114,129,0,103,501,8,0,855
2012,Ghana,Buduburam : Point,37,182,0,230,2138,22,0,2609,30,146,0,227,2028,44,0,2475
2012,Ghana,Ampain : Point,270,340,0,324,1222,52,0,2208,310,342,0,281,924,24,0,1881
2012,Ghana,Accra : District,103,159,0,187,1018,26,0,1493,101,170,0,234,1888,70,0,2463
2012,Ghana,Ghana : Dispersed in the country / territory,9,7,0,9,81,1,0,107,5,9,0,11,74,2,0,101
2012,Guinea,Nzerekore : Prefecture,4,2,0,14,106,6,0,132,4,2,0,12,93,8,0,119
2012,Guinea,Macenta : Prefecture,329,634,0,567,1267,81,0,2878,266,551,0,580,1075,61,0,2533
2012,Guinea,Laine : Point,17,59,0,73,220,14,0,383,8,62,0,75,206,10,0,361
2012,Guinea,Kountaya : Point,2,8,0,10,32,3,0,55,8,12,0,11,16,6,0,53
2012,Guinea,Kouankan : Point,56,128,0,125,372,29,0,710,52,141,0,132,355,40,0,720
2012,Guinea,Conakry : Special Zone,93,148,0,192,732,10,0,1175,84,187,0,205,1044,27,0,1547
2012,Guinea,Beyla : Prefecture,27,31,0,11,70,4,0,143,27,25,0,13,25,4,0,94
2012,Gambia,Gambia : Dispersed in the country / territory,781,1103,0,680,2344,308,0,5216,823,1054,0,686,1778,296,0,4637
2012,Guinea-Bissau,Sao Domingos : Point,174,348,0,170,841,141,0,1674,209,380,0,172,531,105,0,1397
2012,Guinea-Bissau,Jolmete : Point,33,33,0,42,99,7,0,214,20,47,0,35,77,8,0,187
2012,Guinea-Bissau,Canchungo : Point,69,118,0,81,240,32,0,540,47,138,0,78,166,23,0,452
2012,Guinea-Bissau,Bissau : Autonomous Sector,9,8,0,5,28,0,0,50,7,7,0,4,115,0,0,133
2012,Guinea-Bissau,Biombo : Region,2,1,0,0,3,0,0,6,0,0,0,0,0,1,0,1
2012,Guinea-Bissau,Bigene : Point,187,390,0,212,849,85,0,1723,201,387,0,224,606,96,0,1514
2012,Guinea-Bissau,Guinea-Bissau : Dispersed in the country / territory,0,0,0,0,0,0,0,0,0,0,0,0,1,0,0,1
2012,Guatemala,Guatemala : Municipio,1,2,0,1,63,9,0,76,0,5,0,2,72,7,0,86
2012,Guyana,Guyana : Dispersed in the country / territory,0,0,0,1,3,0,0,4,0,1,0,1,1,0,0,3
2012,"China, Hong Kong SAR","Hong Kong SAR, China : Dispersed in the country / territory",32,22,0,13,384,1,0,452,26,20,0,14,439,2,0,501
2012,Honduras,Trujillo : Municipio,0,0,0,0,0,0,0,0,0,0,0,0,5,0,0,5
2012,Honduras,Tegucigalpa : Municipio,0,0,0,0,3,0,0,3,0,0,0,0,2,0,0,2
2012,Honduras,Islas de la Bahia : Departamento,0,0,0,0,2,0,0,2,0,0,0,0,0,0,0,0
2012,Honduras,Honduras : Dispersed in the country / territory,0,0,0,0,2,0,0,2,0,0,0,0,0,0,0,0
2012,Honduras,Comayagua : Departamento,0,0,0,0,1,0,0,1,0,0,0,0,0,0,0,0
2012,Honduras,Ceiba : Municipio,0,0,0,0,0,0,0,0,0,0,0,0,2,0,0,2
2012,Croatia,Vinkovci : Point,0,0,0,0,1,0,0,1,0,0,0,0,0,0,0,0
2012,Croatia,Rijeka : Point,0,0,0,0,0,0,0,0,0,0,0,0,2,0,0,2
2012,Croatia,Kutina : Point,1,0,0,0,5,0,0,6,4,5,0,12,73,0,0,94
2012,Croatia,Jezevo : Point,0,0,0,0,0,0,0,0,0,0,0,0,9,0,0,9
2012,Croatia,Grad Zagreb : Grad - City,10,15,0,12,52,0,0,89,8,13,0,18,178,1,0,218
2012,Croatia,Bjelovar : Point,0,0,0,0,0,0,0,0,0,0,0,0,1,0,0,1
2012,Croatia,Croatia : Dispersed in the country / territory,3,12,0,7,177,135,10401,10735,3,17,0,29,219,68,9603,9939
2012,Haiti,Port au Prince : Point,0,0,0,0,0,0,0,0,0,0,0,0,12,0,0,12
2012,Hungary,Debrecen : Megyei jogu varos - City with County Rights,0,0,0,0,0,0,69,69,0,0,0,0,0,0,317,317
2012,Indonesia,Yogyakarta Province,0,0,0,0,0,0,0,0,0,1,0,49,0,0,0,50
2012,Indonesia,Sumatera Utara Province,17,7,0,64,18,2,0,108,17,24,0,487,20,6,0,554
2012,Indonesia,Sumatera Barat Province,0,0,0,0,0,0,0,0,0,0,0,1,0,0,0,1
2012,Indonesia,Sulawesi Utara Province,0,0,0,0,0,0,0,0,0,8,0,76,0,1,0,85
2012,Indonesia,Sulawesi Selatan Province,11,6,0,49,10,0,0,76,6,15,0,180,15,4,0,220
2012,Indonesia,Semarang,1,0,0,1,0,1,0,3,0,0,0,4,1,0,0,5
2012,Indonesia,Riau Province,4,9,0,24,5,1,0,43,4,7,0,62,1,2,0,76
2012,Indonesia,Nusa Tenggara Timur Province,1,0,0,13,2,0,0,16,2,12,0,110,3,2,0,129
2012,Indonesia,Kepulauan Riau Province,0,1,0,4,3,1,0,9,0,42,0,264,2,8,0,316
2012,Indonesia,Kalimantan Barat Province,0,0,0,0,0,0,0,0,0,2,0,47,0,0,0,49
2012,Indonesia,Jawa Barat-Province,76,75,0,425,89,9,0,674,69,458,0,2771,137,40,0,3475
2012,Indonesia,Jakarta-Province,30,30,0,220,55,5,0,340,43,104,0,709,61,11,0,928
2012,Indonesia,Cilegon,2,0,0,4,0,0,0,6,0,20,0,125,1,7,0,153
2012,Indonesia,Bangil,1,0,0,4,2,0,0,7,2,14,0,59,0,2,0,77
2012,Indonesia,Bandar Lampung,4,2,0,6,2,0,0,14,1,3,0,70,2,0,0,76
2012,Indonesia,Bali-Province,3,2,0,12,5,0,0,22,2,13,0,40,4,2,0,61
2012,Indonesia,Indonesia : Dispersed in the country / territory,15,7,0,33,16,0,0,71,8,30,0,240,19,4,0,301
2012,India,Tamil Nadu : State,0,0,0,0,0,0,33206,33206,0,0,0,0,0,0,33959,33959
2012,India,Delhi : District,782,1450,0,1264,6806,495,0,10797,854,1493,0,1647,6801,458,0,11253
2012,Ireland,Ireland : Dispersed in the country / territory,0,0,0,0,0,0,359,359,0,0,0,0,0,0,439,439
2012,Iran (Islamic Rep. of),Ziveh,17,30,0,37,129,11,0,224,14,29,0,30,112,12,0,197
2012,Iran (Islamic Rep. of),Varmahang,1,1,0,2,2,0,0,6,0,0,0,0,3,0,0,3
2012,Iran (Islamic Rep. of),Torbat e Jam,137,255,0,300,1173,106,0,1971,139,260,0,323,1254,160,0,2136
2012,Iran (Islamic Rep. of),Taft,30,41,0,105,218,12,0,406,39,80,0,87,255,19,0,480
2012,Iran (Islamic Rep. of),Sultanieh : Point,0,0,0,0,4,3,0,7,0,0,0,0,5,5,0,10
2012,Iran (Islamic Rep. of),Saveh,433,650,0,518,961,92,0,2654,483,550,0,637,1007,147,0,2824
2012,Iran (Islamic Rep. of),Sarvestan,24,30,0,32,99,6,0,191,28,33,0,33,94,12,0,200
2012,Iran (Islamic Rep. of),Mohajerin,234,253,0,330,920,84,0,1821,227,300,0,302,894,109,0,1832
2012,Iran (Islamic Rep. of),Meybod,52,107,0,110,277,16,0,562,62,103,0,120,302,23,0,610
2012,Iran (Islamic Rep. of),Khuzestan Province,0,1,0,0,3,0,0,4,1,0,0,0,3,0,0,4
2012,Iran (Islamic Rep. of),Dilzeh,6,10,0,15,33,5,0,69,15,10,0,15,39,2,0,81
2012,Iran (Islamic Rep. of),Bezileh,2,3,0,3,23,1,0,32,1,4,0,5,17,1,0,28
2012,Iran (Islamic Rep. of),Bani Najjar,155,151,0,190,673,27,0,1196,164,152,0,180,635,33,0,1164
2012,Iran (Islamic Rep. of),Ardakan,151,227,0,250,619,30,0,1277,162,230,0,258,686,45,0,1381
2012,Iran (Islamic Rep. of),Abazar,3,10,0,12,47,7,0,79,7,10,0,16,65,2,0,100
2012,Iran (Islamic Rep. of),Tehran County : Shahrestan - County,0,3,0,2,7,0,0,12,1,2,0,1,13,0,0,17
2012,Iran (Islamic Rep. of),Sonqor : Shahrestan - County,1,5,0,6,19,3,0,34,1,6,0,7,15,2,0,31
2012,Iran (Islamic Rep. of),Rafsanjan : Shahrestan - County,376,550,0,583,586,204,0,2299,374,520,0,651,565,265,0,2375
2012,Iran (Islamic Rep. of),Markazi : Ostan - Province,1,2,0,4,11,0,0,18,3,9,0,2,13,0,0,27
2012,Iran (Islamic Rep. of),Khorasan : Ostan - Province,0,0,0,0,0,0,0,0,0,0,0,0,2,0,0,2
2012,Iran (Islamic Rep. of),Kerman County : Shahrestan - County,0,0,0,0,0,0,0,0,0,0,0,1,2,0,0,3
2012,Iran (Islamic Rep. of),Jahrom : Shahrestan - County,8,15,0,18,60,7,0,108,6,10,0,14,60,4,0,94
2012,Iran (Islamic Rep. of),Dalaki Bushehr province,25,9,0,10,22,2,0,68,23,7,0,10,18,0,0,58
2012,Iran (Islamic Rep. of),Bardsir : Shahrestan - County,236,250,0,279,579,32,0,1376,230,260,0,279,584,29,0,1382
2012,Iraq,Wassit,2264,5082,0,4218,4218,956,0,16738,2667,2961,0,2961,7648,571,0,16808
2012,Iraq,Thi-Qar,1967,4414,0,3664,3664,830,0,14539,2316,2571,0,2571,6642,495,0,14595
2012,Iraq,Sulaymaniyah,306,564,0,504,2046,145,0,3565,366,572,0,709,4170,192,0,6009
2012,Iraq,Salah al-Din,3274,7348,0,6100,6100,1382,0,24204,3856,4283,0,4282,11058,824,0,24303
2012,Iraq,Qadissyah,1024,2309,0,1907,1911,433,0,7584,1209,1342,0,1340,3462,257,0,7610
2012,Iraq,Ninewa,541,1207,0,999,1251,259,0,4257,626,740,0,768,1979,169,0,4282
2012,Iraq,Najaf,1993,4481,0,3712,3728,841,0,14755,2351,2609,0,2610,6747,503,0,14820
2012,Iraq,Muthanna,515,1156,0,959,959,218,0,3807,606,673,0,673,1739,130,0,3821
2012,Iraq,Missan,1033,2317,0,1923,1923,435,0,7631,1216,1349,0,1351,3490,260,0,7666
2012,Iraq,Makhmour : Point,795,1452,0,598,2268,169,0,5282,741,1343,0,661,2346,179,0,5270
2012,Iraq,Kirkuk,3293,7389,0,6134,6135,1390,0,24341,3878,4305,0,4304,11122,829,0,24438
2012,Iraq,Kerbala,329,735,0,609,619,142,0,2434,390,430,0,429,1113,82,0,2444
2012,Iraq,Iraq : Dispersed in the country / territory,3,3,0,6,4,0,0,16,2,6,0,10,3,0,0,21
2012,Iraq,Erbil,5510,11593,0,9569,11717,2154,0,40543,6417,7119,0,7246,24305,1335,0,46422
2012,Iraq,Dohuk   ,6972,15648,0,12989,12989,2944,0,51542,8212,9115,0,9115,23550,1756,0,51748
2012,Iraq,Diyala,2900,6505,0,5400,5400,1224,0,21429,3413,3790,0,3790,9791,730,0,21514
2012,Iraq,Dahuk,3265,2988,0,1821,8520,372,0,16966,3362,3159,0,3271,20026,326,0,30144
2012,Iraq,Baghdad,14296,32011,0,26782,28846,6346,0,108281,16814,18923,0,19069,50223,4006,0,109035
2012,Iraq,Babylon,2440,5476,0,4546,4546,1030,0,18038,2874,3190,0,3190,8241,615,0,18110
2012,Iraq,Anbar/AlQaim,938,1034,0,532,1984,170,0,4658,964,1011,0,568,1401,114,0,4058
2012,Iraq,Anbar,3713,8359,0,6912,6956,1566,0,27506,4373,4880,0,4852,12595,936,0,27636
2012,Iceland,Reykjavik : Region,0,0,0,0,0,0,52,52,0,0,0,0,0,0,67,67
2012,Iceland,Reykjavik : Point,2,0,0,0,10,0,0,12,1,2,0,1,52,1,0,57
2012,Iceland,Iceland : Dispersed in the country / territory,3,1,0,5,14,0,0,23,1,3,0,1,31,0,0,36
2012,Israel,Israel : Dispersed in the country / territory,412,329,0,356,7134,150,0,8381,450,329,0,760,43961,250,0,45750
2012,Italy,Italy : Dispersed in the country / territory,0,0,0,0,0,0,2293,2293,0,0,0,0,0,0,12037,12037
2012,Jamaica,Jamaica : Dispersed in the country / territory,1,0,0,0,6,0,0,7,0,2,0,2,9,0,0,13
2012,Jordan,Zarqa : Governorate,564,785,0,526,1737,124,0,3736,625,853,0,567,1744,98,0,3887
2012,Jordan,Tafilah : Governorate,16,18,0,9,30,3,0,76,25,27,0,10,26,3,0,91
2012,Jordan,Mafraq : Governorate,6133,6342,0,4649,12751,834,0,30709,4742,5993,0,4869,11026,500,0,27130
2012,Jordan,Madaba : Governorate,64,85,0,51,199,20,0,419,53,110,0,71,223,14,0,471
2012,Jordan,Ma'an : Governorate,135,141,0,105,379,25,0,785,125,163,0,115,403,30,0,836
2012,Jordan,Karak : Governorate,102,121,0,59,282,24,0,588,106,139,0,92,280,17,0,634
2012,Jordan,Jarash : Governorate,144,154,0,129,324,24,0,775,136,162,0,129,288,18,0,733
2012,Jordan,Irbid : Governorate,2453,3205,0,2073,6431,387,0,14549,2681,3370,0,2287,6116,285,0,14739
2012,Jordan,Balqa : Governorate,61,86,0,55,196,18,0,416,61,84,0,71,215,16,0,447
2012,Jordan,Aqaba : Governorate,32,52,0,31,148,9,0,272,49,43,0,43,145,12,0,292
2012,Jordan,Amman : Governorate,2514,3582,0,2576,12068,1834,0,22574,2663,3740,0,2769,13152,1578,0,23902
2012,Jordan,Ajlun : Governorate,93,116,0,96,235,14,0,554,106,134,0,73,185,14,0,512
2012,Jordan,Jordan : Dispersed in the country / territory,12728,15354,0,10770,36937,3755,0,79544,11791,15489,0,11573,35380,2739,0,76972
2012,Japan,Japan : Dispersed in the country / territory,0,0,0,0,0,0,1923,1923,0,0,0,0,0,0,6197,6197
2012,Kazakhstan,Zhambyl Oblast,0,0,0,0,0,0,0,0,0,0,0,0,2,0,0,2
2012,Kazakhstan,South Kazakhstan : Region - Oblast,6,11,0,7,21,2,0,47,1,6,0,5,43,2,0,57
2012,Kazakhstan,Astana city,0,0,0,0,0,0,0,0,0,0,0,0,1,0,0,1
2012,Kazakhstan,Almaty Oblast,3,2,0,1,20,1,0,27,1,4,0,3,19,0,0,27
2012,Kazakhstan,Almaty : City,22,35,0,28,136,3,0,224,31,32,0,33,162,6,0,264
2012,Kazakhstan,Kazakhstan : Dispersed in the country / territory,0,147,0,306,1294,103,0,1850,0,171,0,318,1267,69,0,1825
2012,Kenya,Nairobi : Province,1927,3790,0,3273,17009,802,0,26801,1968,3871,0,3303,16820,610,0,26572
2012,Kenya,Kambioos : Point,1984,2696,0,931,3165,304,0,9080,2087,3098,0,1194,2426,241,0,9046
2012,Kenya,Kakuma : Point,8627,11247,0,7395,21410,969,0,49648,8942,13056,0,10740,24285,534,0,57557
2012,Kenya,Ifo : Point,8648,12386,0,6592,21276,1553,0,50455,8795,13062,0,7573,16947,1462,0,47839
2012,Kenya,Ifo 2 W : Point,4229,5837,0,1846,7441,662,0,20015,4599,6468,0,2427,5599,583,0,19676
2012,Kenya,Ifo 2 E : Point,3332,4463,0,1519,5222,412,0,14948,3430,5133,0,2077,3619,371,0,14630
2012,Kenya,Hagadera : Point,10924,15922,0,8932,30895,2598,0,69271,11606,16619,0,10615,28889,2483,0,70212
2012,Kenya,Dagahaley : Point,10602,16621,0,7786,25030,2152,0,62191,10785,17338,0,8835,19990,1988,0,58936
2012,Kyrgyzstan,Ysyk-kol : Oblast - Region,0,0,0,0,265,258,0,523,0,0,0,0,263,110,0,373
2012,Kyrgyzstan,Talas : Oblast - Region,0,0,0,0,215,163,0,378,0,0,0,0,127,79,0,206
2012,Kyrgyzstan,Osh City : Shaar - City,2,4,0,1,283,145,0,435,1,3,0,2,168,111,0,285
2012,Kyrgyzstan,Osh : Oblast - Region,220,648,0,280,941,497,0,2586,180,464,0,260,694,281,0,1879
2012,Kyrgyzstan,Naryn : Oblast - Region,0,0,0,0,237,199,0,436,0,0,0,0,311,87,0,398
2012,Kyrgyzstan,Jalal-abad : Oblast - Region,360,682,0,180,426,303,0,1951,430,473,0,300,1044,318,0,2565
2012,Kyrgyzstan,Chuy : Oblast - Region,0,0,0,0,412,327,0,739,0,0,0,0,279,114,0,393
2012,Kyrgyzstan,Bishkek : Shaar - City,12,58,0,44,294,116,0,524,25,45,0,51,485,63,0,669
2012,Kyrgyzstan,Batken : Oblast - Region,79,121,0,0,345,328,0,873,129,168,0,21,496,154,0,968
2012,Kyrgyzstan,Kyrgyzstan : Dispersed in the country / territory,7910,10660,0,10060,52900,5870,2304,89704,8970,11890,0,11540,48000,4200,2200,86800
2012,Cambodia,Cambodia : Dispersed in the country / territory,1,0,0,0,3,0,0,4,0,1,0,0,20,0,0,21
2012,Cambodia,Phnom Penh Urban : Point,0,1,0,4,13,4,0,22,1,6,0,7,38,2,0,54
2012,Saint Kitts and Nevis,Saint Kitts and Nevis : Dispersed in the country / territory,0,0,0,0,0,0,0,0,0,0,0,0,1,0,0,1
2012,Rep. of Korea,Yeosu,0,0,0,0,0,0,0,0,0,0,0,0,1,0,0,1
2012,Rep. of Korea,Yangju,0,0,0,0,1,0,0,1,0,0,0,0,2,0,0,2
2012,Rep. of Korea,Whasung : Point,0,0,0,0,3,1,0,4,0,0,0,0,11,1,0,12
2012,Rep. of Korea,Suwon : Point,0,0,0,0,0,0,0,0,0,0,0,0,6,1,0,7
2012,Rep. of Korea,Republic of Korea : Dispersed in country,0,0,0,0,0,0,111,111,0,0,0,0,0,0,68,68
2012,Rep. of Korea,Pohang : Point,0,0,0,0,0,0,0,0,0,0,0,0,1,0,0,1
2012,Rep. of Korea,Inchon : Do - Province,0,1,0,0,2,0,0,3,0,0,0,0,15,0,0,15
2012,Rep. of Korea,Daejeon : Gwangyeoksi - Metropolitan City,0,0,0,0,1,1,0,2,0,0,0,0,1,1,0,2
2012,Rep. of Korea,Daegu : Gwangyeoksi - Metropolitan City,0,0,0,0,2,0,0,2,0,0,0,0,1,0,0,1
2012,Rep. of Korea,Cheongju : Point,0,1,0,0,1,0,0,2,0,0,0,0,3,0,0,3
2012,Rep. of Korea,Seoul : Teukbyeolsi - Capital Metropolitan City,21,19,0,2,218,5,0,265,25,20,0,13,1433,6,0,1497
2012,Kuwait,Kuwait : Dispersed in the country / territory,46,97,0,92,406,30,0,671,65,136,0,118,486,27,0,832
2012,Lebanon,Mont Liban : Mohafazat - Governorates,681,698,0,421,2252,181,0,4233,640,748,0,486,3409,180,0,5463
2012,Lebanon,Liban Sud : Mohafazat - Governorates,787,775,0,452,1663,69,0,3746,878,798,0,438,1601,76,0,3791
2012,Lebanon,Liban Nord : Mohafazat - Governorates,6276,6058,0,4127,15532,960,0,32953,6626,6515,0,4252,13329,774,0,31496
2012,Lebanon,Beyrouth : Qadaa - District,285,336,0,185,878,44,0,1728,305,341,0,168,1335,64,0,2213
2012,Lebanon,Beqaa : Mohafazat - Governorates,5144,4951,0,3265,11413,770,0,25543,5439,5272,0,3342,9999,634,0,24686
2012,Liberia,Solo : Point,583,584,0,256,1318,145,0,2886,610,646,0,337,1126,100,0,2819
2012,Liberia,Saclepea : Point,108,139,0,117,247,14,0,625,97,122,0,107,243,14,0,583
2012,Liberia,River Ghee : County,175,223,0,67,368,25,0,858,207,239,0,62,158,5,0,671
2012,Liberia,PTP : Point,945,1058,0,431,2115,136,0,4685,917,1000,0,544,2104,103,0,4668
2012,Liberia,Nimba : County,981,1308,0,442,2435,207,0,5373,936,1347,0,502,1018,210,0,4013
2012,Liberia,Monrovia : Point,31,50,0,65,235,4,0,385,23,45,0,53,451,10,0,582
2012,Liberia,Maryland : County,452,584,0,111,1119,93,0,2359,460,679,0,201,645,43,0,2028
2012,Liberia,Little Wlebbo : Point,999,1110,0,467,1884,102,0,4562,964,1061,0,440,1313,59,0,3837
2012,Liberia,Liberia : Dispersed in the country / territory,0,0,0,0,0,0,15526,15526,0,0,0,0,0,0,13852,13852
2012,Liberia,Grand Gedeh : County,873,1036,0,397,3227,495,0,6028,800,1070,0,523,2352,271,0,5016
2012,Liberia,Dougee : Point,539,557,0,237,1196,167,0,2696,543,661,0,319,845,64,0,2432
2012,Liberia,Bahn : Point,959,1253,0,438,2049,115,0,4814,963,1299,0,469,1190,116,0,4037
2012,Libya,Tripoli : Popularate,530,1024,0,1895,2236,199,0,5884,551,1152,0,2186,3518,326,0,7733
2012,Saint Lucia,Castries : Point,0,0,0,0,0,0,0,0,0,0,0,0,3,0,0,3
2012,Sri Lanka,Vavuniya : District,13,24,0,16,90,30,0,173,9,27,0,18,109,23,0,186
2012,Sri Lanka,Trincomalee : District,14,24,0,21,93,10,0,162,19,26,0,28,95,10,0,178
2012,Sri Lanka,Sri Lanka : Dispersed in the country / territory,0,2,0,2,2,2,0,8,0,2,0,2,4,2,0,10
2012,Sri Lanka,Puttalam : District,0,0,0,0,1,0,0,1,1,1,0,0,1,0,0,3
2012,Sri Lanka,Mullaitivu : District,2,1,0,0,3,1,0,7,0,0,0,0,2,1,0,3
2012,Sri Lanka,Matale : District,0,2,0,0,2,0,0,4,2,1,0,0,3,0,0,6
2012,Sri Lanka,Mannar : District,11,33,0,19,105,16,0,184,10,32,0,22,124,16,0,204
2012,Sri Lanka,Kilinochchi : District,4,4,0,5,28,3,0,44,0,2,0,4,23,1,0,30
2012,Sri Lanka,Kandy : District,0,0,0,0,0,0,0,0,0,0,0,0,1,0,0,1
2012,Sri Lanka,Jaffna : District,8,13,0,9,69,15,0,114,6,19,0,22,62,13,0,122
2012,Sri Lanka,Gampaha : District,8,15,0,10,39,2,0,74,14,6,0,9,58,1,0,88
2012,Sri Lanka,Colombo : District,8,17,0,14,69,2,0,110,12,22,0,10,80,2,0,126
2012,Sri Lanka,Batticaloa : District,1,0,0,1,2,0,0,4,0,1,0,2,3,0,0,6
2012,Sri Lanka,Ampara : District,0,0,0,0,2,0,0,2,0,0,0,0,3,0,0,3
2012,Lesotho,Maseru : District,0,1,0,1,10,0,0,12,2,2,0,2,19,0,0,25
2012,Lithuania,RRC Rukla : Point,2,1,0,0,8,0,0,11,0,0,0,2,15,0,0,17
2012,Lithuania,Klaipeda: Savivaldybe-Municipality,0,0,0,1,1,0,0,2,0,0,0,1,0,0,0,1
2012,Lithuania,Kaunas : Savivaldybe - Municipality,3,1,0,0,4,0,0,8,1,0,0,0,6,0,0,7
2012,Lithuania,FRC Pabrade : Point,2,3,0,1,7,0,0,13,0,6,0,6,48,0,0,60
2012,Lithuania,Vilnius : Savivaldybe - Municipality,0,0,0,3,2,0,0,5,2,2,0,0,5,0,0,9
2012,Lithuania,Lithuania : Dispersed in the country / territory,0,0,0,0,0,0,1666,1666,0,0,0,0,0,0,2464,2464
2012,Lithuania,Jonavos Raj. : Savivaldybe - Municipality,0,0,0,2,4,0,0,6,2,0,0,0,9,0,0,11
2012,Latvia,Mucenieki : Point,2,0,0,2,7,0,0,11,0,2,0,1,18,0,0,21
2012,Latvia,Latvia : Dispersed in the country / territory,5,2,0,5,42,1,0,55,8,16,0,6,153,0,0,183
2012,"China, Macao SAR","Macao SAR, China : Dispersed in the country / territory",0,0,0,0,1,0,0,1,0,0,0,1,4,0,0,5
2012,Morocco,Morocco : Dispersed in the country / territory,96,70,0,65,440,12,0,683,80,69,0,138,1919,33,0,2239
2012,Rep. of Moldova,Chisinau : Municipality,1,0,0,0,10,2,0,13,0,1,0,0,58,3,0,62
2012,Rep. of Moldova,Republic of Moldova : Dispersed in the country / territory,3,5,0,3,1074,147,0,1232,1,5,0,8,834,103,0,951
2012,Madagascar,Madagascar : Dispersed in the country / territory,0,0,0,2,2,0,0,4,0,1,0,0,5,0,0,6
2012,Mexico,Mexico : Dispersed in the country / territory,26,53,0,89,401,8,0,577,16,40,0,80,734,0,0,870
2012,The former Yugoslav Republic of Macedonia,Vizbegovo : Point,9,19,0,11,35,0,0,74,9,22,0,43,333,1,0,408
2012,The former Yugoslav Republic of Macedonia,Valandovo : Opština - Municipality,0,1,0,1,5,0,0,7,0,1,0,1,4,1,0,7
2012,The former Yugoslav Republic of Macedonia,Tetovo : Opština - Municipality,9,9,0,8,63,12,0,101,5,10,0,6,42,2,0,65
2012,The former Yugoslav Republic of Macedonia,Sveti Nikole : Opština - Municipality,0,0,0,0,0,1,0,1,0,0,0,0,0,0,0,0
2012,The former Yugoslav Republic of Macedonia,Strumica : Opština - Municipality,0,0,0,1,2,0,0,3,0,0,0,0,1,0,0,1
2012,The former Yugoslav Republic of Macedonia,Stip : Opština - Municipality,4,2,0,0,7,1,0,14,6,2,0,3,2,0,0,13
2012,The former Yugoslav Republic of Macedonia,Skopje : City,84,106,0,103,506,34,0,833,91,120,0,91,408,31,0,741
2012,The former Yugoslav Republic of Macedonia,Radovis : Opština - Municipality,0,0,0,0,0,0,0,0,0,0,0,0,1,0,0,1
2012,The former Yugoslav Republic of Macedonia,Probistip : Opština - Municipality,0,0,0,0,0,1,0,1,0,0,0,0,0,0,0,0
2012,The former Yugoslav Republic of Macedonia,Prilep : Opština - Municipality,2,8,0,3,9,0,0,22,3,2,0,0,9,1,0,15
2012,The former Yugoslav Republic of Macedonia,Ohrid : Opština - Municipality,0,0,0,0,0,0,0,0,0,0,0,0,1,0,0,1
2012,The former Yugoslav Republic of Macedonia,Kumanovo : Opština - Municipality,9,8,0,12,66,3,0,98,11,13,0,10,42,8,0,84
2012,The former Yugoslav Republic of Macedonia,Kocani : Opština - Municipality,0,0,0,0,1,0,0,1,0,0,0,0,0,0,0,0
2012,The former Yugoslav Republic of Macedonia,Kicevo : Opština - Municipality,1,0,0,0,19,1,0,21,0,4,0,1,11,0,0,16
2012,The former Yugoslav Republic of Macedonia,Kavadarci : Opština - Municipality,0,1,0,0,3,0,0,4,1,0,0,0,1,0,0,2
2012,The former Yugoslav Republic of Macedonia,Gostivar : Opština - Municipality,7,7,0,5,28,1,0,48,3,8,0,12,14,6,0,43
2012,The former Yugoslav Republic of Macedonia,Gevgelija : Opština - Municipality,0,0,0,0,2,0,0,2,0,0,0,0,0,0,0,0
2012,The former Yugoslav Republic of Macedonia,Debar : Opština - Municipality,2,0,0,0,0,0,0,2,1,1,0,0,0,0,0,2
2012,The former Yugoslav Republic of Macedonia,Bitola : Opština - Municipality,13,11,0,0,19,0,0,43,13,6,0,4,14,0,0,37
2012,The former Yugoslav Republic of Macedonia,Berovo : Opština - Municipality,0,0,0,0,1,0,0,1,0,0,0,0,0,0,0,0
2012,Mali,Sikasso : Region,45,51,0,35,116,3,0,250,41,54,0,25,115,2,0,237
2012,Mali,Kayes : Region,1,11,0,7,17,0,0,36,9,9,0,10,23,4,0,55
2012,Mali,Faragouana : Point,2,4,0,2,7,0,0,15,1,5,0,3,13,0,0,22
2012,Mali,Bamako : District,1361,1749,0,1118,2147,155,0,6530,1528,1825,0,1141,2329,200,0,7023
2012,Myanmar,northern Rakhine State,51392,64239,0,125589,169928,17131,0,428279,45567,56958,0,106322,155760,15189,0,379796
2012,Myanmar,Rakhine State (Rakhine Emergency Response),7314,9142,0,17873,24183,2438,0,60950,6485,8106,0,15131,22167,2161,0,54050
2012,Myanmar,Kachin and northern Shan States (Kachin Emergency Response),3468,6069,0,6936,22542,4335,0,43350,3332,5831,0,6664,21658,4165,0,41650
2012,Montenegro,Pluzine : Opština - Municipality,0,0,0,0,1,0,0,1,0,0,0,0,0,0,0,0
2012,Montenegro,Ulcinj : Opština - Municipality,5,17,0,10,84,30,0,146,5,13,0,19,93,20,0,150
2012,Montenegro,Tivat : Opština - Municipality,4,7,0,16,149,64,0,240,0,8,0,29,165,55,0,257
2012,Montenegro,Rozaj : Opština - Municipality,4,9,0,10,66,8,0,97,4,13,0,21,52,11,0,101
2012,Montenegro,Podgorica : Opština - Municipality,186,364,0,361,1609,420,0,2940,211,376,0,388,1836,361,0,3172
2012,Montenegro,Pljevlja : Opština - Municipality,3,1,0,4,31,3,0,42,3,8,0,2,33,5,0,51
2012,Montenegro,Plav : Opština - Municipality,2,9,0,15,133,53,0,212,2,8,0,29,130,45,0,214
2012,Montenegro,Niksic : Opština - Municipality,8,16,0,33,176,43,0,276,9,18,0,36,167,24,0,254
2012,Montenegro,Montenegro : Dispersed in the country / territory,0,0,0,0,0,0,1788,1788,0,0,0,0,0,0,1595,1595
2012,Montenegro,Mojkovac : Opština - Municipality,0,1,0,1,14,4,0,20,1,2,0,4,10,3,0,20
2012,Montenegro,Kotor : Opština - Municipality,0,5,0,4,61,40,0,110,2,1,0,8,92,21,0,124
2012,Montenegro,Kolasin : Opština - Municipality,1,3,0,5,24,20,0,53,1,3,0,8,36,10,0,58
2012,Montenegro,Herceg Novi : Opština - Municipality,0,9,0,21,329,161,0,520,3,13,0,25,286,114,0,441
2012,Montenegro,Danilovgrad : Opština - Municipality,0,7,0,12,105,43,0,167,2,11,0,15,101,28,0,157
2012,Montenegro,Cetinje : Opština - Municipality,0,0,0,0,9,2,0,11,0,2,0,0,3,1,0,6
2012,Montenegro,Budva : Opština - Municipality,4,17,0,23,203,64,0,311,2,18,0,21,192,58,0,291
2012,Montenegro,Bijelo Polje : Opština - Municipality,1,5,0,11,60,13,0,90,2,2,0,15,60,9,0,88
2012,Montenegro,Berane : Opština - Municipality,47,68,0,114,386,130,0,745,42,101,0,87,400,88,0,718
2012,Montenegro,Bar : Opština - Municipality,15,46,0,71,507,202,0,841,31,48,0,73,519,169,0,840
2012,Montenegro,Andrijevica : Opština - Municipality,1,6,0,12,89,34,0,142,1,8,0,15,71,23,0,118
2012,Mongolia,Ulaanbaatar : Capital City,0,0,0,0,1,0,0,1,2,0,0,0,10,0,0,12
2012,Mozambique,Zambezia : Provincia,3,11,0,3,34,0,0,51,4,8,0,7,100,0,0,119
2012,Mozambique,Tete : Provincia,33,53,0,26,99,0,0,211,38,41,0,35,170,4,0,288
2012,Mozambique,Sofala : Provincia,2,4,0,3,12,0,0,21,0,4,0,2,28,1,0,35
2012,Mozambique,Niassa : Provincia,8,22,0,13,35,0,0,78,6,20,0,12,64,0,0,102
2012,Mozambique,Nampula : Provincia,48,71,0,34,211,3,0,367,43,83,0,56,698,6,0,886
2012,Mozambique,Maratane : Point,639,733,0,481,1374,70,0,3297,660,840,0,535,2036,30,0,4101
2012,Mozambique,Maputo:Provincia,13,49,0,27,83,3,0,175,14,33,0,30,133,3,0,213
2012,Mozambique,Manica : Provincia,0,2,0,2,23,0,0,27,1,4,0,1,96,0,0,102
2012,Mozambique,Inhambane : Provincia,0,2,0,3,12,0,0,17,0,3,0,6,23,0,0,32
2012,Mozambique,Gaza : Provincia,0,4,0,3,7,0,0,14,0,7,0,2,14,0,0,23
2012,Mozambique,Cabo Delgado : Provincia,3,2,0,0,12,0,0,17,3,0,0,2,36,1,0,42
2012,Mozambique,Maputo : Cidade capital - Capital City,80,184,0,125,513,13,0,915,95,179,0,141,1029,21,0,1465
2012,Mauritania,Nouakchott & Nouadhibou:points,73,56,0,29,278,9,0,445,69,48,0,57,644,3,0,821
2012,Mauritania,Mbera,6289,6544,0,2971,12953,866,0,29623,6299,6633,0,2633,8119,721,0,24405
2012,Mauritania,Mauritania : Dispersed in the country / territory,320,380,0,165,593,36,0,1494,289,381,0,150,381,41,0,1242
2012,Montserrat,Montserrat : Dispersed in the country / territory,0,0,0,0,0,0,0,0,0,0,0,0,5,0,0,5
2012,Malawi,Dzaleka : Point,1414,1794,0,1213,3200,106,0,7727,1406,1868,0,1425,4144,94,0,8937
2012,Malaysia,Kuala Lumpur : Wilayah Persekutuan - Federal State,4995,3227,0,2103,19972,553,0,30850,5216,3494,0,2785,58799,692,0,70986
2012,Namibia,Osire : Point,133,243,0,174,587,15,0,1152,115,261,0,180,864,11,0,1431
2012,Namibia,Namibia : Dispersed in the country / territory,24,17,0,18,58,2,0,119,24,31,0,17,119,2,0,193
2012,Niger,Tigzefan,119,187,0,44,253,23,0,626,113,148,0,27,205,15,0,508
2012,Niger,Tabareybarey,483,953,0,336,1351,136,0,3259,511,906,0,292,748,104,0,2561
2012,Niger,Sinegodrar,54,105,0,28,148,19,0,354,60,86,0,38,113,14,0,311
2012,Niger,Niamey : Capital District,569,1030,0,613,1778,175,0,4165,520,948,0,469,828,108,0,2873
2012,Niger,Miel,73,139,0,49,170,15,0,446,68,131,0,33,196,20,0,448
2012,Niger,Mangaize,316,489,0,204,743,73,0,1825,321,547,0,194,472,57,0,1591
2012,Niger,Koutougou,2,7,0,1,9,0,0,19,3,2,0,2,9,0,0,16
2012,Niger,Kizamou,6,8,0,2,11,3,0,30,3,12,0,3,12,0,0,30
2012,Niger,Chinwaren,251,390,0,196,512,23,0,1372,216,290,0,185,455,29,0,1175
2012,Niger,Camp Abala,997,1848,0,680,2314,180,0,6019,1066,1729,0,692,1465,155,0,5107
2012,Niger,Banibangou,221,415,0,151,639,60,0,1486,264,420,0,133,492,61,0,1370
2012,Niger,Ayourou Ville,54,95,0,45,177,17,0,388,50,95,0,32,66,8,0,251
2012,Niger,Agando,1421,1880,0,1417,2509,347,0,7574,1016,1679,0,1217,2333,569,0,6814
2012,Nigeria,Oru Camp : Point,5,17,0,11,56,1,0,90,6,10,0,14,68,1,0,99
2012,Nigeria,Lagos : State,99,180,0,127,767,17,0,1190,101,181,0,167,1408,50,0,1907
2012,Nigeria,Ijebuode : Local Government Area,5,6,0,5,11,0,0,27,4,6,0,5,45,1,0,61
2012,Nigeria,Benue : State,19,83,0,47,104,14,0,267,30,55,0,48,79,8,0,220
2012,Nigeria,Amana : Point,8,72,0,35,88,12,0,215,4,65,0,25,21,5,0,120
2012,Nicaragua,Palacaguina : Municipio,0,0,0,0,0,0,0,0,0,0,0,0,2,0,0,2
2012,Nicaragua,Managua : Departamento,0,1,0,1,5,0,0,7,0,3,0,0,11,0,0,14
2012,Nicaragua,Nicaragua : Dispersed in the country / territory,2,4,0,2,40,4,0,52,0,5,0,4,51,5,0,65
2012,Norway,Norway : Dispersed in the country / territory,0,0,0,0,0,0,2950,2950,0,0,0,0,0,0,6449,6449
2012,Nepal,Sanischare : Point,418,577,0,609,2589,303,0,4496,426,624,0,616,2621,429,0,4716
2012,Nepal,Kathmandu : District,23,22,0,5,78,2,0,130,19,21,0,14,130,2,1,187
2012,Nepal,Beldangi: Point,1390,1964,0,1874,9161,1155,0,15544,1436,2093,0,2083,9395,1425,0,16432
2012,Nepal,Nepal : Dispersed in the country / territory,2,3,0,1,21,3,7660,7690,0,2,0,2,34,1,7500,7539
2012,Nauru,Regional Processing Centre,0,0,0,0,0,0,0,0,0,0,0,0,379,0,0,379
2012,Oman,Oman : Dispersed in the country / territory,14,9,0,10,51,2,0,86,7,10,0,9,43,3,0,72
2012,Pakistan,Zar Karez : Point,281,531,0,319,830,61,0,2022,276,564,0,416,874,123,0,2253
2012,Pakistan,Zangal Patai : Point,3,12,0,8,36,0,0,59,2,17,0,13,38,3,0,73
2012,Pakistan,Zafarabad : Point,201,371,0,224,468,24,0,1288,227,380,0,295,615,82,0,1599
2012,Pakistan,Yakaghund : Point,238,335,0,171,387,26,0,1157,227,332,0,180,396,38,0,1173
2012,Pakistan,Utmanzai : Point,216,525,0,296,766,48,0,1851,239,567,0,305,823,115,0,2049
2012,Pakistan,Urguch : Point,1,5,0,5,10,0,0,21,2,5,0,3,21,0,0,31
2012,Pakistan,Toor : Point,177,269,0,195,396,31,0,1068,192,266,0,210,617,44,0,1329
2012,Pakistan,Togh Sarai : Point,544,675,0,368,1165,106,0,2858,635,859,0,330,1042,97,0,2963
2012,Pakistan,Timer : Point,491,1070,0,774,1747,95,0,4177,517,1093,0,853,1844,181,0,4488
2012,Pakistan,Thall : Point,882,1397,0,1077,2629,275,0,6260,947,1496,0,1313,2534,426,0,6716
2012,Pakistan,Surkhab : Point,438,873,0,515,1456,86,0,3368,439,916,0,651,1606,234,0,3846
2012,Pakistan,Sund Rawal : Point,0,11,0,10,15,2,0,38,0,14,0,13,40,6,0,73
2012,Pakistan,Sindh : Province,4055,6858,0,5431,14596,733,0,31673,4298,7069,0,6274,17568,1708,0,36917
2012,Pakistan,Shindand : Point,124,201,0,161,314,20,0,820,122,179,0,183,342,35,0,861
2012,Pakistan,Shaikh Abad : Point,377,701,0,387,1103,79,0,2647,314,753,0,417,1193,108,0,2785
2012,Pakistan,Saranan : Point,1479,2426,0,1807,4240,228,0,10180,1556,2403,0,2101,4352,626,0,11038
2012,Pakistan,Rata Kulachi : Point,25,56,0,29,68,6,0,184,20,49,0,56,100,14,0,239
2012,Pakistan,Rakh Zandani : Point,0,0,0,1,1,0,0,2,1,1,0,1,5,0,0,8
2012,Pakistan,Quetta : Point,0,0,0,4,13,0,0,17,0,0,0,3,17,0,0,20
2012,Pakistan,Pusha Pul : Point,56,92,0,47,109,9,0,313,49,91,0,86,188,28,0,442
2012,Pakistan,Punjab : Province,9471,18136,0,12654,33769,2071,0,76101,10040,19231,0,15184,42393,3970,0,90818
2012,Pakistan,Posti : Point,19,18,0,17,29,2,0,85,12,23,0,16,33,7,0,91
2012,Pakistan,Pir Alizai : Point,725,1416,0,612,1677,96,0,4526,701,1443,0,743,2098,260,0,5245
2012,Pakistan,Peshawar : Point,0,2,0,1,2,0,0,5,0,1,0,4,5,0,0,10
2012,Pakistan,Panian : Point,3187,8015,0,3342,12648,721,0,27913,3440,8336,0,3757,11994,1380,0,28907
2012,Pakistan,Padhana : Point,550,1209,0,786,2078,122,0,4745,538,1260,0,891,2199,259,0,5147
2012,Pakistan,Old Shamshatoo : Point,3474,6112,0,3856,11586,500,0,25528,3650,6551,0,4381,12352,1111,0,28045
2012,Pakistan,Old Akora : Point,2928,4166,0,2873,7315,254,0,17536,2989,4367,0,3326,7684,791,0,19157
2012,Pakistan,Oblan : Point,659,1046,0,862,1817,136,0,4520,709,1089,0,895,1897,221,0,4811
2012,Pakistan,New Durrani : Point,871,1382,0,645,2385,218,0,5501,1024,2020,0,1275,2387,231,0,6937
2012,Pakistan,New Akora : Point,60,26,0,7,43,2,0,138,51,30,0,15,154,6,0,256
2012,Pakistan,Naurang : Point,57,144,0,114,258,20,0,593,73,160,0,119,274,37,0,663
2012,Pakistan,Naguman : Point,183,420,0,275,654,35,0,1567,195,397,0,354,696,74,0,1716
2012,Pakistan,Nagar : Point,22,34,0,16,42,2,0,116,18,36,0,21,60,4,0,139
2012,Pakistan,Munda : Point,690,1379,0,799,2013,116,0,4997,720,1344,0,873,1926,240,0,5103
2012,Pakistan,Mohammad Kheil : Point,297,697,0,293,1131,33,0,2451,310,745,0,395,1157,143,0,2750
2012,Pakistan,Mera Kachori : Point,350,615,0,397,1020,71,0,2453,322,576,0,443,1052,118,0,2511
2012,Pakistan,Mayar : Point,53,96,0,91,174,19,0,433,69,104,0,72,240,24,0,509
2012,Pakistan,Malgagai : Point,454,663,0,538,1187,130,0,2972,425,764,0,568,1386,213,0,3356
2012,Pakistan,Lejay Karez : Point,47,76,0,52,143,8,0,326,68,56,0,80,225,41,0,470
2012,Pakistan,Lakti Banda : Point,436,732,0,517,1267,159,0,3111,456,767,0,593,1265,229,0,3310
2012,Pakistan,Kund/Khairabad : Point,1097,1751,0,890,2409,191,0,6338,1107,1820,0,936,2464,296,0,6623
2012,Pakistan,Kotwai : Point,382,712,0,516,1122,84,0,2816,429,706,0,517,987,177,0,2816
2012,Pakistan,Kotkai : Point,180,271,0,224,504,71,0,1250,188,334,0,249,599,100,0,1470
2012,Pakistan,Kot Chandna : Point,1012,1749,0,1337,3064,150,0,7312,1092,1654,0,1469,3055,307,0,7577
2012,Pakistan,Koga : Point,749,991,0,765,1771,91,0,4367,784,956,0,929,1697,160,0,4526
2012,Pakistan,Khyber Pakhtunkhwa : Province,84450,121373,0,71342,263746,13347,0,554258,99943,145132,0,97392,272051,25562,0,640080
2012,Pakistan,Khurasan : Point,234,370,0,317,942,72,0,1935,230,359,0,318,1037,96,0,2040
2012,Pakistan,Khoughani : Point,117,152,0,117,316,14,0,716,101,152,0,145,329,27,0,754
2012,Pakistan,Kheshki : Point,42,50,0,33,90,4,0,219,26,61,0,42,97,12,0,238
2012,Pakistan,Khazana : Point,436,688,0,509,1165,79,0,2877,407,653,0,628,1412,128,0,3228
2012,Pakistan,Khaki : Point,947,2025,0,1039,3014,217,0,7242,976,2024,0,1247,3104,346,0,7697
2012,Pakistan,Kesu : Point,38,85,0,61,151,6,0,341,56,101,0,92,175,15,0,439
2012,Pakistan,Kata Kanri : Point,371,591,0,455,955,97,0,2469,389,620,0,455,1124,131,0,2719
2012,Pakistan,Karachi : Point,2,14,0,7,34,0,0,57,1,5,0,2,41,0,0,49
2012,Pakistan,Kalatak : Point,46,94,0,66,161,7,0,374,49,119,0,83,242,12,0,505
2012,Pakistan,Kaghan : Point,117,240,0,140,342,26,0,865,150,240,0,166,338,36,0,930
2012,Pakistan,Kababian : Point,803,1260,0,859,2419,85,0,5426,878,1277,0,954,3431,201,0,6741
2012,Pakistan,Jerma : Point,80,105,0,71,190,16,0,462,100,118,0,102,242,28,0,590
2012,Pakistan,Jalozai : Point,4481,6535,0,3561,12073,928,0,27578,5416,7965,0,5122,10769,921,0,30193
2012,Pakistan,Jalala : Point,899,1701,0,943,2702,164,0,6409,932,1762,0,1083,2930,305,0,7012
2012,Pakistan,Islamabad : Point,10,39,0,35,235,6,0,325,15,43,0,51,183,5,0,297
2012,Pakistan,Ichirian : Point,298,585,0,289,960,62,0,2194,251,581,0,333,1017,112,0,2294
2012,Pakistan,Girdi Jungle : Point,1486,2486,0,1488,3498,579,0,9537,1870,2808,0,2026,5198,901,0,12803
2012,Pakistan,Ghulam Banda : Point,541,860,0,680,1658,80,0,3819,594,904,0,824,1784,205,0,4311
2012,Pakistan,Ghiljo : Point,83,118,0,49,186,12,0,448,84,114,0,61,177,23,0,459
2012,Pakistan,Ghazi : Point,9,23,0,5,30,1,0,68,12,27,0,9,34,5,0,87
2012,Pakistan,Ghazgai Minara : Point,116,227,0,117,317,27,0,804,104,257,0,181,386,54,0,982
2012,Pakistan,Gandhi Khan Khel : Point,162,297,0,205,482,32,0,1178,204,298,0,197,466,71,0,1236
2012,Pakistan,Gandaf : Point,962,1428,0,1100,2374,192,0,6056,1023,1493,0,1182,2635,243,0,6576
2012,Pakistan,Gamkol : Point,2298,3404,0,2660,6139,359,0,14860,2387,3365,0,3054,7365,670,0,16841
2012,Pakistan,Gambila : Point,93,178,0,92,266,27,0,656,133,177,0,120,313,51,0,794
2012,Pakistan,Domshivgar : Point,11,27,0,15,36,2,0,91,7,16,0,21,43,3,0,90
2012,Pakistan,Dodpa : Point,0,29,0,19,40,1,0,89,0,17,0,22,56,4,0,99
2012,Pakistan,Doaba : Point,365,538,0,435,1004,95,0,2437,407,546,0,477,1135,168,0,2733
2012,Pakistan,Darsamand : Point,295,459,0,343,888,94,0,2079,335,489,0,400,1015,142,0,2381
2012,Pakistan,Daraban : Point,5,9,0,5,12,0,0,31,6,3,0,7,14,1,0,31
2012,Pakistan,Dabara : Point,113,169,0,39,125,8,0,454,186,211,0,43,208,16,0,664
2012,Pakistan,Chichana : Point,245,349,0,299,724,53,0,1670,277,337,0,340,973,118,0,2045
2012,Pakistan,Chakdara : Point,734,1371,0,993,2091,118,0,5307,789,1376,0,1097,2484,189,0,5935
2012,Pakistan,Chagai : Point,5,21,0,10,30,5,0,71,15,23,0,12,39,6,0,95
2012,Pakistan,Bizen Khel : Point,94,157,0,140,307,17,0,715,110,186,0,175,334,42,0,847
2012,Pakistan,Basu Mera : Point,227,510,0,462,1111,49,0,2359,263,543,0,551,1073,125,0,2555
2012,Pakistan,Barawal : Point,4,4,0,3,9,1,0,21,1,7,0,5,30,3,0,46
2012,Pakistan,Barary : Point,463,920,0,505,1512,98,0,3498,410,975,0,553,1639,158,0,3735
2012,Pakistan,Barari : Point,6,7,0,4,14,0,0,31,8,7,0,7,20,0,0,42
2012,Pakistan,Barakai : Point,1620,2967,0,2495,5723,328,0,13133,1752,3073,0,2742,5407,632,0,13606
2012,Pakistan,Balochistan : Province,14072,28859,0,18749,50668,3612,0,115960,14639,30316,0,22854,57978,7762,0,133549
2012,Pakistan,Bakka Khel : Point,40,71,0,33,106,11,0,261,52,76,0,65,162,18,0,373
2012,Pakistan,Baghicha : Point,41,50,0,44,97,7,0,239,41,55,0,42,101,11,0,250
2012,Pakistan,Badaber : Point,1789,3260,0,1943,5134,288,0,12414,1885,3378,0,2114,5873,563,0,13813
2012,Pakistan,Azakhel : Point,1660,2623,0,1721,3858,169,0,10031,1949,2767,0,1949,4197,338,0,11200
2012,Pakistan,Pakistan : Dispersed in the country / territory,165,337,0,299,821,43,0,1665,180,377,0,367,590,41,0,1555
2012,Pakistan,Islamabad : Federal Capital Territory,1781,3723,0,2671,7345,434,0,15954,1899,4015,0,3189,8395,864,0,18362
2012,Pakistan,Azad Kashmir : Pakistan Administered Area,333,691,0,507,1368,91,0,2990,362,759,0,547,1736,189,0,3593
2012,Panama,Kuna Yala : Point,5,13,0,16,25,1,0,60,4,12,0,14,29,1,0,60
2012,Panama,Darien : Provincia,68,71,0,70,149,14,0,372,68,57,0,60,161,25,0,371
2012,Panama,Panama : Dispersed in the country / territory,268,729,0,2065,3336,862,0,7260,262,808,0,2610,5021,972,0,9673
2012,Peru,Peru : Dispersed in the country / territory,9,30,0,72,445,26,0,582,14,49,0,88,783,84,0,1018
2012,Philippines,Western Visayas (Region VI) : Region,0,0,0,0,0,0,0,0,0,0,0,0,3,0,0,3
2012,Philippines,Philippines : Dispersed in the country / territory,0,0,0,0,0,0,16,16,0,0,0,0,0,0,52,52
2012,Philippines,National Capital Region (NCR) : Region,0,3,0,4,23,0,0,30,1,1,0,1,103,3,0,109
2012,Philippines,MIMAROPA (Region IV-B) : Region,0,0,0,0,0,0,0,0,0,0,0,0,1,0,0,1
2012,Philippines,Davao (Region XI),0,0,0,0,0,0,3007,3007,0,0,0,0,2,0,3008,3010
2012,Philippines,Central Luzon (Region III) : Region,0,0,0,0,1,0,0,1,0,0,0,0,7,0,0,7
2012,Philippines,Central Luzon (Region III),0,0,0,0,0,0,0,0,0,0,0,0,2,0,0,2
2012,Philippines,CALABARZON (Region IV-A ) : Region,0,0,0,3,2,0,0,5,0,1,0,1,9,2,0,13
2012,Palau,Koror : State,0,0,0,0,0,0,0,0,0,0,0,0,3,0,0,3
2012,Papua New Guinea,Vanimo,0,0,0,0,0,0,0,0,0,0,0,0,1,0,0,1
2012,Papua New Guinea,Port Moresby : National Capital District,1,0,0,0,1,0,0,2,1,0,0,1,10,0,0,12
2012,Papua New Guinea,East Awin : Point,143,199,0,163,581,41,0,1127,145,226,0,185,568,47,0,1171
2012,Papua New Guinea,Papua New Guinea : Dispersed in the country / territory,440,612,0,501,1789,126,0,3468,446,696,0,569,1746,145,0,3602
2012,Poland,Warszawa : Powiat - County,0,0,0,0,0,0,78,78,0,0,0,0,0,0,26,26
2012,Poland,Lukow : Powiat - County,0,0,0,0,0,0,68,68,0,0,0,0,0,0,62,62
2012,Poland,Lublin : Powiat - County,0,0,0,0,0,0,54,54,0,0,0,0,0,0,52,52
2012,Poland,Linin : Point,0,0,0,0,0,0,76,76,0,0,0,0,0,0,72,72
2012,Poland,Horbow : Point,0,0,0,0,0,0,58,58,0,0,0,0,0,0,53,53
2012,Poland,Grupa : Point,0,0,0,0,0,0,56,56,0,0,0,0,0,0,68,68
2012,Poland,Grotniki : Point,0,0,0,0,0,0,53,53,0,0,0,0,0,0,47,47
2012,Poland,Debak : Point,0,0,0,0,0,0,48,48,0,0,0,0,0,0,81,81
2012,Poland,Czerwony Bor : Point,0,0,0,0,0,0,35,35,0,0,0,0,0,0,39,39
2012,Poland,Bialystok : Powiat - County,0,0,0,0,0,0,84,84,0,0,0,0,0,0,76,76
2012,Poland,Biala Podlaskae : Powiat - County,0,0,0,0,0,0,63,63,0,0,0,0,0,0,54,54
2012,Paraguay,Asuncion : Point,2,8,0,6,38,2,0,56,2,3,0,5,76,1,0,87
2012,Qatar,Qatar : Dispersed in the country / territory,9,6,0,7,45,3,0,70,10,3,0,7,40,7,0,67
2012,Romania,Bucharest : Municipality,1,0,0,0,109,0,0,110,1,0,0,34,1768,0,0,1803
2012,Rwanda,Rwamagana : Point,11,3,0,2,14,1,0,31,4,8,0,2,7,0,0,21
2012,Rwanda,Rutsiro : Commune,162,97,0,44,295,11,0,609,150,90,0,33,120,8,0,401
2012,Rwanda,Rusizi : Point,65,47,0,19,116,5,0,252,70,51,0,20,33,1,0,175
2012,Rwanda,Rulindo : Point,12,8,0,3,21,0,0,44,14,10,0,4,2,1,0,31
2012,Rwanda,Ruhango : Point,17,16,0,11,60,4,0,108,28,19,0,9,16,6,0,78
2012,Rwanda,Rubavu : Commune,412,397,0,245,1001,53,0,2108,410,357,0,190,412,44,0,1413
2012,Rwanda,Nyaruguru : Point,33,37,0,18,62,2,0,152,26,27,0,6,30,2,0,91
2012,Rwanda,Nyarugenge : Commune,11,5,0,0,26,0,0,42,16,12,0,3,11,0,0,42
2012,Rwanda,Nyanza : Point,13,17,0,10,36,2,0,78,21,14,0,6,13,4,0,58
2012,Rwanda,Nyamasheke : Point,130,96,0,38,226,10,0,500,109,107,0,37,67,9,0,329
2012,Rwanda,Nyamagabe : Commune,1516,1904,0,1322,3644,226,0,8612,1551,1890,0,1088,1740,161,0,6430
2012,Rwanda,Nyagatare (Cyangugu) : Point,3,0,0,0,5,0,0,8,3,1,0,0,0,0,0,4
2012,Rwanda,Nyabihu : Point,206,122,0,49,446,16,0,839,184,117,0,27,147,9,0,484
2012,Rwanda,Ngororero : Point,73,58,0,27,163,8,0,329,62,46,0,16,70,6,0,200
2012,Rwanda,Ngoma : Commune,14,13,0,5,32,4,0,68,14,16,0,7,14,1,0,52
2012,Rwanda,Musanze : Point,150,126,0,35,323,11,0,645,158,99,0,32,123,12,0,424
2012,Rwanda,Muhanga : Point,14,16,0,4,37,1,0,72,17,9,0,5,13,2,0,46
2012,Rwanda,Kiziba : Point,1175,1648,0,1366,4144,464,0,8797,1075,1538,0,1328,2821,368,0,7130
2012,Rwanda,Kirehe : Point,7,5,0,0,15,4,0,31,7,6,0,3,12,0,0,28
2012,Rwanda,Kigali-ngali : Prefecture,114,223,0,167,470,11,0,985,91,206,0,169,464,18,0,948
2012,Rwanda,Kicukiro : Commune,6,5,0,2,13,0,0,26,8,6,0,1,9,0,0,24
2012,Rwanda,Kayonza : Commune,6,6,0,2,11,1,0,26,7,4,0,0,2,2,0,15
2012,Rwanda,Karongi : Point,172,131,0,68,330,16,0,717,143,117,0,48,87,20,0,415
2012,Rwanda,Kamonyi : Point,14,11,0,4,23,3,0,55,11,12,0,3,8,0,0,34
2012,Rwanda,Huye : Commune,34,36,0,13,82,5,0,170,35,34,0,8,28,1,0,106
2012,Rwanda,Gisagara : Point,9,9,0,7,28,2,0,55,9,14,0,6,13,0,0,42
2012,Rwanda,Gihembe : Point,847,1490,0,1334,3649,449,0,7769,848,1531,0,1296,2313,249,0,6237
2012,Rwanda,Gicumbi : Point,17,14,0,4,28,2,0,65,17,15,0,9,10,3,0,54
2012,Rwanda,Gatsibo : Point,822,1540,0,1078,2799,186,0,6425,830,1485,0,1033,1603,146,0,5097
2012,Rwanda,Gasabo : Point,17,10,0,4,29,0,0,60,13,17,0,4,17,1,0,52
2012,Rwanda,Gakenke : Point,11,6,0,3,15,1,0,36,13,1,0,0,5,0,0,19
2012,Rwanda,Burera : Point,18,10,0,6,40,2,0,76,12,8,0,10,12,1,0,43
2012,Rwanda,Bugesera : Point,31,22,0,14,65,4,0,136,35,23,0,8,35,6,0,107
2012,Saudi Arabia,Riyadh : Province,6,40,0,30,98,5,0,179,9,39,0,50,157,7,0,262
2012,Saudi Arabia,Madinah : Province,0,2,0,0,1,0,0,3,0,0,0,0,3,0,0,3
2012,Saudi Arabia,Khobar : Governorate,0,1,0,1,2,1,0,5,0,0,0,1,11,0,0,12
2012,Saudi Arabia,Jeddah : Governorate,5,20,0,27,37,4,0,93,6,25,0,17,55,5,0,108
2012,Saudi Arabia,Arar : Governorate,0,0,0,0,0,0,0,0,0,0,0,0,2,0,0,2
2012,Saudi Arabia,Al-Qateef : Governorate,0,2,0,1,1,0,0,4,0,0,0,4,1,0,0,5
2012,Sudan,Western Darfur : State,0,0,0,0,0,0,166624,166624,0,0,0,0,0,0,166624,166624
2012,Sudan,Wad Sherife : Point,670,1305,0,1222,5148,795,0,9140,710,1375,0,1287,3019,715,0,7106
2012,Sudan,Wad Medani : Point,0,0,0,1,1,0,0,2,0,2,0,0,0,1,0,3
2012,Sudan,Wad El Hileau : Point,14,35,0,29,77,10,0,165,7,34,0,18,74,8,0,141
2012,Sudan,Um Shalaya : Point,815,906,0,509,1736,292,0,4258,754,813,0,576,993,157,0,3293
2012,Sudan,Um Rakuba : Point,19,51,0,31,170,15,0,286,22,63,0,53,159,33,0,330
2012,Sudan,Um Gulja : Point,74,190,0,92,519,76,0,951,78,187,0,100,529,186,0,1080
2012,Sudan,Um Gargur : Point,470,724,0,625,2316,308,0,4443,479,767,0,749,2073,436,0,4504
2012,Sudan,Um Dukhun : Point,0,0,0,0,0,0,300,300,0,0,0,0,0,0,300,300
2012,Sudan,Um Dafog : Point,0,0,0,0,0,0,813,813,0,0,0,0,0,0,713,713
2012,Sudan,Um brosh,0,0,0,0,0,0,0,0,0,0,0,0,1,0,0,1
2012,Sudan,Um Ali,2,13,0,10,14,0,0,39,5,7,0,7,7,2,0,28
2012,Sudan,Tokar : Region,0,0,0,0,0,0,0,0,0,0,0,0,1,0,0,1
2012,Sudan,Tendelti : Point,0,0,0,0,0,0,1250,1250,0,0,0,0,0,0,1250,1250
2012,Sudan,Suwakin : Point,5,6,0,3,18,1,0,33,4,3,0,3,43,2,0,55
2012,Sudan,Southern Kordofan : Wilayat - State,0,0,0,0,0,0,25000,25000,0,0,0,0,0,0,25000,25000
2012,Sudan,Southern Darfur : State,0,0,0,0,0,0,329572,329572,0,0,0,0,0,0,329573,329573
2012,Sudan,Sinkat : Region,0,0,0,0,0,0,0,0,0,0,0,0,1,0,0,1
2012,Sudan,Shagarab 3 : Point,342,647,0,517,1712,196,4007,7421,339,668,0,451,1073,287,4008,6826
2012,Sudan,Shagarab 2 : Point,427,1122,0,792,2520,225,0,5086,421,1226,0,846,1586,365,0,4444
2012,Sudan,Shagarab 1 : Point,590,1412,0,958,3687,401,0,7048,574,1502,0,1091,3267,510,0,6944
2012,Sudan,Salmin,0,1,0,0,1,0,0,2,0,1,0,0,1,0,0,2
2012,Sudan,Salalab,7,43,0,30,134,4,0,218,9,40,0,38,179,12,0,278
2012,Sudan,Safawa,0,0,0,0,3,1,0,4,0,0,0,0,0,0,0,0
2012,Sudan,Port Sudan : Point,24,99,0,84,265,15,0,487,16,120,0,71,475,25,0,707
2012,Sudan,Nyala : Region,0,0,0,0,2,0,0,2,1,1,0,0,13,0,0,15
2012,Sudan,Northern Darfur : State,0,0,0,0,0,0,239069,239069,0,0,0,0,0,0,240069,240069
2012,Sudan,New Halfa : Point,7,16,0,5,88,0,0,116,16,16,0,11,833,7,0,883
2012,Sudan,Mukjar : Point,83,119,0,53,146,18,0,419,92,96,0,59,125,14,0,386
2012,Sudan,Marghania,6,18,0,12,85,4,0,125,2,17,0,22,119,7,0,167
2012,Sudan,Mafaza : Point,0,0,0,0,1,0,0,1,0,0,0,0,0,0,0,0
2012,Sudan,Laffa,1,0,0,0,6,1,0,8,0,1,0,0,0,0,0,1
2012,Sudan,Kolain : Point,0,0,0,0,0,0,75,75,0,0,0,0,0,0,75,75
2012,Sudan,Kilo 7 : Point,6,38,0,21,120,20,0,205,17,34,0,33,115,30,0,229
2012,Sudan,Kilo 26 : Point,454,691,0,603,2254,296,0,4298,537,719,0,603,1758,395,0,4012
2012,Sudan,Khartoum Urban : Point,15,20,0,15,72,3,0,125,12,26,0,22,90,5,0,155
2012,Sudan,Khartoum North : Point,2,1,0,0,2,0,0,5,1,1,0,0,3,0,0,5
2012,Sudan,Kassala : Point,128,369,0,319,1352,100,0,2268,128,385,0,335,1656,134,0,2638
2012,Sudan,Karkora : Point,0,5,0,6,12,3,0,26,1,4,0,3,12,2,0,22
2012,Sudan,Kalakla,0,0,0,0,4,0,0,4,0,0,0,2,2,0,0,4
2012,Sudan,Hawata : Point,3,2,0,0,3,0,0,8,1,2,0,0,0,0,0,3
2012,Sudan,Habillah : Region,0,0,0,0,0,0,7500,7500,0,0,0,0,0,0,7500,7500
2012,Sudan,Gulsa : Point,0,5,0,9,22,1,0,37,1,3,0,6,6,3,0,19
2012,Sudan,Girba : Point,376,520,0,414,1776,229,0,3315,403,569,0,440,1244,317,0,2973
2012,Sudan,Geref,1,3,0,3,15,0,0,22,1,2,0,4,20,1,0,28
2012,Sudan,Gelu : Point,0,0,0,0,0,0,75,75,0,0,0,0,0,0,75,75
2012,Sudan,Gedaref : Point,32,126,0,117,427,19,0,721,61,148,0,139,487,53,0,888
2012,Sudan,Gari and Dabag : Point,0,0,0,0,0,0,0,0,0,0,0,1,0,0,0,1
2012,Sudan,Gari : Point,0,0,0,0,0,0,75,75,0,0,0,0,0,0,75,75
2012,Sudan,Fau Town : Point,0,1,0,0,1,0,0,2,0,2,0,1,0,0,0,3
2012,Sudan,Fau 5 : Point,23,80,0,60,230,36,0,429,20,94,0,62,221,51,0,448
2012,Sudan,Fath El Rahman : Point,2,25,0,20,96,20,0,163,10,20,0,19,77,26,0,152
2012,Sudan,Es Showak : Point,2,4,0,4,16,2,0,28,2,6,0,6,19,2,0,35
2012,Sudan,El Geneina : Point,0,0,0,0,4,0,0,4,0,0,0,0,46,0,0,46
2012,Sudan,Eastern Darfur : State,0,0,0,0,0,0,71750,71750,0,0,0,0,0,0,71750,71750
2012,Sudan,Dordeab : Point,0,2,0,3,5,0,0,10,0,1,0,0,2,0,0,3
2012,Sudan,Doka : Point,0,0,0,1,2,1,0,4,0,0,0,1,0,1,0,2
2012,Sudan,Diam El-Nour,9,33,0,31,147,4,0,224,9,37,0,25,246,15,0,332
2012,Sudan,Dehama,0,0,0,0,0,0,0,0,0,0,0,0,2,0,0,2
2012,Sudan,Daim,0,0,0,1,2,0,0,3,0,2,0,0,7,1,0,10
2012,Sudan,Dabag : Point,0,0,0,0,0,0,75,75,0,0,0,0,0,0,75,75
2012,Sudan,Central Darfur : State,0,0,0,0,0,0,158738,158738,0,0,0,0,0,0,158742,158742
2012,Sudan,Bir Touk : Point,0,0,0,0,0,0,125,125,0,0,0,0,0,0,125,125
2012,Sudan,Bir Saleeba area : Point,0,0,0,0,0,0,1500,1500,0,0,0,0,0,0,1500,1500
2012,Sudan,Bir Khadija : Point,0,0,0,0,0,0,100,100,0,0,0,0,0,0,100,100
2012,Sudan,Basonda,0,0,0,0,1,0,0,1,2,0,0,0,0,0,0,2
2012,Sudan,Awad El Seid : Point,10,51,0,37,172,24,0,294,13,69,0,52,134,42,0,310
2012,Sudan,Asotriba,0,0,0,0,0,0,0,0,0,0,0,0,3,0,0,3
2012,Sudan,Aroma : Point,3,2,0,0,4,0,0,9,0,0,0,3,6,1,0,10
2012,Sudan,Armankul : Point,0,0,0,0,0,0,1150,1150,0,0,0,0,0,0,1150,1150
2012,Sudan,Abuda : Point,169,259,0,225,759,90,0,1502,159,260,0,245,655,113,0,1432
2012,Sudan,Abu Rakham area : Point,10,29,0,38,98,16,0,191,8,35,0,37,93,25,0,198
2012,Sudan,Khartoum : Wilayat - State,186,587,0,730,3893,161,9979,15536,166,556,0,761,4705,264,9981,16433
2012,Senegal,Saint Louis,1,2,0,0,9,0,0,12,3,1,0,0,13,1,0,18
2012,Senegal,Richard Toll : Point,1347,1627,0,755,2750,270,0,6749,1377,1527,0,724,2060,227,0,5915
2012,Senegal,Dakar/Thies : Point,6,17,0,16,29,1,0,69,10,25,0,20,58,3,0,116
2012,Senegal,Dakar : Point,84,122,0,116,920,21,0,1263,92,163,0,132,2006,35,0,2428
2012,Singapore,Singapore : Dispersed in the country / territory,0,0,0,0,1,0,0,1,0,0,0,0,2,0,0,2
2012,Solomon Islands,Honiara,0,0,0,0,1,0,0,1,0,0,0,0,2,0,0,2
2012,Sierra Leone,Tobanda : Point,3,19,0,26,35,4,0,87,5,23,0,18,61,4,0,111
2012,Sierra Leone,Taiama : Point,9,39,0,23,59,4,0,134,6,62,0,74,123,12,0,277
2012,Sierra Leone,Largo : Point,3,89,0,35,83,5,0,215,6,45,0,29,17,6,0,103
2012,Sierra Leone,Kenema : District,13,87,0,97,287,40,0,524,18,69,0,66,160,20,0,333
2012,Sierra Leone,Jembe : Point,2,34,0,26,59,2,0,123,3,28,0,23,82,2,0,138
2012,Sierra Leone,Gondama : Point,11,94,0,69,73,2,0,249,14,78,0,47,99,4,0,242
2012,Sierra Leone,Gerihun : Point,5,32,0,30,55,5,0,127,4,22,0,99,110,3,0,238
2012,Sierra Leone,Freetown : Point,13,86,0,133,147,15,0,394,12,94,0,110,195,11,0,422
2012,Sierra Leone,Bo : District,1,28,0,37,149,8,0,223,2,25,0,42,143,10,0,222
2012,Sierra Leone,Bandajuma : Point,2,17,0,6,21,1,0,47,4,16,0,11,28,3,0,62
2012,El Salvador,San Salvador : Point,0,2,0,0,1,1,0,4,0,0,0,0,12,0,0,12
2012,El Salvador,La Union : Departamento ,0,0,0,0,5,2,0,7,0,0,0,0,14,4,0,18
2012,El Salvador,Cuscatlan : Departamento ,0,0,0,0,1,0,0,1,0,0,0,2,1,0,0,3
2012,Somalia,Mogadishu Area,12,11,0,1,15,0,0,39,8,5,0,1,21,0,0,35
2012,Somalia,Hargeisa : District,649,666,0,320,1650,11,0,3296,606,702,0,306,1737,47,0,3398
2012,Somalia,Gaalkacyo Region,34,49,0,10,100,2,0,195,63,47,0,10,101,10,0,231
2012,Somalia,Bossaso Region,243,373,0,159,811,32,0,1618,264,347,0,140,1218,44,0,2013
2012,Serbia and Kosovo (S/RES/1244 (1999)),Vojvodina : Autonomous Province,0,618,0,1463,11739,8245,0,22065,0,700,0,1603,13909,4937,0,21149
2012,Serbia and Kosovo (S/RES/1244 (1999)),Kosovo (S/RES/1244 (1999)) : Dispersed in the country / territor,1131,1266,0,1297,3994,1364,0,9052,1202,1295,0,1333,5240,1322,0,10392
2012,Serbia and Kosovo (S/RES/1244 (1999)),Central Serbia : Regional Grouping,3,12,0,9,44,0,0,68,4,10,0,26,209,4,0,253
2012,Serbia and Kosovo (S/RES/1244 (1999)),Central and Southern Serbia : Regional Grouping,5,4782,0,7084,41217,15472,0,68560,6,5113,0,7419,41966,12281,0,66785
2012,Serbia and Kosovo (S/RES/1244 (1999)),Belgrade : Capital City,30,2996,0,4781,28919,13204,0,49930,17,3168,0,5190,30447,9140,0,47962
2012,South Sudan,Yida,6267,8054,0,4496,11730,599,0,31146,6657,7834,0,4276,6914,482,0,26163
2012,South Sudan,Yei : Point,0,1,0,12,251,0,0,264,2,2,0,11,22,0,0,37
2012,South Sudan,Yei,0,0,0,0,0,0,60,60,0,0,0,0,0,0,77,77
2012,South Sudan,Yambio,0,0,0,0,0,0,13,13,0,0,0,0,0,0,18,18
2012,South Sudan,Tambura : County,49,104,0,21,173,1,0,348,61,86,0,27,153,0,0,327
2012,South Sudan,Source Yubu : Point,45,107,0,35,213,9,0,409,61,97,0,44,115,10,0,327
2012,South Sudan,Renk,32,12,0,6,53,1,0,104,33,19,0,4,83,1,0,140
2012,South Sudan,Pochalla,246,511,0,351,929,38,0,2075,247,541,0,331,362,22,0,1503
2012,South Sudan,Pariang,1,1,0,60,124,0,0,186,4,3,0,49,521,0,0,577
2012,South Sudan,Nyeel,80,112,0,72,137,13,0,414,97,102,0,95,111,8,0,413
2012,South Sudan,Naandi : Point,13,33,0,7,54,3,0,110,10,31,0,15,58,6,0,120
2012,South Sudan,Morobo : County,8,5,0,0,16,1,0,30,4,5,0,2,16,0,0,27
2012,South Sudan,Morobo,0,0,0,0,0,0,13,13,0,0,0,0,0,0,16,16
2012,South Sudan,Maridi,38,41,0,9,60,1,18,167,47,31,0,18,76,3,4,179
2012,South Sudan,Malakal,11,6,0,0,20,1,0,38,12,3,0,0,62,0,0,77
2012,South Sudan,Makpandu : Point,337,503,0,248,1441,78,0,2607,329,472,0,232,1959,101,0,3093
2012,South Sudan,Magwi,0,0,0,0,0,0,122,122,0,0,0,0,0,0,112,112
2012,South Sudan,Lasu,711,1052,0,667,1894,175,0,4499,685,1004,0,679,1423,106,0,3897
2012,South Sudan,Lainya,0,0,0,0,0,0,4,4,0,0,0,0,0,0,4,4
2012,South Sudan,Kajo Keji,0,0,0,0,0,0,752,752,0,0,0,0,0,0,639,639
2012,South Sudan,Juba : County,0,0,0,0,0,0,25,25,0,0,0,0,35,0,29,64
2012,South Sudan,Juba,256,255,0,89,733,8,0,1341,237,233,0,108,3288,48,0,3914
2012,South Sudan,Jamam,1474,2045,0,1056,3484,380,0,8439,1494,1960,0,846,2589,501,0,7390
2012,South Sudan,Gorom,174,172,0,73,335,6,0,760,208,181,0,114,687,4,0,1194
2012,South Sudan,Gendrassa,1397,2103,0,941,3183,230,0,7854,1483,1944,0,866,2325,286,0,6904
2012,South Sudan,Ezo : County,232,404,0,190,1045,99,0,1970,271,367,0,190,877,83,0,1788
2012,South Sudan,Doro,4771,5978,0,2722,9177,487,0,23135,5081,6127,0,2841,7078,452,0,21579
2012,South Sudan,Batil,3550,4706,0,2217,7733,727,0,18933,3683,4669,0,2241,6304,924,0,17821
2012,South Sudan,Andari : Point,14,32,0,12,93,9,0,160,20,38,0,11,68,7,0,144
2012,Suriname,Suriname : Dispersed in the country / territory,0,0,0,0,1,0,0,1,0,0,0,0,2,0,0,2
2012,Slovakia,Humenne : Point,2,5,0,1,6,0,0,14,2,1,0,0,6,0,0,9
2012,Slovakia,Slovakia : Dispersed in the country / territory,27,17,0,9,64,0,0,117,17,3,0,7,597,0,0,624
2012,Slovenia,Ljubljana : Obcine - Municipality,2,9,0,6,48,0,0,65,4,16,0,28,163,0,0,211
2012,Sweden,Sweden : Dispersed in the country / territory,0,0,0,0,0,0,10655,10655,0,0,0,0,0,0,16018,16018
2012,Swaziland,Malindza Reception Centre,21,34,0,23,74,0,0,152,21,29,0,32,172,3,0,257
2012,Swaziland,Swaziland : Dispersed in the country / territory,21,30,0,32,126,2,0,211,19,41,0,37,206,4,0,307
2012,Sint Maarten (Dutch part),Philipsburg : Point,0,0,0,0,3,0,0,3,0,0,0,1,3,0,0,4
2012,Syrian Arab Rep.,Al Hol : Point,5,4,0,5,30,4,0,48,7,5,0,2,40,3,0,57
2012,Syrian Arab Rep.,Tartous : Mohafazah - Governorate,18,27,0,41,121,16,0,223,15,31,0,42,111,27,0,226
2012,Syrian Arab Rep.,Syrian Arab Republic : Dispersed in the country / territory,122,220,0,187,779,61,0,1369,124,229,0,225,669,67,0,1314
2012,Syrian Arab Rep.,Raqqa : Mohafazah - Governorate,12,22,0,15,45,3,0,97,14,18,0,18,34,1,0,85
2012,Syrian Arab Rep.,Lattakia : Mohafazah - Governorate,10,44,0,37,140,16,0,247,21,44,0,53,145,25,0,288
2012,Syrian Arab Rep.,Idleb : Mohafazah - Governorate,16,19,0,21,83,2,0,141,18,38,0,26,74,2,0,158
2012,Syrian Arab Rep.,Homs : Mohafazah - Governorate,60,133,0,133,421,49,0,796,80,151,0,138,399,80,0,848
2012,Syrian Arab Rep.,Hassakeh : Mohafazah - Governorate,375,620,0,412,1612,192,0,3211,359,671,0,473,1014,138,0,2655
2012,Syrian Arab Rep.,Hama : Mohafazah - Governorate,7,20,0,14,62,6,0,109,16,21,0,25,44,8,0,114
2012,Syrian Arab Rep.,Dayr Az-Zor : Mohafazah - Governorate,50,80,0,64,215,12,0,421,50,71,0,60,193,20,0,394
2012,Syrian Arab Rep.,Dara : Mohafazah - Governorate,56,110,0,102,321,29,0,618,70,128,0,139,311,36,0,684
2012,Syrian Arab Rep.,Damascus : Mohafazah - Governorate,1903,3846,0,3485,14649,1972,0,25855,1983,4020,0,3686,14396,2300,0,26385
2012,Syrian Arab Rep.,As-Suweida : Mohafazah - Governorate,2,1,0,1,7,0,0,11,1,1,0,3,9,0,0,14
2012,Syrian Arab Rep.,Aleppo : Mohafazah - Governorate,176,268,0,254,1027,93,0,1818,165,259,0,285,1016,126,0,1851
2012,Turks and Caicos Islands,Turks and Caicos Islands : Dispersed in the country / territory,1,0,0,1,8,0,0,10,0,2,0,0,10,0,0,12
2012,Chad,Am Nabak : Point,1198,2280,0,2251,5397,525,0,11651,1298,2296,0,1860,2039,354,0,7847
2012,Chad,Amboko : Point,641,1291,0,1518,2431,136,0,6017,612,1238,0,1429,1867,134,0,5280
2012,Chad,Bredjing : Point,3316,3646,0,2942,9163,1042,0,20109,3400,3628,0,3147,6465,745,0,17385
2012,Chad,Djabal : Point,1912,1850,0,1497,4596,414,0,10269,1955,1885,0,1602,2856,323,0,8621
2012,Chad,Dosseye : Point,649,1375,0,1134,2256,140,0,5554,625,1343,0,976,1277,147,0,4368
2012,Chad,Farchana : Point,2108,2547,0,2091,6023,647,0,13416,2114,2553,0,2156,3736,444,0,11003
2012,Chad,Gaga : Point,2218,2655,0,1865,5037,314,0,12089,2201,2549,0,1970,3166,291,0,10177
2012,Chad,Gondje : Point,720,1492,0,1300,2590,125,0,6227,703,1419,0,1394,1902,72,0,5490
2012,Chad,Goz Amer : Point,2849,2915,0,1922,6347,627,0,14660,2807,2915,0,2093,4057,559,0,12431
2012,Chad,Iridimi : Point,1780,2348,0,2506,4973,467,0,12074,1783,2261,0,2284,2382,299,0,9009
2012,Chad,Kounoungou : Point,1337,2430,0,2095,4804,360,0,11026,1320,2347,0,1954,2221,275,0,8117
2012,Chad,Mile : Point,1709,2432,0,1942,4928,463,0,11474,1662,2300,0,1762,2318,307,0,8349
2012,Chad,Moula : Point,454,895,0,428,1217,96,0,3090,516,883,0,521,953,85,0,2958
2012,Chad,Moyo : Point,757,1210,0,498,1735,176,0,4376,751,1130,0,515,982,99,0,3477
2012,Chad,N'Djamena : Region,58,156,0,209,223,302,0,948,38,179,0,238,469,271,0,1195
2012,Chad,Oure Cassoni : Point,2279,3874,0,4110,8943,751,0,19957,2325,3747,0,3322,3568,348,0,13310
2012,Chad,Touloum : Point,2281,3116,0,3299,6748,646,0,16090,2260,2960,0,3001,3237,392,0,11850
2012,Chad,Treguine : Point,1980,1924,0,1450,4713,500,0,10567,2029,2011,0,1552,3394,404,0,9390
2012,Chad,Yaroungou : Point,734,1235,0,1069,2942,260,0,6240,718,1207,0,1098,2166,165,0,5354
2012,Togo,Tandjoare : Region,974,992,0,498,2016,300,0,4780,949,1025,0,357,302,61,0,2694
2012,Togo,Sotouboua : Region,786,1156,0,378,1670,168,0,4158,750,1227,0,561,1179,153,0,3870
2012,Togo,Lome : Point,349,420,0,310,1901,44,0,3024,384,391,0,343,2496,29,0,3643
2012,Togo,Dankpen : Region,185,273,0,90,395,40,0,983,169,276,0,126,267,34,0,872
2012,Thailand,Umpium : Point,572,845,0,756,2867,253,0,5293,610,893,0,767,2794,224,0,5288
2012,Thailand,Tham Hin : Point,436,611,0,439,1928,190,0,3604,426,636,0,449,1969,158,0,3638
2012,Thailand,Nu Po : Point,751,1305,0,1054,4178,342,0,7630,726,1341,0,1085,4612,321,0,8085
2012,Thailand,Mai Nai Soi : Point,686,1110,0,671,2890,339,0,5696,699,1164,0,635,3208,328,0,6034
2012,Thailand,Mae Sot : Point,0,13,0,11,75,2,0,101,2,6,0,10,127,3,0,148
2012,Thailand,Mae Ra Ma Luang : Point,609,945,0,647,2275,241,0,4717,632,915,0,695,2163,292,0,4697
2012,Thailand,Mae La Oon : Point,651,820,0,609,2390,251,0,4721,643,837,0,651,2488,271,0,4890
2012,Thailand,Mae La : Point,1509,2368,0,1954,6961,851,0,13643,1571,2402,0,2131,6173,770,0,13047
2012,Thailand,Ban Mae Surin : Point,120,145,0,112,486,42,0,905,116,152,0,131,480,58,0,937
2012,Thailand,Ban Don Yang : Point,215,313,0,247,965,85,0,1825,228,310,0,258,858,83,0,1737
2012,Thailand,Bangkok : Metropolitan Administration,117,149,0,69,615,27,0,977,121,170,0,113,1003,39,0,1446
2012,Tajikistan,Tajikistan : Dispersed in the country / territory,2,0,0,0,3,0,0,5,0,3,0,0,5,0,1323,1331
2012,Tajikistan,Khujand : Point,0,0,0,0,0,0,0,0,0,0,0,0,0,0,181,181
2012,Tajikistan,Khatlon : Province,0,0,0,0,0,0,0,0,0,0,0,0,0,0,86,86
2012,Tajikistan,Dushanbe : Capital City,1,9,0,10,11,0,0,31,1,3,0,8,18,1,2482,2513
2012,Turkmenistan,Turkmenistan : Dispersed in the country / territory,0,0,0,0,0,0,341,341,0,0,0,0,0,0,341,341
2012,Turkmenistan,Turkmenbashi : District,0,0,0,0,5,4,0,9,0,0,0,0,4,1,0,5
2012,Turkmenistan,Turkmenabat : District,0,0,0,1,8,0,0,9,0,0,0,0,8,0,0,8
2012,Turkmenistan,Mary province,0,0,0,0,0,0,338,338,0,0,0,0,0,0,337,337
2012,Turkmenistan,Mary,0,0,0,0,0,0,0,0,0,0,0,0,1,0,0,1
2012,Turkmenistan,Lebap province,0,0,0,0,0,0,1715,1715,0,0,0,0,0,0,1714,1714
2012,Turkmenistan,Dashoguz province,0,0,0,0,0,0,1755,1755,0,0,0,0,0,0,1755,1755
2012,Turkmenistan,Balkan provjnce,0,0,0,0,0,0,172,172,0,0,0,0,0,0,171,171
2012,Turkmenistan,Ahal province,0,0,0,0,0,0,90,90,0,0,0,0,0,0,89,89
2012,Turkmenistan,Ashgabat : Capital City,0,0,0,0,5,2,65,72,0,0,0,0,7,0,64,71
2012,Timor-Leste,Dili : District,0,0,0,0,0,0,0,0,0,0,0,0,1,0,0,1
2012,Tonga,Nuku'alofa : Point,1,0,0,0,0,0,0,1,1,0,0,0,1,0,0,2
2012,Trinidad and Tobago,Port Of Spain : Region,0,0,0,0,1,0,0,1,0,1,0,0,13,0,0,14
2012,Trinidad and Tobago,Port of Spain : Municipality,0,2,0,0,2,0,0,4,0,2,0,0,4,0,0,6
2012,Tunisia,Zarzis,4,4,0,5,38,0,0,51,7,4,0,4,45,3,0,63
2012,Tunisia,Tunis : Wilayat - Governorate,11,4,0,2,84,5,0,106,6,4,0,8,244,4,0,266
2012,Tunisia,Sousse : Wilayat - Governorate,0,1,0,1,3,1,0,6,0,1,0,0,4,3,0,8
2012,Tunisia,Shousha : Point,26,16,0,11,98,0,0,151,46,22,0,50,867,10,0,995
2012,Tunisia,Sfax : Wilayat - Governorate,0,1,0,0,1,0,0,2,1,1,0,1,2,0,0,5
2012,Tunisia,Monastir : Mutamadiyat,0,0,0,0,1,0,0,1,0,0,0,0,0,0,0,0
2012,Tunisia,Medennine,0,0,0,0,0,0,0,0,0,0,0,0,11,0,0,11
2012,Tunisia,Bizerte : Wilayat - Governorate,0,0,0,0,1,0,0,1,0,0,0,0,0,0,0,0
2012,Tunisia,Bengurdane,4,4,0,3,29,2,0,42,5,4,0,4,51,4,0,68
2012,Turkey,Yozgat Urban : Point,37,62,0,49,230,28,0,406,23,56,0,72,236,33,0,420
2012,Turkey,Yozgat Camp : Point,4,8,0,4,19,0,0,35,5,3,0,7,3,0,0,18
2012,Turkey,Yalova : Province,39,56,0,34,244,21,0,394,43,46,0,33,296,24,0,442
2012,Turkey,Van : Province,10,16,0,19,84,1,0,130,10,24,0,57,136,2,0,229
2012,Turkey,Usak : Province,7,10,0,8,35,2,0,62,6,13,0,14,61,1,0,95
2012,Turkey,Urfa : Point,4,6,0,4,17,0,30809,30840,7,12,0,9,32,0,35579,35639
2012,Turkey,Turkey : Dispersed in the country / territory,0,0,0,1,1,0,0,2,0,0,0,4,3,0,0,7
2012,Turkey,Tokat : Province,12,27,0,21,105,12,0,177,33,26,0,25,169,13,0,266
2012,Turkey,Tekirdag : Point,0,0,0,0,1,0,0,1,0,1,0,1,4,0,0,6
2012,Turkey,Sivas : Province,28,37,0,33,125,5,0,228,19,53,0,43,171,7,0,293
2012,Turkey,Sirnak : Point,3,7,0,3,14,0,0,27,1,2,0,5,27,0,0,35
2012,Turkey,Sinop,0,0,0,0,1,0,0,1,1,0,0,0,1,0,0,2
2012,Turkey,Siirt : Province,6,8,0,9,30,0,0,53,4,5,0,17,31,1,0,58
2012,Turkey,Sakarya : Province,80,127,0,85,468,32,0,792,110,166,0,123,621,34,0,1054
2012,Turkey,Osmaniye,0,0,0,0,0,0,4191,4191,0,0,0,0,0,0,3578,3578
2012,Turkey,Nigde : Province,17,36,0,42,231,16,0,342,19,43,0,30,304,18,0,414
2012,Turkey,Nevsehir : Province,28,47,0,43,345,17,0,480,41,60,0,97,501,18,0,717
2012,Turkey,Mersin : Province,33,45,0,31,158,7,0,274,30,61,0,39,210,6,0,346
2012,Turkey,Mardin : Province,11,22,0,9,42,1,0,85,6,26,0,17,63,1,0,113
2012,Turkey,Manisa : Province,0,0,0,0,0,0,0,0,0,0,0,0,1,0,0,1
2012,Turkey,Malatya : Province,16,25,0,17,79,3,0,140,14,26,0,32,128,7,0,207
2012,Turkey,Kutahya : Province,33,52,0,56,197,5,0,343,40,59,0,53,244,7,0,403
2012,Turkey,Konya : Province,35,50,0,44,219,8,0,356,44,50,0,58,304,6,0,462
2012,Turkey,Kirsehir : Province,78,116,0,75,404,50,0,723,87,131,0,87,543,33,0,881
2012,Turkey,Kirklareli : Province,0,4,0,5,13,1,0,23,2,7,0,4,14,1,0,28
2012,Turkey,Kirikkale : Province,23,53,0,24,157,4,0,261,29,46,0,37,211,11,0,334
2012,Turkey,Kilis,0,0,0,0,0,0,6793,6793,0,0,0,0,6,0,7198,7204
2012,Turkey,Kayseri : Province,45,83,0,68,614,49,0,859,44,105,0,106,690,43,0,988
2012,Turkey,Kastamonu : Province,18,37,0,29,128,6,0,218,22,25,0,44,195,8,0,294
2012,Turkey,Kars : Province,29,40,0,25,87,1,0,182,20,47,0,47,94,0,0,208
2012,Turkey,Karaman : Province,7,14,0,16,55,1,0,93,13,14,0,18,81,2,0,128
2012,Turkey,K.Maras : Point,14,17,0,20,52,1,7189,7293,9,18,0,14,75,1,7613,7730
2012,Turkey,Izmit : Point,0,0,0,0,1,0,0,1,0,0,0,0,3,0,0,3
2012,Turkey,Izmir : Province,1,3,0,2,18,0,0,24,0,5,0,2,44,0,0,51
2012,Turkey,Istanbul : Province,74,125,0,129,737,37,0,1102,99,151,0,331,1259,53,0,1893
2012,Turkey,Isparta : Province,31,56,0,42,204,6,0,339,53,63,0,56,223,4,0,399
2012,Turkey,Igdir : Province,1,0,0,0,2,0,0,3,0,0,0,0,4,0,0,4
2012,Turkey,Hatay : Province,11,13,0,14,50,0,6085,6173,11,16,0,13,82,0,6812,6934
2012,Turkey,Hakkari : Province,1,0,0,1,6,0,0,8,0,5,0,3,8,0,0,16
2012,Turkey,Gumushane : Province,6,10,0,9,37,1,0,63,7,16,0,16,51,2,0,92
2012,Turkey,Gaziantep : Province,43,99,0,75,278,9,12564,13068,52,96,0,77,409,12,13589,14235
2012,Turkey,Eskisehir : Province,32,55,0,50,233,13,0,383,33,73,0,49,326,14,0,495
2012,Turkey,Erzurum : Province,25,49,0,46,137,3,0,260,17,65,0,47,164,5,0,298
2012,Turkey,Erzincan : Province,19,42,0,26,73,1,0,161,24,33,0,25,101,2,0,185
2012,Turkey,Edirne : Province,2,1,0,0,5,1,0,9,0,0,0,0,6,1,0,7
2012,Turkey,Duzce : Province,32,49,0,25,140,6,0,252,32,43,0,27,231,11,0,344
2012,Turkey,Denizli : Province,31,29,0,24,202,8,0,294,21,56,0,46,332,7,0,462
2012,Turkey,Corum : Province,28,55,0,48,181,17,0,329,27,65,0,42,209,14,0,357
2012,Turkey,Cankiri : Province,7,15,0,12,61,3,0,98,2,16,0,29,109,7,0,163
2012,Turkey,Canakkale : Province,0,0,0,2,12,0,0,14,0,1,0,4,18,1,0,24
2012,Turkey,Bursa : Province,0,0,0,0,1,0,0,1,0,0,0,0,2,0,0,2
2012,Turkey,Burdur : Province,18,39,0,44,200,3,0,304,29,38,0,64,260,2,0,393
2012,Turkey,Bolu : Province,27,29,0,20,111,5,0,192,27,36,0,25,145,8,0,241
2012,Turkey,Bilecik : Province,14,10,0,9,78,11,0,122,12,21,0,18,101,10,0,162
2012,Turkey,Bayburt : Province,10,17,0,6,38,1,0,72,7,12,0,9,53,2,0,83
2012,Turkey,Batman : Province,13,25,0,31,64,3,0,136,22,35,0,29,83,1,0,170
2012,Turkey,Balikesir : Province,10,15,0,8,69,2,0,104,10,26,0,19,96,4,0,155
2012,Turkey,Ardahan,1,0,0,1,1,0,0,3,0,1,0,0,5,0,0,6
2012,Turkey,Antalya : Province,0,0,0,2,6,0,0,8,2,1,0,0,8,0,0,11
2012,Turkey,Ankara : Province,14,38,0,24,183,7,0,266,16,34,0,44,332,10,0,436
2012,Turkey,Amasya : Province,57,72,0,48,235,23,0,435,45,68,0,66,293,24,0,496
2012,Turkey,Aksaray : Province,34,62,0,48,193,11,0,348,28,58,0,78,234,13,0,411
2012,Turkey,Agri : Province,22,38,0,35,140,4,0,239,23,66,0,98,190,5,0,382
2012,Turkey,Afyon : Point,44,67,0,59,287,16,0,473,46,77,0,83,372,18,0,596
2012,Turkey,Adiyaman,1,1,0,2,1,0,4560,4565,1,0,0,0,1,0,4580,4582
2012,Turkey,Adana : Province,48,104,0,90,380,12,0,634,61,113,0,106,540,18,0,838
2012,United Rep. of Tanzania,Ulyankulu : Point,3042,6744,0,4123,10452,882,0,25243,2886,6434,0,4408,9665,673,0,24066
2012,United Rep. of Tanzania,Pemba,6,3,0,1,11,0,0,21,9,2,0,0,12,0,0,23
2012,United Rep. of Tanzania,Nyarugusu : Point,6507,7163,0,5524,15765,1099,0,36058,6209,6493,0,5695,13122,555,0,32074
2012,United Rep. of Tanzania,Mishamo : Point,3563,6667,0,5110,11821,1091,0,28252,3506,6722,0,4350,11391,1167,0,27136
2012,United Rep. of Tanzania,Kigoma : Region,1742,2103,0,2009,4554,367,0,10775,1730,2279,0,1993,5028,422,0,11452
2012,United Rep. of Tanzania,Katumba : Point,3623,7868,0,6291,14936,1352,0,34070,3726,7749,0,5618,13859,1404,0,32356
2012,United Rep. of Tanzania,Chogo : Point,151,208,0,169,525,45,0,1098,150,226,0,218,352,59,0,1005
2012,United Rep. of Tanzania,National Milling Co-operation Transit Centre : Point,2,12,0,4,13,0,0,31,9,8,0,8,19,1,0,45
2012,United Rep. of Tanzania,Dar es Salaam : Region,14,12,0,5,19,0,0,50,6,2,0,11,69,0,0,88
2012,Uganda,Rwamanja,4122,3543,0,3379,3579,117,0,14740,4081,3609,0,3406,3859,102,0,15057
2012,Uganda,Rhino Camp : Point,340,579,0,422,812,79,0,2232,341,592,0,553,515,33,0,2034
2012,Uganda,Oruchinga : Point,536,730,0,379,1248,67,0,2960,582,680,0,406,1089,72,0,2829
2012,Uganda,Nakivale : Point,5530,7713,0,4901,13228,603,0,31975,5554,7750,0,5034,13423,637,0,32398
2012,Uganda,Kyangwali : Point,2302,3935,0,4217,304,2,0,10760,2393,3976,0,3883,267,1,0,10520
2012,Uganda,Kiryandongo : District,238,414,0,317,838,80,0,1887,239,430,0,345,687,64,0,1765
2012,Uganda,Kayaka II : Point,1964,2166,0,1402,3385,276,0,9193,1954,2150,0,1453,3041,264,0,8862
2012,Uganda,Kampala : City,3205,9220,0,13634,5213,169,0,31441,3310,9483,0,17456,7642,144,0,38035
2012,Uganda,Adjumani : District,712,1210,0,873,2025,145,0,4965,723,1299,0,880,1351,61,0,4314
2012,Ukraine,Ukraine : Dispersed in the country / territory,0,0,0,0,0,0,1773,1773,0,0,0,0,0,0,4687,4687
2012,Uruguay,Montevideo : Point,2,9,0,8,54,9,0,82,2,7,0,10,108,11,0,138
2012,Uzbekistan,Termez : Point,0,0,0,0,1,0,0,1,0,0,0,0,7,0,0,7
2012,Uzbekistan,Tashkent : Point,4,10,0,11,49,5,0,79,4,6,0,11,59,9,0,89
2012,Venezuela (Bolivarian Republic of),Zulia : Point,15,15,0,20,47,2,26686,26785,18,22,0,17,58,4,29961,30080
2012,Venezuela (Bolivarian Republic of),Venezuela : Dispersed in the country / territory,86,200,0,306,1077,48,39740,41457,106,240,0,319,1197,65,43142,45069
2012,Venezuela (Bolivarian Republic of),Tachira : Point,28,26,0,27,52,4,20116,20253,22,31,0,31,75,4,21561,21724
2012,Venezuela (Bolivarian Republic of),Caracas : Point,7,4,0,5,47,1,0,64,9,5,0,5,131,3,0,153
2012,Venezuela (Bolivarian Republic of),Apure : Point,12,18,0,16,34,3,7359,7442,15,18,0,15,39,5,7915,8007
2012,British Virgin Islands,Tortola : District,0,0,0,0,0,0,0,0,0,0,0,0,2,0,0,2
2012,Viet Nam,Viet Nam : Dispersed in the country / territory,0,0,0,0,0,0,6500,6500,0,0,0,0,0,0,4500,4500
2012,Viet Nam,Ho Chi Minh City : Thanh Pho - Municipality,0,0,0,0,0,0,300,300,0,0,0,0,0,0,200,200
2012,Vanuatu,Port Vila : Province,0,0,0,1,0,0,0,1,0,0,0,0,1,0,0,1
2012,Yemen,Taiz : Point,79,164,0,146,601,43,0,1033,95,142,0,123,335,25,0,720
2012,Yemen,Shabwa : Point,15,28,0,29,151,6,0,229,12,22,0,22,171,2,0,229
2012,Yemen,Shabwa : Muhafazah - Governorate,35,92,0,81,363,36,0,607,38,98,0,87,332,34,0,589
2012,Yemen,Sana'a : Point,4471,7976,0,4980,21015,1115,0,39557,4781,8967,0,5560,22371,1133,0,42812
2012,Yemen,"S,adah : Muhafazah - Governorate",4540,15855,0,10130,22988,1202,0,54715,4234,17234,0,12920,21310,1543,0,57241
2012,Yemen,Rada' : District,29,18,0,17,56,5,0,125,25,33,0,32,62,5,0,157
2012,Yemen,Mukalla : Point,523,587,0,364,1778,93,0,3345,492,552,0,332,3825,116,0,5317
2012,Yemen,Mahra : Point,176,130,0,58,376,7,0,747,177,126,0,66,957,15,0,1341
2012,Yemen,Lahjj : Governorate,360,952,0,844,3776,375,0,6307,425,1096,0,981,3723,380,0,6605
2012,Yemen,Hodeidah : Point,20,40,0,41,109,24,0,234,19,55,0,55,104,19,0,252
2012,Yemen,Hajjah : Muhafazah - Governorate,4733,15656,0,9965,22646,1195,0,54195,4474,16972,0,12563,20893,1556,0,56458
2012,Yemen,Hadramout: Muhafazah - Governorate,110,290,0,257,1151,115,0,1923,119,307,0,275,1043,106,0,1850
2012,Yemen,Dhamar : Point,18,19,0,18,78,2,0,135,17,16,0,16,47,4,0,100
2012,Yemen,Amran : Muhafazah - Governorate,1370,5880,0,3704,9005,496,0,20455,1408,6144,0,4139,7091,543,0,19325
2012,Yemen,Al-Maharah : Governorate,9,23,0,20,92,9,0,153,10,26,0,23,89,10,0,158
2012,Yemen,Al-Bayda: Muhafazah - Governorate,26,68,0,60,268,26,0,448,28,72,0,65,245,25,0,435
2012,Yemen,Al-Baida : Point,8,34,0,33,86,7,0,168,14,23,0,23,92,2,0,154
2012,Yemen,Al Kharaz : Point,319,1787,0,1464,4929,122,0,8621,1480,1820,0,1701,5281,144,0,10426
2012,Yemen,Al Jawf : Muhafazah - Governorate,838,3593,0,2264,5503,302,0,12500,889,3879,0,2613,4477,342,0,12200
2012,Yemen,Aden : Point,1402,3010,0,2871,17436,995,0,25714,1539,3048,0,3027,33488,894,0,41996
2012,Yemen,Abyan: Muhafazah - Governorate,811,2145,0,1902,8511,846,0,14215,930,2400,0,2148,8154,833,0,14465
2012,Yemen,Abyan : Governorate,3410,7643,0,6153,29262,3458,0,49926,3916,8107,0,6786,26286,3045,0,48140
2012,Yemen,Yemen : Dispersed in the country / territory,788,1400,0,6522,28077,118,0,36905,649,751,0,3534,77472,220,0,82626
2012,Zambia,Others locations,372,1522,0,1658,228,0,0,3780,341,1597,0,2156,326,0,0,4420
2012,Zambia,Other locations,239,559,0,321,1031,49,0,2199,228,486,0,315,1117,84,0,2230
2012,Zambia,Meheba,1226,2154,0,1268,3565,315,0,8528,1213,2138,0,1238,4161,430,0,9180
2012,Zambia,Mayukwayukwa,798,1183,0,774,2118,151,0,5024,802,1134,0,776,2053,328,0,5093
2012,Zambia,Lusaka Urban,301,672,0,543,1942,57,0,3515,304,610,0,511,2807,110,0,4342
2012,Zimbabwe,Tongogara : Point,267,364,0,252,620,12,0,1515,290,424,0,290,745,15,0,1764
2012,Zimbabwe,Harare : City,67,103,0,60,258,2,0,490,79,93,0,77,355,5,0,609
2013,Aruba,Aruba : Dispersed in the country / territory,0,0,0,0,2,0,0,2,0,0,0,0,4,0,0,4
2013,Afghanistan,Zabul : Wilayat - Province,972,1531,0,1085,3339,166,0,7093,1004,1543,0,1151,3009,299,0,7006
2013,Afghanistan,Wardak : Wilayat - Province,1164,1875,0,1377,4357,220,0,8993,1188,1891,0,1427,3810,395,0,8711
2013,Afghanistan,Uruzgan : Wilayat - Province,1510,2245,0,1573,5004,247,0,10579,1549,2208,0,1649,4453,420,0,10279
2013,Afghanistan,Urozgan : Wilayat - Province,9,60,0,36,78,5,0,188,14,50,0,32,84,10,0,190
2013,Afghanistan,Takhar : Wilayat - Province,214,590,0,382,1034,63,0,2283,206,594,0,393,1008,113,0,2314
2013,Afghanistan,Sari Pul : Wilayat - Province,852,1267,0,887,2823,139,0,5968,874,1246,0,931,2513,237,0,5801
2013,Afghanistan,Sar-e Pol : Wilayat - Province,142,483,0,378,1009,79,0,2091,136,502,0,399,985,129,0,2151
2013,Afghanistan,Samangan : Wilayat - Province,82,228,0,164,443,35,0,952,66,261,0,171,387,53,0,938
2013,Afghanistan,Parwan : Wilayat - Province,378,1042,0,781,2292,95,0,4588,389,1094,0,829,2136,202,0,4650
2013,Afghanistan,Panjshir : Wilayat - Province,15,54,0,57,164,7,0,297,12,60,0,60,149,9,0,290
2013,Afghanistan,Panjsher : Wilayat - Province,17,25,0,18,56,3,0,119,17,25,0,19,49,5,0,115
2013,Afghanistan,Paktya : Wilayat - Province,92,137,0,96,305,15,0,645,94,135,0,101,271,26,0,627
2013,Afghanistan,Paktika : Wilayat - Province,452,689,0,481,1522,77,0,3221,454,675,0,514,1347,132,0,3122
2013,Afghanistan,Paktia : Wilayat - Province,672,1810,0,1396,3592,241,0,7711,656,1865,0,1465,2891,411,0,7288
2013,Afghanistan,Nuristan : Wilayat - Province,384,582,0,421,1268,62,0,2717,394,582,0,430,1136,106,0,2648
2013,Afghanistan,Nimruz : Wilayat - Province,20,41,0,30,115,6,0,212,15,66,0,41,123,8,0,253
2013,Afghanistan,Nimroz : Wilayat - Province,35,52,0,37,116,6,0,246,36,51,0,38,104,10,0,239
2013,Afghanistan,Nangarhar : Wilayat - Province,8809,17632,0,12615,35006,1794,0,75856,9006,17753,0,13198,31242,3080,0,74279
2013,Afghanistan,Logar : Wilayat - Province,920,2180,0,1618,4280,223,0,9221,964,2227,0,1690,3730,397,0,9008
2013,Afghanistan,Laghman : Wilayat - Province,932,2571,0,1751,4436,206,0,9896,922,2542,0,1763,4117,372,0,9716
2013,Afghanistan,Kunduz : Wilayat - Province,1391,3672,0,2494,6334,337,0,14228,1518,3835,0,2648,5974,591,0,14566
2013,Afghanistan,Kunar : Wilayat - Province,2878,5080,0,3478,10084,501,0,22021,2951,5088,0,3741,9220,876,0,21876
2013,Afghanistan,Khost : Wilayat - Province,853,1493,0,1096,3264,196,0,6902,852,1503,0,1201,2879,303,0,6738
2013,Afghanistan,Kapisa : Wilayat - Province,327,630,0,450,1440,69,0,2916,346,621,0,482,1292,118,0,2859
2013,Afghanistan,Kandahar : Wilayat - Province,3963,7142,0,5138,14505,749,0,31497,4074,7039,0,5498,13556,1307,0,31474
2013,Afghanistan,Kabul : Wilayat - Province,2623,8261,0,6385,21106,1116,0,39491,2655,8630,0,6699,18542,1872,0,38398
2013,Afghanistan,Jowzjan : Wilayat - Province,242,900,0,648,2045,176,0,4011,222,929,0,645,1830,253,0,3879
2013,Afghanistan,Jawzjan : Wilayat - Province,807,1200,0,841,2675,132,0,5655,828,1180,0,882,2380,225,0,5495
2013,Afghanistan,Hirat : Wilayat - Province,7988,11880,0,8321,26475,1307,0,55971,8196,11680,0,8725,23561,2223,0,54385
2013,Afghanistan,Hilmand : Wilayat - Province,8715,12959,0,9078,28882,1424,0,61058,8940,12742,0,9518,25706,2425,0,59331
2013,Afghanistan,Herat : Wilayat - Province,366,1200,0,1002,4639,225,0,7432,299,1384,0,1047,4426,337,0,7493
2013,Afghanistan,Helmand : Wilayat - Province,423,1244,0,855,1828,116,0,4466,414,1213,0,963,1744,213,0,4547
2013,Afghanistan,Ghor : Wilayat - Province,2286,3404,0,2389,7600,377,0,16056,2348,3351,0,2506,6787,642,0,15634
2013,Afghanistan,Ghazni : Wilayat - Province,1679,2665,0,1921,6079,330,0,12674,1737,2671,0,2025,5442,548,0,12423
2013,Afghanistan,Faryab : Wilayat - Province,3110,4853,0,3422,10791,540,0,22716,3195,4846,0,3561,9546,946,0,22094
2013,Afghanistan,Farah : Wilayat - Province,956,1635,0,1202,3639,175,0,7607,999,1655,0,1233,3277,298,0,7462
2013,Afghanistan,Daykundi : Wilayat - Province,6,40,0,24,103,8,0,181,11,39,0,27,108,13,0,198
2013,Afghanistan,Bamyan : Wilayat - Province,20,103,0,83,343,32,0,581,15,89,0,75,309,46,0,534
2013,Afghanistan,Balkh : Wilayat - Province,1164,2383,0,1693,5482,315,0,11037,1196,2429,0,1803,4898,498,0,10824
2013,Afghanistan,Baghlan : Wilayat - Province,630,1612,0,1113,3068,145,0,6568,634,1692,0,1156,2814,321,0,6617
2013,Afghanistan,Badghis : Wilayat - Province,1252,1878,0,1312,4154,202,0,8798,1271,1840,0,1372,3731,350,0,8564
2013,Afghanistan,Badakhshan : Wilayat - Province,187,296,0,210,659,30,0,1382,183,291,0,223,655,58,0,1410
2013,Afghanistan,Afghanistan : Dispersed in the country / territory,78,256,0,228,441,11,0,1014,104,212,0,177,225,15,0,733
2013,Albania,Tirana Urban : Point,6,4,0,3,17,3,0,33,7,4,0,5,31,2,0,49
2013,Albania,Tirana Camp : Point,0,0,0,0,55,6,0,61,0,0,0,0,118,14,0,132
2013,Albania,Shkoder,0,0,0,2,2,0,0,4,1,0,0,0,3,0,0,4
2013,Albania,Fier,0,0,0,0,0,0,0,0,0,0,0,0,1,0,0,1
2013,Albania,Elbasan,0,0,0,0,0,0,0,0,0,0,0,0,1,0,0,1
2013,Albania,Durres,1,1,0,0,1,0,0,3,0,0,0,0,1,0,0,1
2013,Albania,Babrru Centre,0,1,0,1,8,0,0,10,1,1,0,3,11,1,0,17
2013,Albania,Peshkopi : Bashki - Municipality,0,0,0,0,0,1,0,1,0,0,0,0,0,0,0,0
2013,Albania,Mamurras : Bashki - Municipality,0,1,0,0,1,0,0,2,0,2,0,0,0,0,0,2
2013,United Arab Emirates,Abu Dhabi : Emirate,19,54,0,38,212,26,0,349,21,49,0,34,201,26,0,331
2013,Argentina,Argentina : Dispersed in the country / territory,19,66,0,85,1024,310,0,1504,20,73,0,116,1973,592,0,2774
2013,Armenia,Yerevan : City,38,78,0,89,637,203,0,1045,55,73,0,91,725,135,0,1079
2013,Armenia,Vayots Dzor : Marz - Province,0,0,0,0,4,0,0,4,0,0,0,0,1,0,0,1
2013,Armenia,Tavush : Marz - Province,0,0,0,0,8,22,0,30,0,0,0,0,3,5,0,8
2013,Armenia,Syunik : Marz - Province,0,0,0,0,58,18,0,76,0,0,0,0,54,6,0,60
2013,Armenia,Shirak : Marz - Province,0,0,0,0,17,3,0,20,0,0,0,0,14,3,0,17
2013,Armenia,Lori : Marz - Province,0,0,0,0,44,14,0,58,0,0,0,0,42,10,0,52
2013,Armenia,Kotayk : Marz - Province,0,0,0,0,86,56,0,142,0,0,0,0,90,35,0,125
2013,Armenia,Gergharkunik : Marz - Province,0,0,0,0,35,13,0,48,0,0,0,0,39,13,0,52
2013,Armenia,Armavir : Marz - Province,0,0,0,0,50,38,0,88,0,0,0,0,47,17,0,64
2013,Armenia,Ararat : Marz - Province,0,0,0,0,34,33,0,67,0,0,0,0,45,39,0,84
2013,Armenia,Aragatsotn : Marz - Province,0,0,0,0,40,18,0,58,0,0,0,0,32,10,0,42
2013,Antigua and Barbuda,St. John,0,0,0,0,0,0,0,0,0,0,0,0,1,0,0,1
2013,Azerbaijan,Baku : Municipality,74,107,0,81,333,27,0,622,66,120,0,90,536,24,0,836
2013,Burundi,Musasa : Point,600,979,0,515,1361,66,0,3521,639,954,0,575,1111,29,0,3308
2013,Burundi,Kinama: Point,814,1315,0,798,2028,101,0,5056,810,1370,0,814,1643,66,0,4703
2013,Burundi,Kavumu: Point,385,422,0,211,656,18,0,1692,402,452,0,195,495,16,0,1560
2013,Burundi,Bwagiriza : Point,946,1154,0,671,1947,85,0,4803,965,1259,0,702,1468,92,0,4486
2013,Burundi,Butare : Point,20,28,0,6,46,2,0,102,12,22,0,14,54,3,0,105
2013,Burundi,Bujumbura: Town,1430,2514,0,1967,5629,291,0,11831,1433,2435,0,2036,4726,201,0,10831
2013,Burundi,Burundi : Dispersed in the country / territory,5870,7586,0,6190,17781,1444,0,38871,5645,7375,0,6759,20552,3044,0,43375
2013,Benin,Benin : Dispersed in the country / territory,8,20,0,11,87,8,0,134,23,20,0,13,108,4,0,168
2013,Burkina Faso,Mentao : Point,1173,1437,0,592,2709,284,0,6195,1198,1483,0,615,2123,293,0,5712
2013,Burkina Faso,Goudebo : Point,885,1191,0,492,2031,177,0,4776,897,1183,0,445,1768,218,0,4511
2013,Burkina Faso,Dori,0,2,0,0,0,0,0,2,0,1,0,0,0,0,0,1
2013,Burkina Faso,Sag-Nioniogo : Point,161,223,0,96,420,42,0,942,153,253,0,130,361,41,0,938
2013,Burkina Faso,Ouahigouya : Department,7,11,0,2,16,2,0,38,6,0,0,1,6,3,0,16
2013,Burkina Faso,Ouagadougou : Point,79,104,0,80,343,6,0,612,53,96,0,86,738,12,0,985
2013,Burkina Faso,Burkina Faso : Dispersed in the country / territory,322,610,0,244,871,55,0,2102,276,674,0,316,707,67,0,2040
2013,Burkina Faso,Bobo-Dioulasso : Department,90,168,0,112,264,24,0,658,86,114,0,79,200,18,0,497
2013,Bangladesh,Nayapara : Point,1300,2260,0,1711,4283,184,0,9738,1335,2283,0,1649,3083,200,0,8550
2013,Bangladesh,Kutupalong : Point,914,1490,0,1119,2795,134,0,6452,992,1505,0,1111,2421,145,0,6174
2013,Bangladesh,Barisal,0,0,0,0,0,0,0,0,0,0,0,0,1,0,0,1
2013,Bangladesh,Rangamati : Zila - District,0,1,0,2,0,0,0,3,0,2,0,0,5,1,0,8
2013,Bangladesh,Gazipur : Zila - District,0,0,0,0,0,0,0,0,0,0,0,0,5,0,0,5
2013,Bangladesh,Dhaka : Zila - District,2,5,0,3,11,0,0,21,1,2,0,1,21,1,0,26
2013,Bangladesh,Cox's Bazar : Zila - District,1,6,0,7,18,0,0,32,0,6,0,5,38,6,0,55
2013,Bangladesh,Chittagong : Zila - District,0,0,0,0,2,0,0,2,0,0,0,0,2,0,0,2
2013,Bangladesh,Barguna : Zila - District,0,0,0,0,0,0,0,0,0,0,0,0,1,0,0,1
2013,Bangladesh,Bandarban : Zila - District,2,9,0,6,20,1,0,38,0,6,0,10,27,3,0,46
2013,Bulgaria,Bulgaria : Dispersed in the country / territory,254,388,0,50,888,36,0,1616,228,585,0,97,2008,26,0,2944
2013,Bahrain,Bahrain : Dispersed in the country / territory,23,18,0,16,103,5,0,165,21,16,0,12,120,12,0,181
2013,Bahamas,Nassau,0,0,0,0,0,0,0,0,0,0,0,0,8,0,0,8
2013,Bahamas,Carmichael Detention Center,0,0,0,0,0,0,0,0,0,0,0,0,8,0,0,8
2013,Bahamas,Bahamas : Dispersed in the country / territory,0,0,0,0,4,0,0,4,0,0,0,0,6,1,0,7
2013,Bosnia and Herzegovina,Republika Srpska : Entity,0,0,0,0,1,0,0,1,0,0,0,1,3,0,0,4
2013,Bosnia and Herzegovina,Federation of Bosnia and Herzegovina : Entity,9,19,0,18,65,6,0,117,5,23,0,17,85,4,0,134
2013,Bosnia and Herzegovina,Brcko : District,1,1,0,1,12,2,0,17,0,1,0,2,11,2,0,16
2013,Bosnia and Herzegovina,Bosnia and Herzegovina : Dispersed in the country / territory,0,123,0,258,2372,581,0,3334,1,155,0,210,2360,619,0,3345
2013,Belarus,Horad Minsk : City,9,27,0,30,69,8,0,143,19,27,0,24,173,4,0,247
2013,Belarus,Vitebsk : Oblast - Region,1,3,0,3,14,2,0,23,1,0,0,4,33,1,0,39
2013,Belarus,Mogilev : Oblast - Region,0,0,0,2,14,0,0,16,0,0,0,0,22,0,0,22
2013,Belarus,Minsk : Oblast - Region,1,3,0,3,30,2,0,39,3,3,0,5,31,1,0,43
2013,Belarus,Grodno : Oblast - Region,0,0,0,0,4,0,0,4,0,0,0,0,9,0,0,9
2013,Belarus,Gomel : Oblast - Region,3,3,0,5,20,3,0,34,2,2,0,2,42,3,0,51
2013,Belarus,Brest : Oblast - Region,0,2,0,0,4,0,0,6,0,0,0,0,13,1,0,14
2013,Belize,Belize : Dispersed in the country / territory,5,5,0,7,20,1,0,38,5,2,0,1,30,8,0,46
2013,Bolivia (Plurinational State of),Yapacani : Point,1,1,0,1,7,0,0,10,0,1,0,0,6,0,0,7
2013,Bolivia (Plurinational State of),Tarija : Department,0,0,0,0,1,0,0,1,0,0,0,0,1,0,0,1
2013,Bolivia (Plurinational State of),Sucre : Point,0,0,0,3,81,2,0,86,0,0,0,0,121,2,0,123
2013,Bolivia (Plurinational State of),Santa Cruz : Department,5,0,0,6,18,1,0,30,3,1,0,8,33,1,0,46
2013,Bolivia (Plurinational State of),Palos Blanco : Point,0,1,0,0,2,0,0,3,0,0,0,0,3,0,0,3
2013,Bolivia (Plurinational State of),La Paz : Department,0,7,0,27,113,4,0,151,3,14,0,27,157,7,0,208
2013,Bolivia (Plurinational State of),Guayaramerin,0,0,0,0,0,0,0,0,0,0,0,0,0,1,0,1
2013,Bolivia (Plurinational State of),El Beni : Department,0,0,0,3,0,0,0,3,0,1,0,1,1,0,0,3
2013,Bolivia (Plurinational State of),Cochabamba : Department,1,7,0,8,15,1,0,32,5,5,0,8,28,0,0,46
2013,Brazil,Goias : Estado - State,0,0,0,0,7,0,0,7,2,0,0,0,331,1,0,334
2013,Brazil,Goias,0,0,0,0,0,0,0,0,0,0,0,0,1,0,0,1
2013,Brazil,Bahia : Estado - State,0,0,0,0,1,0,0,1,0,0,0,0,4,0,0,4
2013,Brazil,Acre : Estado - State,6,13,0,16,1365,2,0,1402,20,26,0,38,6630,13,0,6727
2013,Brazil,Sao Paulo : Estado - State,28,65,0,55,650,35,0,833,41,50,0,59,2266,40,0,2456
2013,Brazil,Santa Catarina : Estado - State,2,0,0,1,19,0,0,22,1,3,0,1,247,1,0,253
2013,Brazil,Roraima : Estado - State,0,1,0,1,5,0,0,7,1,2,0,0,113,0,0,116
2013,Brazil,Rio Grande do Sul : Estado - State,13,27,0,25,159,6,0,230,21,19,0,29,603,6,0,678
2013,Brazil,Rio Grande do Norte : Estado - State,4,6,0,2,24,0,0,36,4,0,0,1,29,0,0,34
2013,Brazil,Rio de Janeiro : Estado - State,13,29,0,28,542,16,0,628,15,34,0,37,1160,25,0,1271
2013,Brazil,Pernambuco : Estado - State,1,1,0,1,2,0,0,5,0,0,0,0,4,0,0,4
2013,Brazil,ParÃƒÂ¡ : Estado - State,0,0,0,0,0,0,0,0,0,0,0,0,4,1,0,5
2013,Brazil,ParanÃƒÂ¡ : Estado - State,4,7,0,4,46,5,0,66,11,6,0,6,947,2,0,972
2013,Brazil,Minas Gerais : Estado - State,0,0,0,1,3,0,0,4,0,1,0,0,19,0,0,20
2013,Brazil,Mato Grosso do Sul : Estado - State,0,0,0,1,8,0,0,9,0,0,0,1,42,0,0,43
2013,Brazil,Mato Grosso : Estado - State,0,0,0,0,4,0,0,4,0,0,0,0,10,0,0,10
2013,Brazil,Espirito Santo : Estado - State,0,0,0,0,3,0,0,3,0,1,0,0,5,0,0,6
2013,Brazil,Distrito Federal : Distrito Federal - Federal district,2,2,0,3,38,3,0,48,4,8,0,5,680,3,0,700
2013,Brazil,CearÃƒÂ¡ : Estado - State,0,0,0,0,1,0,0,1,0,0,0,0,7,0,0,7
2013,Brazil,Brazil : Dispersed in the country / territory,4,11,0,24,68,2,0,109,1,10,0,66,113,10,0,200
2013,Brazil,Amazonas : Estado - State,4,8,0,15,832,3,0,862,14,18,0,27,3964,9,0,4032
2013,Barbados,Barbados : Dispersed in the country / territory,0,0,0,0,0,0,0,0,0,0,0,0,1,0,0,1
2013,Botswana,Dukwi : Point,165,205,0,175,500,18,0,1063,197,211,0,125,1362,37,0,1932
2013,Canada,Canada : Dispersed in the country / territory,1051,1818,0,1342,10426,845,0,15482,1031,1785,0,1511,13297,550,0,18174
2013,Switzerland,Switzerland : Dispersed in the country / territory,1794,2258,0,1659,10882,674,0,17267,1933,2465,0,2083,18516,437,0,25434
2013,China,Zhejiang : Province,0,0,0,0,2,0,0,2,0,0,0,0,7,0,0,7
2013,China,Tianjin : Municipality,1,1,0,0,3,0,0,5,1,3,0,0,10,0,0,14
2013,China,Shanxi : Province,0,0,0,0,0,0,0,0,0,0,0,0,1,0,0,1
2013,China,Shanghai : Municipality,0,0,0,0,0,0,0,0,0,0,0,0,2,0,0,2
2013,China,Shan Dong : Province,0,0,0,0,0,0,0,0,0,0,0,0,2,0,0,2
2013,China,Shaanxi : Province,0,0,0,0,1,0,0,1,1,0,0,0,2,0,0,3
2013,China,Neimenggu : Province,0,0,0,0,1,0,0,1,0,0,0,0,0,0,0,0
2013,China,Liaoning : Province,0,0,0,0,0,0,0,0,0,0,0,0,1,0,0,1
2013,China,Jiangsu : Province,0,1,0,0,2,0,0,3,1,0,0,0,4,0,0,5
2013,China,Ji Lin : Province,0,0,0,0,3,0,0,3,1,0,0,0,3,0,0,4
2013,China,Hunan : Province,0,0,0,0,1,0,0,1,0,1,0,0,1,0,0,2
2013,China,Hubei : Province,1,2,0,1,22,0,0,26,0,1,0,0,20,0,0,21
2013,China,Henan : Province,0,0,0,0,0,0,0,0,0,0,0,0,1,0,0,1
2013,China,Hebei : Province,1,1,0,1,12,4,0,19,1,4,0,3,28,3,0,39
2013,China,Hainan : Province,0,0,0,0,0,0,0,0,0,0,0,0,1,0,0,1
2013,China,Guangdong : Province,8,7,0,10,104,0,0,129,7,16,0,9,148,1,0,181
2013,China,Fujian : Province,0,0,0,0,1,0,0,1,0,0,0,0,1,0,0,1
2013,China,Beijing : Municipality,0,3,0,2,7,0,0,12,3,2,0,0,25,0,0,30
2013,China,China : Dispersed in the country / territory,0,0,0,0,4,0,0,4,0,0,0,0,10,0,0,10
2013,Côte d'Ivoire,Tabou : Departement,105,150,0,116,325,11,0,707,108,125,0,94,268,6,0,601
2013,Côte d'Ivoire,Guiglo : Departement,33,38,0,44,187,15,0,317,41,78,0,46,106,13,0,284
2013,Côte d'Ivoire,CÃƒÂ´te d'Ivoire : Dispersed in the country / territory,2218,2445,0,1049,4272,377,0,10361,2158,2664,0,1162,2776,233,0,8993
2013,Côte d'Ivoire,Abidjan : Departement,58,146,0,89,501,19,0,813,64,133,0,119,644,37,0,997
2013,Cameroon,Zamboi,17,16,0,9,32,4,0,78,24,24,0,4,18,3,0,73
2013,Cameroon,Yokosire : Point,86,119,0,93,215,17,0,530,79,135,0,96,125,29,0,464
2013,Cameroon,Yarmbang : Point,54,108,0,55,140,14,0,371,56,92,0,61,70,16,0,295
2013,Cameroon,Yaounde : Point,623,943,0,598,2388,59,0,4611,622,875,0,574,3851,80,0,6002
2013,Cameroon,Yamba : Point,71,156,0,94,178,16,0,515,73,138,0,94,112,10,0,427
2013,Cameroon,Woumbou : Point,61,92,0,55,155,7,0,370,57,88,0,64,107,11,0,327
2013,Cameroon,Toktoyo : Point,119,185,0,118,326,24,0,772,134,209,0,109,201,32,0,685
2013,Cameroon,Timangolo : Point,50,73,0,50,114,14,0,301,46,65,0,51,76,13,0,251
2013,Cameroon,Tapare : Point,12,14,0,15,24,2,0,67,12,25,0,19,14,4,0,74
2013,Cameroon,Sodepa,25,22,0,16,41,4,0,108,18,31,0,7,33,3,0,92
2013,Cameroon,Sodenou,42,62,0,41,91,4,0,240,42,61,0,44,56,6,0,209
2013,Cameroon,Soa,3,2,0,2,6,0,0,13,2,4,0,1,23,0,0,30
2013,Cameroon,Simi,15,36,0,13,38,5,0,107,19,31,0,15,19,4,0,88
2013,Cameroon,Sangmelima,0,0,0,0,0,0,0,0,0,0,0,0,1,0,0,1
2013,Cameroon,Sandji II,0,0,0,0,1,0,0,1,0,0,0,0,0,0,0,0
2013,Cameroon,Sandji,38,49,0,34,89,4,0,214,33,46,0,38,61,9,0,187
2013,Cameroon,Sandaye : Point,11,27,0,14,29,2,0,83,21,18,0,15,30,4,0,88
2013,Cameroon,Samba : Point,35,68,0,49,106,9,0,267,35,59,0,51,55,14,0,214
2013,Cameroon,Ouro-Adde : Point,84,138,0,95,184,19,0,520,104,163,0,93,105,11,0,476
2013,Cameroon,Obala,0,5,0,1,4,0,0,10,3,1,0,2,7,0,0,13
2013,Cameroon,Nyambaka,5,19,0,10,27,3,0,64,13,31,0,17,8,8,0,77
2013,Cameroon,Nyabi : Point,155,261,0,203,523,33,0,1175,173,197,0,172,315,34,0,891
2013,Cameroon,Nkolafamba,3,6,0,2,8,1,0,20,5,8,0,1,8,0,0,22
2013,Cameroon,Ngunbela : Point,1,3,0,0,3,1,0,8,1,3,0,3,0,1,0,8
2013,Cameroon,Nguindi : Point,31,45,0,35,78,3,0,192,25,34,0,25,47,9,0,140
2013,Cameroon,Ngazi : Point,16,18,0,13,27,3,0,77,14,19,0,7,24,3,0,67
2013,Cameroon,Ngassiri,2,1,0,2,2,0,0,7,0,2,0,1,1,0,0,4
2013,Cameroon,Ngaoundere,0,0,0,0,0,0,0,0,0,0,0,1,0,0,0,1
2013,Cameroon,Ngaoui : Point,494,918,0,616,1241,105,0,3374,515,921,0,587,667,113,0,2803
2013,Cameroon,Ndokayo : Point,233,389,0,263,576,50,0,1511,219,377,0,261,431,60,0,1348
2013,Cameroon,Nandoungue : Point,59,101,0,70,126,18,0,374,56,93,0,63,67,15,0,294
2013,Cameroon,Nabemo : Point,48,69,0,55,94,5,0,271,60,84,0,49,54,12,0,259
2013,Cameroon,Monatele,0,2,0,1,0,0,0,3,0,0,0,1,0,0,0,1
2013,Cameroon,Mokolo,0,0,0,0,2,1,0,3,0,2,0,0,0,1,0,3
2013,Cameroon,Moinam,18,18,0,12,34,1,0,83,14,25,0,1,26,3,0,69
2013,Cameroon,Mobe : Point,22,45,0,26,67,3,0,163,30,49,0,18,41,6,0,144
2013,Cameroon,Minawao,288,204,0,128,403,78,0,1101,285,207,0,132,372,86,0,1082
2013,Cameroon,Mimbang : Point,0,1,0,0,6,0,0,7,0,3,0,2,5,1,0,11
2013,Cameroon,Mikila : Point,33,61,0,49,84,7,0,234,40,58,0,38,58,7,0,201
2013,Cameroon,Mfou,9,6,0,4,15,0,0,34,7,6,0,3,22,0,0,38
2013,Cameroon,Mengong,0,0,0,0,0,0,0,0,0,0,0,0,1,0,0,1
2013,Cameroon,Mengang,0,0,0,0,0,0,0,0,0,0,0,0,1,0,0,1
2013,Cameroon,Meiganga : Point,193,305,0,238,469,21,0,1226,219,375,0,241,291,42,0,1168
2013,Cameroon,Meidougou : Point,263,457,0,327,668,53,0,1768,285,463,0,319,402,64,0,1533
2013,Cameroon,Mboumama : Point,90,109,0,97,207,11,0,514,86,102,0,86,150,23,0,447
2013,Cameroon,Mboula : Point,25,52,0,34,76,3,0,190,30,70,0,27,37,7,0,171
2013,Cameroon,Mborguene : Point,36,56,0,34,88,3,0,217,32,66,0,54,68,4,0,224
2013,Cameroon,Mbonga : Point,30,43,0,22,67,3,0,165,27,47,0,27,45,10,0,156
2013,Cameroon,Mbondo : Point,34,75,0,51,98,11,0,269,47,73,0,34,91,9,0,254
2013,Cameroon,Mbomba,4,17,0,6,16,1,0,44,5,14,0,9,9,5,0,42
2013,Cameroon,Mbile : Point,29,50,0,33,87,5,0,204,21,33,0,30,53,10,0,147
2013,Cameroon,Mbewe : Point,18,26,0,16,34,9,0,103,18,15,0,9,21,4,0,67
2013,Cameroon,Mbarang : Point,59,81,0,60,113,13,0,326,68,85,0,43,78,14,0,288
2013,Cameroon,Mbankomo,0,0,0,0,0,0,0,0,0,0,0,0,1,0,0,1
2013,Cameroon,Mbalmayo,0,1,0,1,4,0,0,6,0,3,0,2,4,0,0,9
2013,Cameroon,Maroua,1,1,0,1,9,1,0,13,0,0,0,3,4,0,0,7
2013,Cameroon,Mandjou : Point,112,232,0,178,371,31,0,924,104,260,0,194,179,43,0,780
2013,Cameroon,Lokoti : Point,60,87,0,41,127,12,0,327,47,91,0,62,98,13,0,311
2013,Cameroon,Limbe,0,0,0,0,1,0,0,1,0,0,0,1,2,0,0,3
2013,Cameroon,Kribi,0,0,0,0,0,0,0,0,0,0,0,0,4,0,0,4
2013,Cameroon,Kousseri,0,0,0,0,0,0,0,0,0,0,0,0,1,0,0,1
2013,Cameroon,Kounde,0,1,0,0,1,1,0,3,0,1,0,1,1,1,0,4
2013,Cameroon,Kouba : Point,29,65,0,31,80,6,0,211,25,54,0,25,45,14,0,163
2013,Cameroon,Kombo Laka : Point,64,111,0,77,160,14,0,426,79,115,0,66,122,17,0,399
2013,Cameroon,Kombo,0,0,0,0,0,0,0,0,0,0,0,0,1,0,0,1
2013,Cameroon,Kole : Point,27,41,0,49,84,10,0,211,31,59,0,28,37,4,0,159
2013,Cameroon,Kette : Point,105,145,0,126,311,17,0,704,110,168,0,113,195,36,0,622
2013,Cameroon,Kenzou : Point,188,317,0,243,557,34,0,1339,203,312,0,209,325,47,0,1096
2013,Cameroon,Kambele,7,19,0,11,23,4,0,64,11,13,0,11,22,3,0,60
2013,Cameroon,Goundjel : Point,0,6,0,2,11,0,0,19,0,2,0,2,13,0,0,17
2013,Cameroon,Goro,30,56,0,40,69,5,0,200,33,49,0,32,58,13,0,185
2013,Cameroon,Gomana,17,40,0,24,42,2,0,125,22,45,0,20,20,3,0,110
2013,Cameroon,Gbiti : Point,588,795,0,594,1550,81,0,3608,573,814,0,573,986,150,0,3096
2013,Cameroon,Gbakim : Point,27,25,0,34,64,1,0,151,23,26,0,35,48,4,0,136
2013,Cameroon,Gbabio,0,0,0,1,2,0,0,3,2,0,0,0,4,0,0,6
2013,Cameroon,Garoua,0,4,0,3,7,0,0,14,1,2,0,1,21,2,0,27
2013,Cameroon,Gargapela : Point,49,109,0,71,122,15,0,366,73,93,0,62,51,11,0,290
2013,Cameroon,Garga Sarali : Point,51,66,0,49,139,10,0,315,44,87,0,61,134,15,0,341
2013,Cameroon,Garga Libona : Point,107,153,0,94,260,20,0,634,108,174,0,108,146,21,0,557
2013,Cameroon,Gandinang : Point,0,0,0,0,1,0,0,1,0,0,0,0,1,0,0,1
2013,Cameroon,Gado Badzere : Point,54,71,0,55,106,16,0,302,51,75,0,66,66,13,0,271
2013,Cameroon,Fada : Point,1,0,0,0,2,0,0,3,0,2,0,0,1,0,0,3
2013,Cameroon,Edea,0,0,0,0,1,0,0,1,0,0,0,0,0,0,0,0
2013,Cameroon,Ebolowa,0,2,0,1,1,0,0,4,0,0,0,0,3,0,0,3
2013,Cameroon,Dschang,0,0,0,1,1,0,0,2,0,0,0,2,1,0,0,3
2013,Cameroon,Douala : Point,333,522,0,784,581,5,0,2225,310,507,0,1868,887,13,0,3585
2013,Cameroon,Djohong : Point,4,5,0,1,7,0,0,17,2,3,0,1,3,1,0,10
2013,Cameroon,Djaoro Mone,57,93,0,51,105,6,0,312,40,96,0,32,54,6,0,228
2013,Cameroon,Djalingo : Point,26,26,0,28,51,9,0,140,19,34,0,24,31,3,0,111
2013,Cameroon,Dir : Point,1,7,0,1,9,0,0,18,5,6,0,3,10,2,0,26
2013,Cameroon,Digou Adamou : Point,0,1,0,0,2,1,0,4,0,0,0,3,2,1,0,6
2013,Cameroon,Dang Patou : Point,48,62,0,50,97,7,0,264,39,64,0,37,65,8,0,213
2013,Cameroon,Damissa,31,44,0,34,67,3,0,179,21,43,0,33,53,4,0,154
2013,Cameroon,Colomine,24,41,0,34,52,6,0,157,20,53,0,26,40,3,0,142
2013,Cameroon,Bouli : Point,58,59,0,55,106,12,0,290,42,64,0,48,77,4,0,235
2013,Cameroon,Boulembe : Point,50,105,0,87,147,12,0,401,54,108,0,68,108,13,0,351
2013,Cameroon,Boubara : Point,46,75,0,61,158,10,0,350,42,72,0,63,102,18,0,297
2013,Cameroon,Borgop : Point,34,73,0,34,67,10,0,218,38,57,0,33,43,4,0,175
2013,Cameroon,Bombe Pana,68,90,0,54,133,5,0,350,59,100,0,61,96,11,0,327
2013,Cameroon,Boforo,41,72,0,46,101,6,0,266,41,84,0,46,47,6,0,224
2013,Cameroon,Bigoro,39,41,0,43,73,6,0,202,34,63,0,43,53,8,0,201
2013,Cameroon,Betare Oya : Point,6,4,0,11,36,0,0,57,4,6,0,18,51,0,0,79
2013,Cameroon,Belabo,0,1,0,0,1,0,0,2,1,1,0,2,1,0,0,5
2013,Cameroon,Beke Chantier,7,8,0,7,21,0,0,43,6,19,0,4,13,2,0,44
2013,Cameroon,Bedobo : Point,60,80,0,66,155,8,0,369,54,72,0,47,102,6,0,281
2013,Cameroon,Bazzama : Point,36,63,0,48,115,7,0,269,31,41,0,47,71,9,0,199
2013,Cameroon,Batouri,0,0,0,1,1,0,0,2,1,1,0,0,1,0,0,3
2013,Cameroon,Baham,0,0,0,0,4,0,0,4,0,0,0,0,1,0,0,1
2013,Cameroon,Bagodo : Point,12,20,0,22,38,4,0,96,11,33,0,27,36,7,0,114
2013,Cameroon,Bafouck : Point,51,94,0,56,126,5,0,332,54,59,0,44,109,13,0,279
2013,Cameroon,Bafia,0,0,0,0,0,0,0,0,0,0,0,0,1,0,0,1
2013,Cameroon,Babongo : Point,0,1,0,0,3,0,0,4,0,1,0,3,1,0,0,5
2013,Cameroon,Awae,0,0,0,0,0,0,0,0,0,0,0,0,1,0,0,1
2013,Cameroon,Ambam,0,0,0,0,0,0,0,0,0,0,0,0,1,0,0,1
2013,Cameroon,Alhamdou,48,58,0,32,82,2,0,222,47,57,0,37,55,7,0,203
2013,Cameroon,Adinkol : Point,28,51,0,32,69,5,0,185,33,70,0,26,38,9,0,176
2013,Cameroon,Zembe Borongo : Point,135,220,0,186,346,31,0,918,149,268,0,146,194,41,0,798
2013,Cameroon,Tongo Gandima : Point,98,186,0,118,287,22,0,711,109,207,0,127,182,52,0,677
2013,Cameroon,Ndanga Gandima : Point,47,72,0,47,126,11,0,303,49,76,0,68,76,16,0,285
2013,Cameroon,Guiwa Yangamo : Point,113,160,0,131,384,12,0,800,123,181,0,153,531,19,0,1007
2013,Cameroon,Garoua-Boulai : Point,335,610,0,473,911,81,0,2410,328,628,0,460,491,87,0,1994
2013,Cameroon,Dakere Babongo : Point,53,58,0,39,99,5,0,254,48,63,0,35,57,8,0,211
2013,Cameroon,Cameroon : Dispersed in the country / territory,1748,3836,0,2814,7614,455,0,16467,1771,4018,0,2749,6267,654,0,15459
2013,Cameroon,Batoua Godole : Point,246,384,0,246,512,50,0,1438,205,385,0,269,287,51,0,1197
2013,Dem. Rep. of the Congo,Mole,649,522,0,334,1497,66,0,3068,664,476,0,560,2245,34,0,3979
2013,Dem. Rep. of the Congo,Mboti,37,31,0,22,98,7,0,195,35,31,0,36,149,12,0,263
2013,Dem. Rep. of the Congo,Inke,950,827,0,339,1878,96,0,4090,950,835,0,695,2190,68,0,4738
2013,Dem. Rep. of the Congo,Boyabu,785,803,0,338,1425,101,0,3452,737,722,0,368,1106,66,0,2999
2013,Dem. Rep. of the Congo,,1315,1262,0,457,1995,112,0,5141,1212,1129,0,402,1159,75,0,3977
2013,Dem. Rep. of the Congo,Walungu : Territoire,1,7,0,4,27,0,0,39,7,16,0,5,51,0,0,79
2013,Dem. Rep. of the Congo,Walungu : Point,139,138,0,49,222,12,0,560,129,125,0,43,135,8,0,440
2013,Dem. Rep. of the Congo,Walikale : Point,40454,38805,0,14058,61358,3425,0,158100,37287,34718,0,12373,35641,2316,0,122335
2013,Dem. Rep. of the Congo,Uvira : Point,4875,4889,0,1930,7789,463,0,19946,4533,4419,0,1739,5243,339,0,16273
2013,Dem. Rep. of the Congo,Tshopo : Territoire - District,5026,4821,0,1746,7623,427,0,19643,4632,4313,0,1537,4427,288,0,15197
2013,Dem. Rep. of the Congo,Tshabobo : Point,65,102,0,28,137,5,0,337,37,89,0,31,149,11,0,317
2013,Dem. Rep. of the Congo,Sud Ubangi,941,901,0,984,2141,334,0,5301,888,828,0,1206,1718,211,0,4851
2013,Dem. Rep. of the Congo,Shabunda : Point,12176,11760,0,4326,18914,1031,0,48207,11216,10593,0,3857,11250,701,0,37617
2013,Dem. Rep. of the Congo,Rutshuru : Point,15471,14840,0,5376,23465,1313,0,60465,14260,13277,0,4732,13627,887,0,46783
2013,Dem. Rep. of the Congo,Pweto : Territoire,22945,22010,0,7974,34802,1948,0,89679,21149,19691,0,7018,20210,1314,0,69382
2013,Dem. Rep. of the Congo,Punia : Territoire,9167,8793,0,3185,13903,778,0,35826,8449,7867,0,2804,8074,525,0,27719
2013,Dem. Rep. of the Congo,Pangi : Territoire,25066,24045,0,8711,38019,2128,0,97969,23104,21512,0,7667,22078,1435,0,75796
2013,Dem. Rep. of the Congo,Nord-Kivu : Province,2431,5657,0,3506,7879,330,0,19803,2978,4174,0,3339,5863,158,0,16512
2013,Dem. Rep. of the Congo,Nord Ubangi,1363,1896,0,981,3291,265,0,7796,1416,1917,0,929,1787,199,0,6248
2013,Dem. Rep. of the Congo,Mwenga : Territoire,14956,14346,0,5197,22684,1269,0,58452,13785,12835,0,4575,13174,856,0,45225
2013,Dem. Rep. of the Congo,Mwenga : Point,89,144,0,102,368,8,0,711,89,134,0,83,218,10,0,534
2013,Dem. Rep. of the Congo,Mwene Ditu : Point,34,49,0,33,63,8,0,187,33,36,0,36,66,11,0,182
2013,Dem. Rep. of the Congo,Mitwaba : Territoire,5091,4883,0,1769,7721,432,0,19896,4692,4369,0,1557,4484,291,0,15393
2013,Dem. Rep. of the Congo,Masisi : Point,50788,48718,0,17649,77032,4311,0,198498,46812,43587,0,15535,44732,2908,0,153574
2013,Dem. Rep. of the Congo,Manono : Territoire,6667,6396,0,2317,10113,566,0,26059,6145,5722,0,2039,5873,382,0,20161
2013,Dem. Rep. of the Congo,Malemba Nkulu : Territoire,6973,6689,0,2423,10576,592,0,27253,6427,5984,0,2133,6142,399,0,21085
2013,Dem. Rep. of the Congo,Lusuku : Point,19,28,0,12,53,3,0,115,31,33,0,10,57,4,0,135
2013,Dem. Rep. of the Congo,Lubutu: Territoire,791,758,0,275,1199,67,0,3090,729,678,0,242,696,45,0,2390
2013,Dem. Rep. of the Congo,Lubumbashi : Point,69,119,0,64,236,18,0,506,67,136,0,49,282,14,0,548
2013,Dem. Rep. of the Congo,Lubudi : Territoire,1122,1076,0,390,1701,95,0,4384,1034,963,0,343,988,64,0,3392
2013,Dem. Rep. of the Congo,Lubero : Point,12798,12277,0,4447,19314,1083,0,49919,11976,10974,0,3915,11203,733,0,38801
2013,Dem. Rep. of the Congo,Likasi : City,273,262,0,95,415,23,0,1068,252,235,0,84,240,16,0,827
2013,Dem. Rep. of the Congo,Kolwezi,1,2,0,0,2,0,0,5,0,0,0,0,1,0,0,1
2013,Dem. Rep. of the Congo,Kipushi,0,0,0,0,0,0,0,0,0,0,0,0,0,2,0,2
2013,Dem. Rep. of the Congo,Kinshasa : Province,428,899,0,651,2644,887,0,5509,353,776,0,703,2444,596,0,4872
2013,Dem. Rep. of the Congo,Kimaza : Point,37,51,0,23,96,1,0,208,42,49,0,32,191,16,0,330
2013,Dem. Rep. of the Congo,Katshia : Point,33,48,0,23,66,5,0,175,32,44,0,27,61,8,0,172
2013,Dem. Rep. of the Congo,Katanga : Province,1246,1370,0,868,3927,195,0,7606,1632,1851,0,1070,3024,237,0,7814
2013,Dem. Rep. of the Congo,Kasongo: Territoire,5802,5565,0,2016,8800,492,0,22675,5348,4979,0,1776,5110,332,0,17545
2013,Dem. Rep. of the Congo,Kasenga: Territoire,1636,1569,0,569,2481,139,0,6394,1508,1404,0,500,1441,94,0,4947
2013,Dem. Rep. of the Congo,Kambove : Territoire,3318,3182,0,1153,5032,282,0,12967,3058,2847,0,1015,2921,190,0,10031
2013,Dem. Rep. of the Congo,Kalemie : Point,8682,8323,0,3017,13172,737,0,33931,8002,7451,0,2655,7647,497,0,26252
2013,Dem. Rep. of the Congo,Kalehe : Point,35188,33766,0,12282,53578,2986,0,137800,32457,30276,0,10849,31316,2041,0,106939
2013,Dem. Rep. of the Congo,Kailo: Territoire,1371,1315,0,476,2080,116,0,5358,1264,1177,0,419,1208,79,0,4147
2013,Dem. Rep. of the Congo,Kahemba : Point,13,22,0,29,31,4,0,99,14,42,0,33,46,7,0,142
2013,Dem. Rep. of the Congo,Kabare : Point,7356,7070,0,2553,11195,626,0,28800,6781,6326,0,2265,6522,423,0,22317
2013,Dem. Rep. of the Congo,Kabambare : Territoire,144,138,0,50,218,12,0,562,132,123,0,44,126,8,0,433
2013,Dem. Rep. of the Congo,Ituri : Territoire - District,46364,17948,0,18264,69239,4997,0,156812,41980,40360,0,17486,41799,4006,0,145631
2013,Dem. Rep. of the Congo,Isiro : Point,3,5,0,5,12,0,0,25,4,4,0,2,11,1,0,22
2013,Dem. Rep. of the Congo,Ingbokolo : Point,145,108,0,104,356,15,0,728,125,100,0,105,289,20,0,639
2013,Dem. Rep. of the Congo,Idjwi: Territoire,961,922,0,334,1457,82,0,3756,886,825,0,292,846,55,0,2904
2013,Dem. Rep. of the Congo,Haut-Uele : Territoire - District,13887,20791,0,12343,43781,2282,0,93084,27782,26077,0,11224,26682,1539,0,93304
2013,Dem. Rep. of the Congo,Goma : Point,22552,21706,0,17787,24433,1917,0,88395,20796,19428,0,7003,20013,1297,0,68537
2013,Dem. Rep. of the Congo,Fizi : Point,8318,8376,0,3137,13097,777,0,33705,7673,7542,0,2776,7917,534,0,26442
2013,Dem. Rep. of the Congo,Equateur : Province,8721,10597,0,4988,15858,1299,0,41463,8531,10354,0,4937,11806,795,0,36423
2013,Dem. Rep. of the Congo,Dungu : Point,2,0,0,2,2,0,0,6,1,0,0,0,5,0,0,6
2013,Dem. Rep. of the Congo,Doruma : Point,8,0,0,5,8,3,0,24,2,0,0,4,7,2,0,15
2013,Dem. Rep. of the Congo,Dilolo : Point,23,34,0,15,38,2,0,112,18,30,0,4,43,3,0,98
2013,Dem. Rep. of the Congo,Buta : Point,11,44,0,48,134,58,0,295,53,82,0,70,254,96,0,555
2013,Dem. Rep. of the Congo,Bukavu : Point,427,411,0,148,697,37,0,1720,399,376,0,151,434,26,0,1386
2013,Dem. Rep. of the Congo,Bondo : Point,573,631,0,431,1586,90,0,3311,602,701,0,438,982,82,0,2805
2013,Dem. Rep. of the Congo,Beni : Point,20108,19289,0,6988,30799,1707,0,78891,18534,17257,0,6151,17411,1151,0,60504
2013,Dem. Rep. of the Congo,Bas-Uele : Territoire - District,4519,4335,0,1572,6854,384,0,17664,4165,3878,0,1382,3980,259,0,13664
2013,Dem. Rep. of the Congo,Bas-Congo : Province,1880,5252,0,3424,11912,2082,0,24550,1947,5266,0,3857,9275,1606,0,21951
2013,Dem. Rep. of the Congo,Aru-Wani,163,282,0,140,364,42,0,991,180,304,0,149,46,0,0,679
2013,Dem. Rep. of the Congo,Aru-Offa,31,37,0,10,56,12,0,146,24,38,0,20,6,1,0,89
2013,Dem. Rep. of the Congo,Aru-Loni I,81,114,0,64,165,12,0,436,93,114,0,73,43,3,0,326
2013,Dem. Rep. of the Congo,Aru : Point,5,10,0,2,12,5,0,34,2,8,0,4,11,6,0,31
2013,Dem. Rep. of the Congo,Ariwara : Point,14,10,0,13,29,7,0,73,10,11,0,12,16,13,0,62
2013,Dem. Rep. of the Congo,Aba : Point,0,0,0,0,2,0,0,2,0,0,0,0,3,0,0,3
2013,Congo,Tchitondi,0,0,0,0,0,0,0,0,0,0,0,0,0,1,0,1
2013,Congo,Tchiamba-Nza : Point,1,8,0,3,23,1,0,36,2,5,0,6,23,0,0,36
2013,Congo,Sangha : Departement,63,160,0,132,239,11,0,605,60,168,0,130,420,5,0,783
2013,Congo,Pool : Departement,34,86,0,65,128,2,0,315,41,93,0,50,262,2,0,448
2013,Congo,Pointe Noire : Point,25,37,0,22,107,4,0,195,22,31,0,24,267,8,0,352
2013,Congo,Oyo : Point,13,41,0,32,53,3,0,142,10,37,0,29,133,0,0,209
2013,Congo,Ouesso,0,0,0,0,0,0,0,0,0,0,0,0,1,0,0,1
2013,Congo,Okoyo : District,0,3,0,2,2,0,0,7,1,1,0,0,8,0,0,10
2013,Congo,Niari : Departement,0,1,0,0,0,0,0,1,0,0,0,0,1,0,0,1
2013,Congo,Ngo : Point,18,61,0,38,42,1,0,160,18,64,0,21,171,1,0,275
2013,Congo,Malolo : Point,8,43,0,20,89,17,0,177,8,37,0,30,72,12,0,159
2013,Congo,Loukolela : Point,415,625,0,302,991,57,0,2390,405,645,0,280,1205,53,0,2588
2013,Congo,Kondi Mbaka : Point,10,18,0,22,73,7,0,130,7,43,0,28,107,12,0,197
2013,Congo,Komi : Point,1,7,0,5,26,4,0,43,6,5,0,10,31,8,0,60
2013,Congo,Impfondo : Point,710,2053,0,1148,3343,350,0,7604,742,1974,0,1191,3579,242,0,7728
2013,Congo,Brazzaville : Capital,298,756,0,634,1745,70,0,3503,305,781,0,616,2833,59,0,4594
2013,Congo,Betou : Point,1811,2738,0,1680,4430,352,0,11011,1684,2795,0,1689,4630,212,0,11010
2013,Colombia,Turbo,0,0,0,0,2,0,0,2,0,0,0,0,2,0,0,2
2013,Colombia,TuluÃƒÂ¡ : Point,0,0,0,0,0,0,0,0,0,0,0,0,1,0,0,1
2013,Colombia,PopayÃƒÂ¡n,0,1,0,0,3,0,0,4,1,0,0,0,1,0,0,2
2013,Colombia,Neiva,0,0,0,0,0,0,0,0,0,0,0,0,0,1,0,1
2013,Colombia,Maicao : Point,0,0,0,0,1,0,0,1,1,0,0,0,0,0,0,1
2013,Colombia,Duitama : Point,0,0,0,0,1,0,0,1,0,0,0,1,1,0,0,2
2013,Colombia,Cartagena : Point,0,0,0,0,1,1,0,2,0,0,0,0,9,0,0,9
2013,Colombia,Cali : Point,0,0,0,0,1,0,0,1,0,0,0,0,2,1,0,3
2013,Colombia,Buenaventura : Point,0,1,0,1,3,0,0,5,0,0,0,2,1,0,0,3
2013,Colombia,Barranquilla,0,0,0,0,0,1,0,1,0,0,0,0,0,0,0,0
2013,Colombia,Barcelona : Point,0,0,0,2,1,0,0,3,0,0,0,0,1,0,0,1
2013,Colombia,Arauca,0,3,0,0,1,0,0,4,1,0,0,0,1,0,0,2
2013,Colombia,Tumaco : Municipality,0,1,0,0,1,0,0,2,0,1,0,0,0,0,0,1
2013,Colombia,San Andres Islas : Department,0,0,0,0,1,0,0,1,0,0,0,0,2,0,0,2
2013,Colombia,Pereira : Municipality,0,0,0,0,1,0,0,1,0,0,0,0,2,0,0,2
2013,Colombia,MedellÃƒÂ­n : Point,0,0,0,0,0,1,0,1,0,1,0,0,5,0,0,6
2013,Colombia,Leticia : Municipality,0,0,0,0,0,0,0,0,0,0,0,0,1,0,0,1
2013,Colombia,IbaguÃƒÂ© : Point,0,0,0,0,1,0,0,1,0,0,0,0,1,0,0,1
2013,Colombia,CÃƒÂºcuta : Point,1,0,0,0,5,0,0,6,1,0,0,2,8,1,0,12
2013,Colombia,Bucaramanga : Municipality,0,0,0,0,0,0,0,0,0,0,0,0,0,1,0,1
2013,Colombia,Bogota : Capital district,5,8,0,3,37,11,0,64,5,3,0,7,116,14,0,145
2013,Costa Rica,Costa Rica : Dispersed in the country / territory,243,581,0,597,4064,109,0,5594,357,747,0,802,5510,355,0,7771
2013,Cuba,Villa Clara : Provincia,0,0,0,0,1,0,0,1,0,0,0,0,33,0,0,33
2013,Cuba,Mayabeque : Provincia,0,0,0,0,0,0,0,0,0,0,0,0,1,0,0,1
2013,Cuba,Matanzas : Provincia,0,1,0,1,1,0,0,3,0,1,0,0,18,0,0,19
2013,Cuba,Las Tunas : Provincia,0,0,0,0,0,0,0,0,0,0,0,0,17,0,0,17
2013,Cuba,La Habana : Provincia,0,0,0,2,11,0,0,13,1,0,0,1,33,0,0,35
2013,Cuba,Holguin : Provincia,0,0,0,0,0,0,0,0,0,0,0,0,38,0,0,38
2013,Cuba,Granma : Provincia,0,0,0,0,0,0,0,0,0,0,0,0,23,0,0,23
2013,Cuba,Cienfuegos : Provincia,0,0,0,0,1,0,0,1,0,0,0,0,47,0,0,47
2013,Cuba,Camaguey : Provincia,0,0,0,2,0,0,0,2,0,1,0,0,21,0,0,22
2013,Cuba,Artemisa : Provincia,0,0,0,0,0,0,0,0,0,0,0,0,1,0,0,1
2013,Cuba,Santiago de Cuba : Provincia,0,0,0,0,0,0,0,0,0,0,0,0,16,0,0,16
2013,Cuba,Sancti Spiritus : Provincia,0,0,0,0,0,0,0,0,0,0,0,0,23,0,0,23
2013,Cuba,Pinar del Rio : Provincia,1,1,0,1,4,0,0,7,0,0,0,1,31,0,0,32
2013,Cuba,GuantÃƒÂ¡namo : Provincia,0,0,0,0,0,0,0,0,0,0,0,0,45,0,0,45
2013,Cuba,Ciego de Avila : Provincia,0,0,0,0,0,0,0,0,0,0,0,0,6,0,0,6
2013,Curaçao,Curacao : Dispersed in the country / territory,0,4,0,0,24,1,0,29,1,2,0,0,27,2,0,32
2013,Cayman Islands,Grand Cayman,0,0,0,0,2,0,0,2,0,1,0,0,3,0,0,4
2013,Cayman Islands,Cayman Islands : Dispersed in the country / territory,0,0,0,0,0,0,0,0,0,0,0,0,5,0,0,5
2013,Germany,Germany : Dispersed in the country / territory,10972,15318,0,12294,77828,9912,0,126324,11807,16911,0,16278,142319,9509,0,196824
2013,Djibouti,Hol-Hol : Point,143,243,0,131,347,9,0,873,182,245,0,139,249,20,0,835
2013,Djibouti,Djibouti : Point,249,273,0,161,994,14,0,1691,205,307,0,162,1975,28,0,2677
2013,Djibouti,Ali-Addeh : Point,919,1505,0,1108,4906,197,0,8635,903,1499,0,953,5539,205,0,9099
2013,Denmark,Denmark : Dispersed in the country / territory,104,125,0,110,1433,236,0,2008,106,127,0,122,1705,195,0,2255
2013,Dominican Rep.,Dominican Republic : Dispersed in the country / territory,87,127,0,118,430,41,0,803,80,110,0,109,408,35,0,742
2013,Algeria,Algiers : Wilaya - Province,9,5,0,3,37,0,0,54,12,10,0,8,60,1,0,91
2013,Algeria,Algeria : Dispersed in the country / territory,89,78,0,57,302,13,0,539,106,93,0,76,976,25,0,1276
2013,Ecuador,Ecuador : Dispersed in the country / territory,461,3432,0,3777,22734,1245,0,31649,450,3513,0,3999,25140,1697,0,34799
2013,Egypt,Saloum : Point,33,45,0,87,1,0,0,166,28,44,0,356,2,0,0,430
2013,Egypt,Suez : Muhafazah - Governorate,8,15,0,4,35,2,0,64,13,9,0,6,37,0,0,65
2013,Egypt,South Sinai : Muhafazah - Governorate,2,3,0,1,7,1,0,14,1,0,0,4,11,2,0,18
2013,Egypt,Sohag : Muhafazah - Governorate,1,0,0,1,1,0,0,3,0,1,0,0,3,1,0,5
2013,Egypt,Red Sea : Muhafazah - Governorate,86,94,0,64,288,25,0,557,77,85,0,57,343,30,0,592
2013,Egypt,Qena : Muhafazah - Governorate,0,4,0,4,7,0,0,15,2,1,0,3,8,0,0,14
2013,Egypt,Port-Said : Muhafazah - Governorate,52,56,0,39,200,16,0,363,60,69,0,64,189,22,0,404
2013,Egypt,North Sinai : Muhafazah - Governorate,7,7,0,3,14,1,0,32,0,1,0,2,22,2,0,27
2013,Egypt,New Valley : Muhafazah - Governorate,1,1,0,1,4,0,0,7,0,3,0,1,5,0,0,9
2013,Egypt,Monofiya : Muhafazah - Governorate,119,150,0,101,460,42,0,872,174,206,0,122,479,34,0,1015
2013,Egypt,Menia : Muhafazah - Governorate,8,11,0,7,20,1,0,47,4,10,0,4,28,1,0,47
2013,Egypt,Matrouh : Muhafazah - Governorate,62,74,0,32,198,9,0,375,86,75,0,51,208,13,0,433
2013,Egypt,Luxor : Muhafazah - Governorate,0,1,0,2,0,0,0,3,0,0,0,0,6,0,0,6
2013,Egypt,Kalyobiya : Muhafazah - Governorate,920,1101,0,618,2994,192,0,5825,971,1128,0,769,3105,211,0,6184
2013,Egypt,Kafr El Shiekh : Muhafazah - Governorate,21,28,0,22,69,3,0,143,24,29,0,30,77,7,0,167
2013,Egypt,Ismailia : Muhafazah - Governorate,69,85,0,55,236,11,0,456,58,87,0,65,248,17,0,475
2013,Egypt,Helwan : Muhafazah - Governorate,97,187,0,191,1638,43,0,2156,91,182,0,162,1377,52,0,1864
2013,Egypt,Giza : Muhafazah - Governorate,684,842,0,713,4516,281,0,7036,715,891,0,763,4968,275,0,7612
2013,Egypt,Gharbeya : Muhafazah - Governorate,42,60,0,29,166,10,0,307,38,53,0,39,170,9,0,309
2013,Egypt,Fayoum : Muhafazah - Governorate,12,22,0,9,43,1,0,87,10,15,0,6,44,1,0,76
2013,Egypt,El-Beheira : Muhafazah - Governorate,38,35,0,22,104,7,0,206,33,38,0,26,111,6,0,214
2013,Egypt,Egypt : Dispersed in the country / territory,7063,9487,0,5982,16252,1032,0,39816,7779,6682,0,11113,16914,659,0,43147
2013,Egypt,Damietta : Muhafazah - Governorate,961,1065,0,723,3075,247,0,6071,948,1194,0,832,3051,210,0,6235
2013,Egypt,Dakahliya : Muhafazah - Governorate,238,293,0,214,798,55,0,1598,264,345,0,216,866,56,0,1747
2013,Egypt,Cairo : Muhafazah - Governorate,1936,2742,0,2169,12291,752,0,19890,2058,2954,0,2438,14388,720,0,22558
2013,Egypt,Beni Suef : Muhafazah - Governorate,9,8,0,5,12,2,0,36,10,7,0,4,14,2,0,37
2013,Egypt,Asyut : Muhafazah - Governorate,12,14,0,7,29,0,0,62,9,19,0,14,28,1,0,71
2013,Egypt,Aswan : Muhafazah - Governorate,0,0,0,0,6,0,0,6,0,0,0,0,23,0,0,23
2013,Egypt,Alexandria : Muhafazah - Governorate,2133,2465,0,1672,7666,683,0,14619,2227,2646,0,1902,7702,689,0,15166
2013,Egypt,Al Sharqia : Muhafazah - Governorate,424,462,0,265,1244,95,0,2490,404,482,0,292,1355,92,0,2625
2013,Egypt,6th October : Muhafazah - Governorate,2505,3192,0,2217,10000,801,0,18715,2639,3344,0,2547,10275,851,0,19656
2013,Eritrea,Emkulu : Point,279,379,0,197,578,25,0,1458,297,392,0,235,647,31,0,1602
2013,Eritrea,Asmara : Point,5,4,0,1,9,0,0,19,3,5,0,2,8,1,0,19
2013,Eritrea,Gash Barka : Zoba - Region,12,12,0,1,28,0,0,53,9,16,0,10,46,1,0,82
2013,Estonia,Illuka : Vald - Rural municipality,0,1,0,0,4,0,0,5,0,0,0,1,19,0,0,20
2013,Estonia,Estonia : Dispersed in the country / territory,0,0,0,0,10,0,0,10,2,2,0,0,56,0,0,60
2013,Ethiopia,Urban OCPs,2,4,0,9,25,5,0,45,3,1,0,4,49,9,0,66
2013,Ethiopia,Tongo Camp : Point,1150,1244,0,604,1964,174,0,5136,1233,1285,0,707,2043,168,0,5436
2013,Ethiopia,Sherkole : Point,1042,1160,0,620,1864,83,0,4769,1133,1230,0,869,2191,83,0,5506
2013,Ethiopia,Sheder : Point,1028,1496,0,892,2455,133,0,6004,1061,1572,0,1008,1548,55,0,5244
2013,Ethiopia,Melkadida : Point,4112,7656,0,3177,8029,434,0,23408,4254,7889,0,3420,4058,451,0,20072
2013,Ethiopia,Mai-Ayni : Point,683,530,0,531,4244,48,0,6036,773,551,0,1440,9332,75,0,12171
2013,Ethiopia,Kobe Camp : Point,4195,5942,0,2129,6264,498,0,19028,4114,6145,0,2536,4139,526,0,17460
2013,Ethiopia,Kebribeyah : Point,1591,2207,0,907,3116,187,0,8008,1593,2301,0,963,2674,249,0,7780
2013,Ethiopia,Hitsats,72,153,0,86,1834,17,0,2162,84,177,0,112,7666,25,0,8064
2013,Ethiopia,Hilaweyn : Point,4321,6300,0,2288,6609,381,0,19899,4442,6213,0,2553,3785,413,0,17406
2013,Ethiopia,Fugnido : Point,4427,5685,0,3380,9748,533,0,23773,4344,5909,0,3641,4252,125,0,18271
2013,Ethiopia,Erebti,80,151,0,54,196,6,0,487,96,182,0,53,147,13,0,491
2013,Ethiopia,Dalool,718,1255,0,654,1765,96,0,4488,808,1228,0,575,850,151,0,3612
2013,Ethiopia,Buramino : Point,4798,6963,0,2275,7293,437,0,21766,4662,7073,0,2451,3741,421,0,18348
2013,Ethiopia,Bokolmanyo : Point,3179,7051,0,3234,8186,466,0,22116,3143,7326,0,3731,4858,496,0,19554
2013,Ethiopia,Berhale : Point,438,775,0,285,821,39,0,2358,460,843,0,294,540,55,0,2192
2013,Ethiopia,Bambasi Camp : Point,1660,1552,0,825,2400,235,0,6672,1596,1530,0,691,2668,246,0,6731
2013,Ethiopia,Awbarre : Point,1100,1950,0,1215,2977,180,0,7422,971,1877,0,1311,2073,98,0,6330
2013,Ethiopia,Ashura,299,265,0,139,544,41,0,1288,321,307,0,328,662,57,0,1675
2013,Ethiopia,Asaita : Point,627,833,0,447,1640,145,0,3692,656,1004,0,522,1560,177,0,3919
2013,Ethiopia,Adiharush : Point,422,873,0,585,4286,30,0,6196,488,1002,0,757,17277,81,0,19605
2013,Ethiopia,Shimelba (Shire/Shiraro) : Point,403,516,0,322,1118,163,0,2522,452,518,0,373,1848,172,0,3363
2013,Ethiopia,Borena : Awrajja - Zone,301,344,0,231,571,101,0,1548,315,359,0,165,413,92,0,1344
2013,Ethiopia,Addis Ababa : Astedader akabibi - Chartered city,214,318,0,258,1238,60,0,2088,216,380,0,256,1731,142,0,2725
2013,Ethiopia,Ad-Damazin Transit Centre : Point,198,337,0,129,597,55,0,1316,216,320,0,172,575,85,0,1368
2013,Fiji,Suva : Point,0,0,0,2,3,0,0,5,0,0,0,1,6,0,0,7
2013,Fiji,Lotoka,0,0,0,0,0,0,0,0,0,0,0,0,2,0,0,2
2013,Gabon,Tchibanga : Point,0,0,0,1,10,0,0,11,0,3,0,2,9,0,0,14
2013,Gabon,Rebe : Point,0,0,0,0,1,0,0,1,0,0,0,0,0,0,0,0
2013,Gabon,Port-Gentil : Point,0,2,0,8,36,4,0,50,1,8,0,3,102,21,0,135
2013,Gabon,Pana/Dienga : Point,0,0,0,0,0,0,0,0,0,0,0,0,2,0,0,2
2013,Gabon,Oyem : Point,0,0,0,0,4,0,0,4,0,0,0,1,7,0,0,8
2013,Gabon,Okondja : Point,0,4,0,2,4,0,0,10,0,2,0,0,38,1,0,41
2013,Gabon,Ntoum : Point,0,0,0,1,1,0,0,2,0,1,0,0,1,0,0,2
2013,Gabon,Ngwoni : Point,0,1,0,0,3,0,0,4,0,0,0,0,4,0,0,4
2013,Gabon,Ndjole : Point,0,0,0,0,0,0,0,0,0,0,0,0,5,0,0,5
2013,Gabon,Ndende : Point,0,0,0,1,0,0,0,1,0,0,0,0,1,0,0,1
2013,Gabon,Mounana : Point,0,2,0,2,6,0,0,10,0,1,0,1,51,2,0,55
2013,Gabon,Mouila : Point,0,3,0,8,33,1,0,45,0,8,0,9,57,4,0,78
2013,Gabon,Moanda : Point,0,6,0,13,36,1,0,56,0,4,0,13,103,6,0,126
2013,Gabon,Mitzic : Point,0,0,0,0,1,0,0,1,0,0,0,0,3,0,0,3
2013,Gabon,Mekambo : Point,0,0,0,0,0,0,0,0,0,0,0,0,2,2,0,4
2013,Gabon,Mayumba : Point,0,0,0,0,1,0,0,1,0,0,0,0,1,0,0,1
2013,Gabon,Makokou : Point,0,0,0,0,7,0,0,7,0,0,0,1,14,2,0,17
2013,Gabon,Libreville : Point,16,89,0,124,549,23,0,801,16,79,0,146,1020,105,0,1366
2013,Gabon,Lastoursville : Point,0,2,0,4,8,0,0,14,0,3,0,5,22,2,0,32
2013,Gabon,Lambarene : Point,0,0,0,1,3,0,0,4,0,2,0,0,8,1,0,11
2013,Gabon,Koulamoutou : Point,0,12,0,12,47,2,0,73,0,8,0,13,99,7,0,127
2013,Gabon,Gamba : Point,0,1,0,1,2,0,0,4,0,1,0,0,5,1,0,7
2013,Gabon,Franceville : Point,2,37,0,34,172,6,0,251,1,53,0,32,501,17,0,604
2013,Gabon,Dilemba : Point,0,0,0,0,0,0,0,0,0,0,0,0,1,0,0,1
2013,Gabon,Booue : Point,0,1,0,0,2,0,0,3,0,1,0,0,8,0,0,9
2013,Gabon,Bongoville : Point,0,0,0,0,0,0,0,0,0,0,0,0,1,0,0,1
2013,Gabon,Bitam : Point,0,0,0,0,2,0,0,2,0,1,0,0,5,0,0,6
2013,Gabon,Akieni : Point,0,2,0,1,3,0,0,6,0,2,0,2,5,0,0,9
2013,Georgia,Vale : Point,0,0,0,0,0,2,0,2,0,0,0,0,1,0,0,1
2013,Georgia,Tbilisi : City,2,2,0,0,14,7,0,25,5,5,0,5,38,0,0,53
2013,Georgia,Pankisi Gorge,8,13,0,37,79,1,0,138,5,22,0,39,62,5,0,133
2013,Georgia,Batumi,0,0,0,0,1,0,0,1,0,0,0,0,1,0,0,1
2013,Georgia,MartqopÃ¢â‚¬â„¢i : Point,1,0,0,0,4,0,0,5,0,0,0,1,24,2,0,27
2013,Georgia,Georgia : Dispersed in the country / territory,10492,10536,0,11574,74691,26724,0,134017,11100,11470,0,12566,62358,17033,0,114527
2013,Ghana,Volta : Region,348,227,0,212,564,43,0,1394,330,286,0,224,801,37,0,1678
2013,Ghana,Northen Region,1,1,0,0,1,0,0,3,0,0,0,0,2,0,0,2
2013,Ghana,Krisan : Point,56,65,0,36,146,6,0,309,58,58,0,38,443,11,0,608
2013,Ghana,Fetentaa : Point,126,150,0,106,517,10,0,909,101,115,0,106,564,7,0,893
2013,Ghana,Egyeikroum : Point,128,139,0,103,536,17,0,923,143,145,0,97,554,11,0,950
2013,Ghana,Buduburam : Point,75,229,0,253,2377,26,0,2960,74,192,0,265,2225,55,0,2811
2013,Ghana,Asanti Region,1,1,0,5,20,2,0,29,5,6,0,5,42,0,0,58
2013,Ghana,Ampain : Point,312,373,0,318,1344,56,0,2403,349,359,0,296,999,24,0,2027
2013,Ghana,Accra : District,94,108,0,99,683,17,0,1001,82,120,0,91,1233,33,0,1559
2013,Guinea,Nzerekore : Prefecture,2,2,0,4,52,5,0,65,1,2,0,5,45,5,0,58
2013,Guinea,Laine : Point,10,20,0,29,73,5,0,137,9,23,0,24,70,5,0,131
2013,Guinea,Kountaya : Point,10,15,0,12,32,3,0,72,11,17,0,9,21,5,0,63
2013,Guinea,Kouankan : Point,363,575,0,579,1312,86,0,2915,312,519,0,563,1151,60,0,2605
2013,Guinea,Gbonodou,29,49,0,48,144,11,0,281,19,72,0,67,131,30,0,319
2013,Guinea,Conakry : Special zone,45,102,0,116,587,0,0,850,44,98,0,116,863,21,0,1142
2013,Guinea,Beyla : Prefecture,24,29,0,15,71,4,0,143,22,28,0,13,27,4,0,94
2013,Gambia,Gambia : Dispersed in the country / territory,776,1099,0,681,2328,302,0,5186,816,1047,0,684,1750,292,0,4589
2013,Guinea-Bissau,Varela ,16,32,0,13,69,8,0,138,16,33,0,11,55,15,0,130
2013,Guinea-Bissau,Tarrero,21,21,0,9,74,11,0,136,23,21,0,7,63,5,0,119
2013,Guinea-Bissau,Sungutoto,24,44,0,17,113,20,0,218,12,56,0,34,72,12,0,186
2013,Guinea-Bissau,Sindina,16,41,0,21,75,2,0,155,26,39,0,25,42,8,0,140
2013,Guinea-Bissau,Sedengal,14,28,0,15,63,9,0,129,21,31,0,31,41,9,0,133
2013,Guinea-Bissau,Sancoma,18,42,0,20,96,12,0,188,28,36,0,28,56,10,0,158
2013,Guinea-Bissau,Saiam,24,41,0,26,76,6,0,173,21,33,0,25,42,8,0,129
2013,Guinea-Bissau,Pelundo,11,57,0,16,58,10,0,152,9,25,0,19,44,7,0,104
2013,Guinea-Bissau,Papia,21,28,0,13,54,8,0,124,18,36,0,20,36,3,0,113
2013,Guinea-Bissau,Mbaiam,27,33,0,26,71,10,0,167,21,34,0,24,44,5,0,128
2013,Guinea-Bissau,Maque,4,23,0,7,37,1,0,72,2,15,0,10,24,1,0,52
2013,Guinea-Bissau,Mandina,9,8,0,3,44,8,0,72,5,11,0,5,23,5,0,49
2013,Guinea-Bissau,Jolmete : Point,36,47,0,46,110,10,0,249,27,58,0,40,87,10,0,222
2013,Guinea-Bissau,Ingorezinho,25,33,0,19,70,5,0,152,28,36,0,12,57,10,0,143
2013,Guinea-Bissau,Ingore,15,27,0,12,69,10,0,133,12,22,0,19,48,12,0,113
2013,Guinea-Bissau,Erame,14,44,0,16,79,16,0,169,18,44,0,20,35,13,0,130
2013,Guinea-Bissau,Djendem,4,13,0,4,17,2,0,40,7,9,0,5,17,3,0,41
2013,Guinea-Bissau,Djegue ,21,52,0,31,111,23,0,238,24,55,0,26,75,7,0,187
2013,Guinea-Bissau,Djambam,18,23,0,12,49,4,0,106,11,21,0,14,27,4,0,77
2013,Guinea-Bissau,Djacumundo,24,37,0,23,75,16,0,175,23,47,0,20,60,7,0,157
2013,Guinea-Bissau,Catel,12,15,0,11,32,4,0,74,10,20,0,14,26,4,0,74
2013,Guinea-Bissau,Caruai,15,22,0,11,41,13,0,102,19,39,0,6,29,11,0,104
2013,Guinea-Bissau,Carabane,14,25,0,17,72,7,0,135,19,22,0,20,55,6,0,122
2013,Guinea-Bissau,Canjandi,23,33,0,14,81,15,0,166,21,49,0,18,74,7,0,169
2013,Guinea-Bissau,Campada,12,23,0,9,61,10,0,115,8,17,0,17,50,3,0,95
2013,Guinea-Bissau,Bufa,9,21,0,9,27,5,0,71,9,21,0,5,14,2,0,51
2013,Guinea-Bissau,Bigene : Point,27,58,0,32,96,18,0,231,21,61,0,33,63,13,0,191
2013,Guinea-Bissau,Beguingue II,22,32,0,24,106,19,0,203,32,43,0,25,50,8,0,158
2013,Guinea-Bissau,Barraca Lugar,11,19,0,5,40,6,0,81,9,21,0,3,19,1,0,53
2013,Guinea-Bissau,Bachil,35,52,0,39,98,17,0,241,33,65,0,33,57,8,0,196
2013,Guinea-Bissau,Asselem,10,16,0,7,36,8,0,77,8,20,0,5,31,6,0,70
2013,Guinea-Bissau,Sao Domingos : Point,0,2,0,2,2,1,0,7,1,1,0,3,5,1,0,11
2013,Guinea-Bissau,Bissau : Autonomous sector,9,10,0,4,29,0,0,52,9,11,0,4,113,1,0,138
2013,Guinea-Bissau,Barraca Mandioca,11,19,0,11,39,5,0,85,12,19,0,11,26,7,0,75
2013,Guatemala,Guatemala : Municipality,1,4,0,3,67,10,0,85,0,4,0,2,76,8,0,90
2013,Guyana,Guyana : Dispersed in the country / territory,0,0,0,3,4,0,0,7,0,1,0,1,2,0,0,4
2013,"China, Hong Kong SAR","Hong Kong SAR, China : Dispersed in the country / territory",52,28,0,17,776,3,0,876,54,33,0,29,1002,4,0,1122
2013,Honduras,Trujillo : Municipio,0,0,0,0,0,0,0,0,0,0,0,0,5,0,0,5
2013,Honduras,Ceiba : Municipio,0,0,0,0,0,0,0,0,0,0,0,0,2,0,0,2
2013,Honduras,Tegucigalpa : Municipio,0,0,0,0,3,0,0,3,0,0,0,0,2,0,0,2
2013,Honduras,Islas de la Bahia : Departamento,0,0,0,0,2,0,0,2,0,0,0,0,0,0,0,0
2013,Honduras,Honduras : Dispersed in the country / territory,1,2,0,1,5,0,0,9,2,1,0,2,9,1,0,15
2013,Honduras,Comayagua : Departamento,0,0,0,0,1,0,0,1,0,0,0,0,0,0,0,0
2013,Croatia,Vinkovci : Point,0,0,0,0,1,0,0,1,0,0,0,0,0,0,0,0
2013,Croatia,Rijeka : Point,0,0,0,0,0,0,0,0,0,0,0,0,2,0,0,2
2013,Croatia,Kutina : Point,1,0,0,0,1,0,0,2,0,0,0,1,2,0,0,3
2013,Croatia,Jezevo : Point,0,0,0,0,0,0,0,0,0,0,0,0,34,0,0,34
2013,Croatia,Bjelovar : Point,0,0,0,0,0,0,0,0,0,0,0,0,1,0,0,1
2013,Croatia,Grad Zagreb : Grad - City,4,6,0,7,28,0,0,45,4,4,0,15,198,0,0,221
2013,Haiti,Port au Prince : Point,0,0,0,0,0,0,0,0,0,0,0,0,3,0,0,3
2013,Haiti,Delmas : Point,0,0,0,0,0,0,0,0,0,0,0,0,2,0,0,2
2013,Haiti,Haiti : Dispersed in the country / territory,0,0,0,0,1,0,0,1,0,0,0,0,6,1,0,7
2013,Indonesia,Sulawesi Tenggara,1,0,0,1,13,0,0,15,2,1,0,3,54,0,0,60
2013,Indonesia,Jawa Timur,0,0,0,0,0,0,0,0,0,0,0,0,120,6,0,126
2013,Indonesia,Jawa Tengah,1,1,0,0,0,0,0,2,0,0,0,0,5,0,0,5
2013,Indonesia,Banten,13,12,0,6,51,1,0,83,12,18,0,10,101,2,0,143
2013,Indonesia,Bangil : Point,0,0,0,0,0,0,0,0,0,0,0,19,103,0,0,122
2013,Indonesia,Yogyakarta : Special region,0,0,0,0,0,0,0,0,0,0,0,0,40,2,0,42
2013,Indonesia,Sumatra Utara : Provinsi - Province,49,82,0,31,242,8,0,412,69,79,0,88,674,12,0,922
2013,Indonesia,Sumatera Barat : Provinsi - Province,0,0,0,0,0,0,0,0,0,0,0,0,1,0,0,1
2013,Indonesia,Sulawesi Utara : Provinsi - Province,0,0,0,0,0,0,0,0,0,0,0,14,67,0,0,81
2013,Indonesia,Sulawesi Selatan : Provinsi - Province,36,43,0,24,156,2,0,261,34,45,0,69,395,7,0,550
2013,Indonesia,Semarang : Provinsi - Province,2,1,0,0,5,0,0,8,2,1,0,0,6,1,0,10
2013,Indonesia,Riau : Provinsi - Province,14,9,0,11,44,2,0,80,8,12,0,22,139,2,0,183
2013,Indonesia,Nusa Tenggara Timur : Provinsi - Province,2,2,0,2,26,0,0,32,4,4,0,9,118,0,0,135
2013,Indonesia,Kepulauan Riau : Provinsi - Province,2,3,0,0,7,0,0,12,1,1,0,27,312,3,0,344
2013,Indonesia,Kalimantan Barat : Provinsi - Province,0,0,0,0,0,0,0,0,0,0,0,13,91,0,0,104
2013,Indonesia,Jawa Barat : Provinsi - Province,57,76,0,49,347,8,0,537,59,88,0,502,3048,22,0,3719
2013,Indonesia,Jakarta : Special district,42,62,0,52,345,8,0,509,48,67,0,151,855,13,0,1134
2013,Indonesia,Indonesia : Dispersed in the country / territory,35,40,0,22,102,1,0,200,32,47,0,66,219,1,0,365
2013,Indonesia,Cilegon : Kota - City,0,0,0,0,0,0,0,0,0,0,0,2,2,0,0,4
2013,Indonesia,Bali : Provinsi - Province,1,5,0,6,26,1,0,39,2,9,0,8,55,2,0,76
2013,India,Delhi : Union territory,1004,1878,0,1409,7940,579,0,12810,1059,1959,0,1830,8219,519,0,13586
2013,Ireland,Ireland : Dispersed in the country / territory,23,116,0,249,1821,106,0,2315,28,129,0,238,3161,130,0,3686
2013,Iran (Islamic Rep. of),Ziveh : Point,7,20,0,29,100,11,0,167,7,19,0,20,80,12,0,138
2013,Iran (Islamic Rep. of),Varmahang : Point,1,1,0,2,2,0,0,6,0,0,0,0,3,0,0,3
2013,Iran (Islamic Rep. of),Torbat e jam : Shahrestan - County,137,255,0,305,1173,106,0,1976,139,260,0,326,1254,160,0,2139
2013,Iran (Islamic Rep. of),Tehran : Shahrestan - County,2,4,0,5,16,1,0,28,4,4,0,4,17,0,0,29
2013,Iran (Islamic Rep. of),Taft : Shahrestan - County,30,41,0,114,224,12,0,421,39,80,0,92,260,19,0,490
2013,Iran (Islamic Rep. of),Sultanieh : Point,0,0,0,1,4,3,0,8,0,0,0,1,5,5,0,11
2013,Iran (Islamic Rep. of),Sonqor : Shahrestan - County,1,4,0,4,11,3,0,23,1,5,0,6,9,2,0,23
2013,Iran (Islamic Rep. of),Saveh : Shahrestan - County,363,580,0,448,891,22,0,2304,450,530,0,601,920,120,0,2621
2013,Iran (Islamic Rep. of),Sarvestan : Shahrestan - County,34,41,0,47,115,6,0,243,28,33,0,42,117,17,0,237
2013,Iran (Islamic Rep. of),Rafsanjan : Shahrestan - County,376,550,0,574,586,204,0,2290,374,515,0,651,560,265,0,2365
2013,Iran (Islamic Rep. of),Mohajerin : Point,230,247,0,326,908,84,0,1795,227,300,0,302,894,109,0,1832
2013,Iran (Islamic Rep. of),Meybod : Shahrestan - County,52,107,0,121,277,16,0,573,62,103,0,131,304,24,0,624
2013,Iran (Islamic Rep. of),Markazi : Ostan - Province,1,2,0,4,10,0,0,17,3,8,0,2,12,0,0,25
2013,Iran (Islamic Rep. of),Khuzestan : Ostan - Province,0,1,0,0,3,0,0,4,1,0,0,0,3,0,0,4
2013,Iran (Islamic Rep. of),Khorasan : Ostan - Province,0,0,0,0,0,0,0,0,0,0,0,0,2,0,0,2
2013,Iran (Islamic Rep. of),Kerman : Shahrestan - County,1,0,0,1,1,0,0,3,1,1,0,1,3,0,0,6
2013,Iran (Islamic Rep. of),Jahrom : Shahrestan - County,8,13,0,15,55,7,0,98,6,9,0,11,54,4,0,84
2013,Iran (Islamic Rep. of),Dilzeh : Point,4,6,0,12,20,3,0,45,7,5,0,8,23,2,0,45
2013,Iran (Islamic Rep. of),Dalaki : Point,27,9,0,10,26,2,0,74,26,8,0,14,21,0,0,69
2013,Iran (Islamic Rep. of),Bezileh : Point,1,2,0,2,15,1,0,21,1,4,0,4,12,1,0,22
2013,Iran (Islamic Rep. of),Bardsir : Shahrestan - County,249,250,0,301,598,32,0,1430,245,260,0,294,594,29,0,1422
2013,Iran (Islamic Rep. of),Bani Najjar : Point,150,143,0,184,670,26,0,1173,154,152,0,180,630,33,0,1149
2013,Iran (Islamic Rep. of),Ardakan : Shahrestan - County,151,227,0,250,619,30,0,1277,162,226,0,258,686,45,0,1377
2013,Iran (Islamic Rep. of),Abazar : Point,3,10,0,12,46,7,0,78,7,10,0,16,63,2,0,98
2013,Iraq,Makhmour : Point,787,1451,0,598,2268,169,0,5273,731,1341,0,668,2345,176,0,5261
2013,Iraq,Wasit : Muhafazah - Province,1860,3491,0,3464,4143,786,0,13744,2189,2434,0,2434,6282,470,0,13809
2013,Iraq,Sulaymaniyah : Muhafazah - Province,5274,8534,0,7950,13876,1826,0,37460,6055,6643,0,6780,23099,1214,0,43791
2013,Iraq,Salah al-Din : Muhafazah - Province,2858,5339,0,5324,6398,1209,0,21128,3365,3737,0,3740,9653,722,0,21217
2013,Iraq,Qadissiya : Muhafazah - Province,782,1461,0,1456,1749,330,0,5778,921,1022,0,1022,2640,196,0,5801
2013,Iraq,Ninewa : Muhafazah - Province,12314,22941,0,22865,27833,5220,0,91173,14470,16104,0,16134,41692,3131,0,91531
2013,Iraq,Najaf : Muhafazah - Province,1247,2394,0,2330,2747,529,0,9247,1463,1652,0,1655,4234,314,0,9318
2013,Iraq,Muthanna : Muhafazah - Province,141,265,0,262,313,59,0,1040,166,184,0,184,475,35,0,1044
2013,Iraq,Missan : Muhafazah - Province,669,1269,0,1247,1480,283,0,4948,788,876,0,876,2264,169,0,4973
2013,Iraq,Kirkuk : Muhafazah - Province,3419,6393,0,6373,7656,1444,0,25285,4028,4474,0,4472,11553,861,0,25388
2013,Iraq,Kerbala : Muhafazah - Province,859,1701,0,1608,1842,362,0,6372,1006,1133,0,1154,2899,218,0,6410
2013,Iraq,Erbil : Muhafazah - Province,9113,11484,0,10062,25177,2263,0,58099,9750,9867,0,10189,44491,1610,0,75907
2013,Iraq,Duhok : Muhafazah - Province,16374,22924,0,19724,41729,4403,0,105154,18020,19171,0,17813,64985,2876,0,122865
2013,Iraq,Diyala : Muhafazah - Province,8226,15398,0,15325,18391,3473,0,60813,9686,10762,0,10762,27781,2071,0,61062
2013,Iraq,Dhi Qar : Muhafazah - Province,1421,2659,0,2647,3177,600,0,10504,1674,1857,0,1857,4800,358,0,10546
2013,Iraq,Basrah : Muhafazah - Province,1310,2518,0,2476,2915,551,0,9770,1545,1756,0,1741,4432,337,0,9811
2013,Iraq,Baghdad : Muhafazah - Province,17531,32906,0,32538,40622,7740,0,131337,20707,22978,0,22973,60620,4869,0,132147
2013,Iraq,Babylon : Muhafazah - Province,1147,2159,0,2140,2558,485,0,8489,1351,1500,0,1503,3879,289,0,8522
2013,Iraq,Anbar : Muhafazah - Province,4734,9475,0,8859,10075,2006,0,35149,5578,6232,0,6245,16045,1204,0,35304
2013,Iraq,Al Qaim : Qadaa - District,479,548,0,351,1185,127,0,2690,481,723,0,384,744,78,0,2410
2013,Israel,Israel : Dispersed in the country / territory,412,344,0,361,6963,150,0,8230,450,340,0,760,42945,250,0,44745
2013,Jamaica,Jamaica : Dispersed in the country / territory,0,1,0,0,8,0,0,9,0,2,0,2,9,0,0,13
2013,Jordan,Zarqa : Governorate,4058,4759,0,3154,11000,841,0,23812,4326,5117,0,3301,9299,630,0,22673
2013,Jordan,Tafilah : Governorate,197,253,0,135,501,27,0,1113,237,234,0,136,450,24,0,1081
2013,Jordan,Mafraq : Zataari Camp,15785,14844,0,10903,33719,2619,0,77870,14501,15041,0,11190,25020,1588,0,67340
2013,Jordan,Mafraq : Governorate,7787,9569,0,6416,20195,1652,0,45619,8386,9673,0,6583,15679,1127,0,41448
2013,Jordan,Madaba : Governorate,714,799,0,565,1876,145,0,4099,779,875,0,547,1684,125,0,4010
2013,Jordan,Maan : Governorate,572,602,0,425,1453,86,0,3138,581,624,0,479,1345,79,0,3108
2013,Jordan,Karak : Governorate,825,876,0,530,1995,167,0,4393,839,935,0,650,1790,121,0,4335
2013,Jordan,Jarash : Governorate,741,893,0,615,1886,169,0,4304,808,885,0,612,1486,118,0,3909
2013,Jordan,Irbid : Governorate,9222,10428,0,6865,23845,2279,0,52639,9787,11022,0,7178,19235,1664,0,48886
2013,Jordan,Balqa : Governorate,1300,1523,0,1073,3667,298,0,7861,1415,1517,0,1117,3293,215,0,7557
2013,Jordan,Aqabah : Governorate,192,203,0,139,570,53,0,1157,203,218,0,187,590,38,0,1236
2013,Jordan,Amman : Governorate,12534,14126,0,9670,40007,3947,0,80284,13220,14986,0,10498,39747,3326,0,81777
2013,Jordan,Ajlun : Governorate,692,756,0,510,1622,133,0,3713,739,860,0,501,1109,104,0,3313
2013,Jordan,Zarqa : Emirates Jordanian Camp (EJC) ,441,505,0,277,795,62,0,2080,398,478,0,235,622,38,0,1771
2013,Jordan,Jordan : Dispersed in the country / territory,1969,3060,0,2197,11465,2143,0,20834,2077,3188,0,2386,11691,1610,0,20952
2013,Kazakhstan,Pavlodar,0,0,0,0,0,0,0,0,0,0,0,0,1,0,0,1
2013,Kazakhstan,Astana : City,0,0,0,0,0,0,0,0,0,0,0,0,2,0,0,2
2013,Kazakhstan,Almaty : City,22,33,0,30,135,5,0,225,25,35,0,39,163,10,0,272
2013,Kazakhstan,Zhambyl : Oblast - Province,0,0,0,0,0,0,0,0,0,0,0,0,1,1,0,2
2013,Kazakhstan,South Kazakhstan : Oblast - Province,5,11,0,4,26,0,0,46,4,7,0,5,54,2,0,72
2013,Kazakhstan,Kazakhstan : Dispersed in the country / territory,0,147,0,306,1294,103,0,1850,0,171,0,318,1267,69,0,1825
2013,Kazakhstan,Almaty : Oblast - Province,1,0,0,1,18,1,0,21,0,1,0,2,17,0,0,20
2013,Kenya,Nairobi : Province,1702,3652,0,3030,16375,791,0,25550,1738,3741,0,3068,15737,566,0,24850
2013,Kenya,Kambioos : Point,2102,3077,0,1241,3498,271,0,10189,2241,3562,0,1657,2592,241,0,10293
2013,Kenya,Kakuma : Point,9155,13026,0,9115,26241,1121,0,58658,9459,14806,0,13779,31230,608,0,69882
2013,Kenya,Ifo : Point,7907,13254,0,6795,22204,1644,0,51804,8181,13860,0,7693,18126,1594,0,49454
2013,Kenya,Ifo 2 : Point,6654,10076,0,3942,11449,926,0,33047,6996,11197,0,5139,8740,896,0,32968
2013,Kenya,Hagadera : Point,8918,13954,0,8017,25641,1827,0,58357,9491,14559,0,9251,21947,1768,0,57016
2013,Kenya,Dagahaley : Point,8446,15685,0,7312,21822,1581,0,54846,8660,16328,0,8132,15690,1499,0,50309
2013,Kyrgyzstan,Ysyk-kol : Oblast - Region,0,0,0,0,209,81,0,290,0,0,0,0,98,57,0,155
2013,Kyrgyzstan,Talas : Oblast - Region,0,0,0,0,239,178,0,417,0,0,0,0,211,113,0,324
2013,Kyrgyzstan,Osh City : Shaar - City,1,3,0,3,72,48,0,127,4,1,0,3,78,47,0,133
2013,Kyrgyzstan,Osh : Oblast - Region,278,428,0,320,1386,324,0,2736,294,428,0,320,379,126,0,1547
2013,Kyrgyzstan,Naryn : Oblast - Region,0,0,0,0,197,95,0,292,0,0,0,0,84,49,0,133
2013,Kyrgyzstan,Jalal-abad : Oblast - Region,186,330,0,218,1045,123,0,1902,186,330,0,218,236,95,0,1065
2013,Kyrgyzstan,Chuy : Oblast - Region,0,0,0,0,96,54,0,150,0,0,0,0,105,99,0,204
2013,Kyrgyzstan,Bishkek : Shaar - City,29,51,0,55,281,52,0,468,36,55,0,47,368,21,0,527
2013,Kyrgyzstan,Batken : Oblast - Region,95,164,0,112,559,90,0,1020,97,164,0,115,245,85,0,706
2013,Cambodia,Phnom Penh : Autonomous municipality,0,1,0,2,10,4,0,17,1,4,0,7,49,2,0,63
2013,Saint Kitts and Nevis,Nevis,0,0,0,0,0,0,0,0,0,0,0,0,1,0,0,1
2013,Saint Kitts and Nevis,Saint Kitts and Nevis : Dispersed in the country / territory,0,0,0,0,0,0,0,0,0,0,0,0,1,0,0,1
2013,Rep. of Korea,Yangju : Point,0,0,0,0,2,0,0,2,0,0,0,0,4,0,0,4
2013,Rep. of Korea,Whasung : Point,0,0,0,0,3,1,0,4,0,0,0,0,9,1,0,10
2013,Rep. of Korea,Ulsan,0,0,0,0,0,0,0,0,0,0,0,0,5,0,0,5
2013,Rep. of Korea,Suwon : Point,0,0,0,0,0,0,0,0,0,0,0,0,10,1,0,11
2013,Rep. of Korea,Sacheon,0,0,0,0,0,0,0,0,0,0,0,0,1,0,0,1
2013,Rep. of Korea,Pusan,0,0,0,0,1,0,0,1,0,0,0,1,9,0,0,10
2013,Rep. of Korea,Pohang : Point,0,0,0,0,0,0,0,0,0,0,0,0,1,0,0,1
2013,Rep. of Korea,Jeonju,0,0,0,0,1,0,0,1,0,0,0,0,5,0,0,5
2013,Rep. of Korea,Gwangju,0,0,0,0,2,0,0,2,0,0,0,0,16,0,0,16
2013,Rep. of Korea,Gunsan,0,0,0,0,0,0,0,0,0,0,0,0,1,0,0,1
2013,Rep. of Korea,Goyang,0,0,0,0,0,0,0,0,0,0,0,0,1,0,0,1
2013,Rep. of Korea,Cheju,0,0,0,6,0,0,0,6,0,0,0,0,3,0,0,3
2013,Rep. of Korea,Changwon,0,0,0,0,0,0,0,0,0,0,0,2,7,0,0,9
2013,Rep. of Korea,Seoul : Teukbyeolsi - Capital metropolitan city,33,29,0,7,297,14,0,380,37,26,0,33,1865,32,0,1993
2013,Rep. of Korea,Inchon : Do - Province,1,1,0,0,8,0,0,10,1,1,0,1,25,0,0,28
2013,Rep. of Korea,Daejeon : Gwangyeoksi - Metropolitan city,2,1,0,0,2,1,0,6,0,0,0,3,5,1,0,9
2013,Rep. of Korea,Daegu : Gwangyeoksi - Metropolitan city,0,0,0,0,2,0,0,2,0,0,0,1,10,0,0,11
2013,Rep. of Korea,Cheongju : Point,0,1,0,0,1,0,0,2,0,0,0,0,3,0,0,3
2013,Kuwait,Kuwait : Dispersed in the country / territory,66,117,0,105,467,34,0,789,82,149,0,127,493,25,0,876
2013,Lebanon,South : Mohafazah - Governorate,11029,11451,0,5837,24525,1217,0,54059,12296,11056,0,6408,21319,900,0,51979
2013,Lebanon,North : Mohafazah - Governorate,24487,24579,0,15578,60034,3941,0,128619,25796,26069,0,16445,50758,2762,0,121830
2013,Lebanon,Mount Lebanon : Mohafazah - Governorate,18684,19027,0,11105,48579,2834,0,100229,20516,20758,0,9366,46530,2310,0,99480
2013,Lebanon,Beqaa : Mohafazah - Governorate,27812,28381,0,18576,65007,4026,0,143802,28518,30640,0,18136,55936,3298,0,136528
2013,Lebanon,Beirut : Mohafazah - Governorate,2224,2315,0,1242,6236,415,0,12432,2396,2553,0,1443,6762,414,0,13568
2013,Liberia,Solo : Point,272,317,0,141,678,77,0,1485,287,371,0,203,587,56,0,1504
2013,Liberia,River Ghee : County,101,209,0,71,311,21,0,713,125,222,0,66,117,4,0,534
2013,Liberia,PTP : Point,1201,1446,0,635,2872,253,0,6407,1110,1478,0,835,2735,169,0,6327
2013,Liberia,Nimba : County,446,838,0,310,1585,198,0,3377,413,862,0,395,716,100,0,2486
2013,Liberia,Montserrado : County,26,31,0,47,151,3,0,258,22,22,0,31,294,3,0,372
2013,Liberia,Monrovia : Point,12,27,0,34,129,1,0,203,8,39,0,33,190,14,0,284
2013,Liberia,Maryland : County,142,237,0,110,402,44,0,935,114,243,0,147,357,21,0,882
2013,Liberia,Little Wlebbo : Point,1120,1355,0,625,2274,113,0,5487,1058,1327,0,587,1482,68,0,4522
2013,Liberia,Grand Gedeh : County,582,1009,0,366,2663,445,0,5065,514,947,0,474,1974,227,0,4136
2013,Liberia,Bahn : Point,868,1228,0,465,1887,115,0,4563,866,1253,0,541,1113,76,0,3849
2013,Libya,Tripoli : Popularate,1537,2235,0,1421,7962,414,0,13569,1598,2222,0,1840,12294,646,0,18600
2013,Saint Lucia,Saint Lucia : Dispersed in the country / territory,0,0,0,0,0,0,0,0,0,0,0,0,4,0,0,4
2013,Sri Lanka,Vavuniya : District,4,11,0,4,45,13,0,77,6,13,0,10,60,6,0,95
2013,Sri Lanka,Mannar : District,7,13,0,13,59,9,0,101,13,15,0,13,75,6,0,122
2013,Sri Lanka,Kandy : District,1,1,0,0,5,0,0,7,0,1,0,0,7,0,0,8
2013,Sri Lanka,Jaffna : District,10,8,0,17,61,14,0,110,4,9,0,16,53,7,0,89
2013,Sri Lanka,Gampaha : District,83,106,0,59,332,16,0,596,89,89,0,61,512,9,0,760
2013,Sri Lanka,Colombo : District,19,21,0,13,70,2,0,125,18,21,0,32,182,3,0,256
2013,Sri Lanka,Trincomalee : District,2,13,0,8,45,0,0,68,8,5,0,9,40,0,0,62
2013,Sri Lanka,Sri Lanka : Dispersed in the country / territory,0,1,0,0,2,0,0,3,1,0,0,1,3,0,0,5
2013,Sri Lanka,Mullaitivu : District,2,11,0,4,41,4,0,62,1,4,0,6,18,3,0,32
2013,Sri Lanka,Kilinochchi : District,1,4,0,11,31,4,0,51,3,7,0,4,21,3,0,38
2013,Lesotho,Lesotho : Dispersed in the country / territory,1,0,0,0,9,0,0,10,1,1,0,2,16,0,0,20
2013,Lithuania,RRC Rukla : Point,4,6,0,1,9,0,0,20,2,5,0,3,26,0,0,36
2013,Lithuania,FRC Pabrade : Point,0,4,0,1,7,1,0,13,1,1,0,4,48,0,0,54
2013,Lithuania,Vilnius : Savivaldybe - Municipality,2,3,0,0,7,0,0,12,0,3,0,1,11,0,0,15
2013,Lithuania,Siauliai: Savivaldybe -Municipality,0,0,0,0,0,1,0,1,0,0,0,0,0,1,0,1
2013,Lithuania,Kaunas : Savivaldybe - Municipality,6,1,0,0,3,0,0,10,0,0,0,0,6,0,0,6
2013,Lithuania,Jonavos Raj. : Savivaldybe - Municipality,0,1,0,0,5,0,0,6,3,0,0,0,3,1,0,7
2013,Lithuania,Electrenai: Savivaldybe -Municipality,1,0,0,0,1,0,0,2,0,2,0,3,1,0,0,6
2013,Latvia,Mucenieki : Point,4,2,0,3,7,0,0,16,1,1,0,1,23,0,0,26
2013,Latvia,Latvia : Dispersed in the country / territory,5,1,0,6,49,1,0,62,10,11,0,15,187,0,0,223
2013,"China, Macao SAR","Macao SAR, China : Dispersed in the country / territory",0,0,0,0,1,0,0,1,0,0,0,1,4,0,0,5
2013,Morocco,Morocco : Dispersed in the country / territory,202,107,0,128,907,11,0,1355,204,95,0,267,3035,17,0,3618
2013,Rep. of Moldova,Republic of Moldova : Dispersed in the country / territory,7,14,0,6,1090,168,0,1285,4,10,0,13,933,121,0,1081
2013,Madagascar,Madagascar : Dispersed in the country / territory,0,0,0,2,6,0,0,8,0,1,0,0,4,0,0,5
2013,Mexico,Mexico : Dispersed in the country / territory,27,61,0,102,511,6,0,707,23,60,0,94,945,2,0,1124
2013,The former Yugoslav Republic of Macedonia,Vizbegovo : Point,13,20,0,14,66,0,0,113,18,33,0,112,795,2,0,960
2013,The former Yugoslav Republic of Macedonia,Veles,0,2,0,1,2,0,0,5,0,1,0,0,1,0,0,2
2013,The former Yugoslav Republic of Macedonia,Valandovo : OpÃ…Â¡tina - Municipality,0,1,0,1,1,1,0,4,0,1,0,1,2,1,0,5
2013,The former Yugoslav Republic of Macedonia,Tetovo : OpÃ…Â¡tina - Municipality,1,8,0,6,36,14,0,65,0,10,0,8,23,2,0,43
2013,The former Yugoslav Republic of Macedonia,Strumica : OpÃ…Â¡tina - Municipality,0,0,0,0,1,0,0,1,0,0,0,0,0,0,0,0
2013,The former Yugoslav Republic of Macedonia,Stip : OpÃ…Â¡tina - Municipality,3,2,0,2,6,2,0,15,0,8,0,3,2,1,0,14
2013,The former Yugoslav Republic of Macedonia,Skopje : City,55,113,0,94,435,47,0,744,66,118,0,104,397,25,0,710
2013,The former Yugoslav Republic of Macedonia,Probistip : OpÃ…Â¡tina - Municipality,0,0,0,0,0,1,0,1,0,0,0,0,0,0,0,0
2013,The former Yugoslav Republic of Macedonia,Prilep : OpÃ…Â¡tina - Municipality,0,1,0,1,1,0,0,3,0,0,0,1,7,0,0,8
2013,The former Yugoslav Republic of Macedonia,Negotino,0,0,0,0,2,0,0,2,0,0,0,0,0,1,0,1
2013,The former Yugoslav Republic of Macedonia,Kumanovo : OpÃ…Â¡tina - Municipality,5,5,0,6,43,3,0,62,4,5,0,2,18,1,0,30
2013,The former Yugoslav Republic of Macedonia,Kocani : OpÃ…Â¡tina - Municipality,0,0,0,0,0,0,0,0,0,0,0,0,1,0,0,1
2013,The former Yugoslav Republic of Macedonia,Kicevo : OpÃ…Â¡tina - Municipality,0,0,0,0,9,2,0,11,0,1,0,0,5,0,0,6
2013,The former Yugoslav Republic of Macedonia,Kavadarci : OpÃ…Â¡tina - Municipality,0,0,0,0,2,0,0,2,0,0,0,0,0,0,0,0
2013,The former Yugoslav Republic of Macedonia,Gostivar : OpÃ…Â¡tina - Municipality,0,6,0,3,21,1,0,31,1,5,0,3,9,1,0,19
2013,The former Yugoslav Republic of Macedonia,Bitola : OpÃ…Â¡tina - Municipality,2,1,0,3,2,1,0,9,2,4,0,1,3,1,0,11
2013,The former Yugoslav Republic of Macedonia,Berovo : OpÃ…Â¡tina - Municipality,0,0,0,0,1,0,0,1,0,0,0,0,0,0,0,0
2013,Mali,Tombouctou : Region,321,568,0,245,1080,126,0,2340,359,546,0,268,985,119,0,2277
2013,Mali,Sikasso : Region,45,51,0,35,116,3,0,250,41,54,0,25,115,2,0,237
2013,Mali,Segou : Region,32,67,0,32,88,8,0,227,32,50,0,36,67,9,0,194
2013,Mali,Mopti : Region,73,100,0,48,206,18,0,445,76,101,0,42,258,31,0,508
2013,Mali,Kayes : Region,1494,1640,0,1029,1856,149,0,6168,1663,1737,0,1051,1995,192,0,6638
2013,Mali,Gao : Region,586,1030,0,535,1865,135,0,4151,663,1132,0,537,1612,185,0,4129
2013,Mali,Faragouana : Point,2,4,0,2,7,0,0,15,1,5,0,3,13,0,0,22
2013,Mali,Bamako : District,83,118,0,97,308,5,0,611,111,94,0,92,362,9,0,668
2013,Montenegro,Ulcinj : OpÃ…Â¡tina - Municipality,5,20,0,9,90,31,0,155,4,12,0,21,100,24,0,161
2013,Montenegro,Tivat : OpÃ…Â¡tina - Municipality,4,6,0,19,189,81,0,299,0,5,0,27,212,70,0,314
2013,Montenegro,Rozaj : OpÃ…Â¡tina - Municipality,4,9,0,12,67,9,0,101,5,10,0,22,57,12,0,106
2013,Montenegro,Podgorica : OpÃ…Â¡tina - Municipality,81,207,0,257,1490,452,0,2487,72,227,0,302,1517,378,0,2496
2013,Montenegro,Podgorica : OpÅ¡tina - Municipality,92,149,0,101,267,21,0,630,118,143,0,115,458,22,0,856
2013,Montenegro,Pluzine : OpÃ…Â¡tina - Municipality,0,0,0,0,1,0,0,1,0,0,0,0,0,0,0,0
2013,Montenegro,Pljevlja : OpÃ…Â¡tina - Municipality,2,2,0,2,38,10,0,54,6,6,0,4,33,8,0,57
2013,Montenegro,Plav : OpÃ…Â¡tina - Municipality,1,9,0,11,138,58,0,217,0,8,0,25,132,52,0,217
2013,Montenegro,Niksic : OpÃ…Â¡tina - Municipality,8,18,0,31,219,56,0,332,9,17,0,34,185,31,0,276
2013,Montenegro,Montenegro : Dispersed in the country / territory,0,0,0,0,10,2,0,12,0,0,0,1,14,1,0,16
2013,Montenegro,Mojkovac : OpÃ…Â¡tina - Municipality,0,1,0,1,15,4,0,21,0,3,0,4,11,3,0,21
2013,Montenegro,Kotor : OpÃ…Â¡tina - Municipality,0,6,0,6,77,48,0,137,1,1,0,8,108,26,0,144
2013,Montenegro,Kolasin : OpÃ…Â¡tina - Municipality,0,4,0,5,28,23,0,60,0,4,0,6,43,13,0,66
2013,Montenegro,Herceg Novi : OpÃ…Â¡tina - Municipality,0,9,0,23,385,215,0,632,1,13,0,38,344,149,0,545
2013,Montenegro,Danilovgrad : OpÃ…Â¡tina - Municipality,0,4,0,8,112,53,0,177,1,9,0,20,110,32,0,172
2013,Montenegro,Cetinje : OpÃ…Â¡tina - Municipality,0,0,0,0,11,2,0,13,0,2,0,0,4,1,0,7
2013,Montenegro,Budva : OpÃ…Â¡tina - Municipality,1,17,0,25,231,78,0,352,3,15,0,21,215,77,0,331
2013,Montenegro,Bijelo Polje : OpÃ…Â¡tina - Municipality,0,2,0,9,61,14,0,86,2,0,0,14,56,12,0,84
2013,Montenegro,Berane : OpÃ…Â¡tina - Municipality,44,71,0,103,420,144,0,782,46,97,0,80,434,95,0,752
2013,Montenegro,Bar : OpÃ…Â¡tina - Municipality,13,46,0,72,553,236,0,920,22,56,0,70,566,197,0,911
2013,Montenegro,Andrijevica : OpÃ…Â¡tina - Municipality,0,4,0,14,86,35,0,139,0,7,0,16,73,25,0,121
2013,Mongolia,Ulaanbaatar : Capital city,0,0,0,0,3,0,0,3,3,0,0,0,7,0,0,10
2013,Mongolia,Mongolia : Dispersed in the country / territory,0,0,0,0,4,0,0,4,1,0,0,0,11,0,0,12
2013,Mozambique,Tete : Provincia,30,50,0,28,99,1,0,208,31,41,0,33,180,4,0,289
2013,Mozambique,Sofala : Provincia,1,4,0,1,13,0,0,19,0,3,0,1,25,1,0,30
2013,Mozambique,Niassa : Provincia,6,17,0,15,31,0,0,69,5,17,0,11,60,1,0,94
2013,Mozambique,Maratane : Point,713,799,0,536,1467,78,0,3593,700,864,0,568,1953,29,0,4114
2013,Mozambique,Manica : Provincia,1,2,0,1,22,0,0,26,1,4,0,0,96,0,0,101
2013,Mozambique,Gaza : Provincia,0,3,0,3,8,0,0,14,0,6,0,2,16,0,0,24
2013,Mozambique,Zambezia : Provincia,3,9,0,3,34,0,0,49,5,9,0,6,96,0,0,116
2013,Mozambique,Nampula : Provincia,160,202,0,120,580,14,0,1076,160,245,0,175,1849,18,0,2447
2013,Mozambique,Maputo Provincia : Provincia,8,44,0,33,84,3,0,172,7,33,0,35,136,3,0,214
2013,Mozambique,Maputo : Cidade capital - Capital City,58,183,0,130,521,15,0,907,67,184,0,139,1041,29,0,1460
2013,Mozambique,Inhambane : Provincia,0,2,0,2,11,0,0,15,0,3,0,4,22,0,0,29
2013,Mozambique,Cabo Delgado : Provincia,2,4,0,1,10,0,0,17,1,3,0,2,29,1,0,36
2013,Mauritania,Mbera : Point,5482,9555,0,3707,15693,1910,0,36347,5483,9391,0,3830,9925,1416,0,30045
2013,Mauritania,Nouakchott and Nouadhibou : Regional grouping,59,81,0,50,249,6,0,445,71,56,0,67,574,7,0,775
2013,Malawi,Dzaleka : Point,1397,1946,0,1302,3304,104,0,8053,1396,2039,0,1437,3918,92,0,8882
2013,Malaysia,Kuala Lumpur : Wilayah Persekutuan - Federal territory,6308,3890,0,3020,28934,664,0,42816,6601,4370,0,4955,81031,779,0,97736
2013,Namibia,Osire : Point,144,290,0,241,705,24,0,1404,159,297,0,286,1019,13,0,1774
2013,Namibia,Namibia : Dispersed in the country / territory,24,17,0,17,62,2,0,122,26,27,0,14,124,3,0,194
2013,Niger,Tigzefan : Point,113,181,0,40,241,20,0,595,108,137,0,23,191,13,0,472
2013,Niger,Tazalit,121,167,0,60,245,23,0,616,137,193,0,70,275,28,0,703
2013,Niger,Tabareybarey : Point,807,1341,0,476,2035,189,0,4848,860,1299,0,424,993,136,0,3712
2013,Niger,Sinegodrar : Point,37,55,0,12,86,6,0,196,31,38,0,15,57,9,0,150
2013,Niger,Miel : Point,43,83,0,28,95,10,0,259,32,69,0,19,111,9,0,240
2013,Niger,Mangaize : Point,707,948,0,377,1526,146,0,3704,741,1043,0,370,1035,132,0,3321
2013,Niger,Koutougou : Point,2,7,0,1,9,0,0,19,3,2,0,2,9,0,0,16
2013,Niger,Kizamou : Point,3,4,0,1,4,2,0,14,0,7,0,2,7,0,0,16
2013,Niger,Intikane,964,1362,0,442,1661,118,0,4547,996,1406,0,455,1404,133,0,4394
2013,Niger,Camp Abala : Point,1208,2002,0,741,2538,217,0,6706,1229,1855,0,713,1548,165,0,5510
2013,Niger,Banibangou : Point,51,73,0,35,124,10,0,293,53,58,0,30,89,15,0,245
2013,Niger,Ayourou : Point,53,96,0,43,174,17,0,383,49,92,0,31,66,7,0,245
2013,Niger,Niger : Dispersed in the country / territory,3,4,0,11,41,5,0,64,1,9,0,5,43,8,0,66
2013,Niger,Niamey : Capital district,662,1172,0,696,2022,217,0,4769,630,1056,0,525,909,137,0,3257
2013,Nigeria,Lagos : State,88,109,0,61,370,0,0,628,88,108,0,83,794,6,0,1079
2013,Nigeria,Benue : State,19,83,0,44,123,16,0,285,26,57,0,54,96,9,0,242
2013,Nigeria,Amana : Point,0,4,0,2,3,2,0,11,0,1,0,0,0,0,0,1
2013,Nigeria,Nigeria : Dispersed in the country / territory,2,0,0,3,4,0,0,9,2,0,0,2,4,0,0,8
2013,Nigeria,Ijebuode : Local government area,5,19,0,17,60,1,0,102,10,23,0,22,103,3,0,161
2013,Nicaragua,Palacaguina : Municipio,0,0,0,0,0,0,0,0,0,0,0,0,2,0,0,2
2013,Nicaragua,Nicaragua : Dispersed in the country / territory,4,4,0,5,57,8,0,78,3,11,0,9,68,6,0,97
2013,Nicaragua,Managua : Departamento,0,1,0,4,7,0,0,12,0,1,0,1,16,0,0,18
2013,Nepal,Sanischare : Point,368,388,0,381,1864,235,0,3236,326,420,0,401,1910,306,0,3363
2013,Nepal,Kathmandu : District,32,46,0,19,142,5,0,244,36,46,0,32,216,4,0,334
2013,Nepal,Beldangi : Point,1119,1504,0,1320,7101,887,0,11931,1148,1579,0,1499,7303,1125,0,12654
2013,Nepal,Nepal : Dispersed in the country / territory,0,2,0,0,14,4,0,20,0,1,0,0,20,1,0,22
2013,Oman,Oman : Dispersed in the country / territory,14,16,0,10,69,2,0,111,13,13,0,16,59,5,0,106
2013,Pakistan,Zar Karez : Point,175,546,0,367,849,61,0,1998,178,547,0,497,887,123,0,2232
2013,Pakistan,Zangal Patai : Point,3,10,0,10,36,0,0,59,2,16,0,13,39,3,0,73
2013,Pakistan,Zafarabad : Point,115,413,0,245,479,25,0,1277,141,400,0,334,629,81,0,1585
2013,Pakistan,Yakaghund : Point,149,397,0,178,405,26,0,1155,134,399,0,188,411,38,0,1170
2013,Pakistan,Utmanzai : Point,141,522,0,331,795,47,0,1836,142,590,0,353,835,113,0,2033
2013,Pakistan,Urguch : Point,1,2,0,8,10,0,0,21,1,6,0,3,21,0,0,31
2013,Pakistan,Toor : Point,130,267,0,213,409,31,0,1050,115,289,0,229,630,45,0,1308
2013,Pakistan,Togh Sarai : Point,544,675,0,368,1165,106,0,2858,635,859,0,330,1042,97,0,2963
2013,Pakistan,Timer : Point,326,1068,0,873,1777,95,0,4139,338,1096,0,948,1898,184,0,4464
2013,Pakistan,Thall : Point,579,1439,0,1214,2683,273,0,6188,619,1571,0,1425,2617,427,0,6659
2013,Pakistan,Surkhab : Point,297,844,0,580,1461,84,0,3266,289,878,0,724,1620,235,0,3746
2013,Pakistan,Sund Rawal : Point,0,6,0,15,15,2,0,38,0,10,0,16,41,6,0,73
2013,Pakistan,Sindh : Province,2743,6929,0,5870,14572,728,0,30842,2839,7238,0,6573,17689,1686,0,36025
2013,Pakistan,Shindand : Point,78,216,0,180,318,20,0,812,73,200,0,200,345,37,0,855
2013,Pakistan,Shaikh Abad : Point,233,687,0,492,1122,78,0,2612,204,704,0,525,1216,107,0,2756
2013,Pakistan,Saranan : Point,969,2414,0,2051,4290,227,0,9951,1003,2404,0,2315,4447,624,0,10793
2013,Pakistan,Rata Kulachi : Point,16,55,0,36,71,6,0,184,17,44,0,59,105,14,0,239
2013,Pakistan,Rakh Zandani : Point,0,0,0,1,1,0,0,2,1,1,0,1,5,0,0,8
2013,Pakistan,Quetta : District,56,151,0,144,412,24,0,787,52,139,0,153,173,14,0,531
2013,Pakistan,Pusha Pul : Point,30,107,0,53,112,9,0,311,22,99,0,95,195,28,0,439
2013,Pakistan,Punjab : Province,6252,18516,0,13968,34401,2089,0,75226,6504,19615,0,16464,43477,3983,0,90043
2013,Pakistan,Posti : Point,13,21,0,19,30,2,0,85,6,28,0,15,34,8,0,91
2013,Pakistan,Pir Alizai : Point,388,1345,0,785,1626,94,0,4238,408,1290,0,955,2060,253,0,4966
2013,Pakistan,Panian : Point,2282,6628,0,5149,12839,721,0,27619,2492,7076,0,5385,12339,1384,0,28676
2013,Pakistan,Padhana : Point,401,1092,0,963,2113,121,0,4690,393,1126,0,1064,2243,259,0,5085
2013,Pakistan,Old Shamshatoo,2184,6343,0,4367,11746,502,0,25142,2286,6662,0,5009,12597,1139,0,27693
2013,Pakistan,Old Akora : Point,1881,4714,0,3099,7439,253,0,17386,1890,4894,0,3566,7853,795,0,18998
2013,Pakistan,Oblan : Point,439,1140,0,940,1850,136,0,4505,466,1169,0,991,1941,222,0,4789
2013,Pakistan,New Durrani : Point,1198,1498,0,749,3295,150,0,6890,1498,1947,0,1198,3145,300,0,8088
2013,Pakistan,New Akora : Point,45,37,0,10,44,2,0,138,35,43,0,17,155,6,0,256
2013,Pakistan,Naurang,40,138,0,129,264,18,0,589,52,148,0,140,283,36,0,659
2013,Pakistan,Naguman : Point,102,410,0,317,648,34,0,1511,124,395,0,376,706,75,0,1676
2013,Pakistan,Nagar : Point,11,39,0,21,42,2,0,115,11,36,0,23,61,4,0,135
2013,Pakistan,Munda : Point,413,1504,0,836,2047,115,0,4915,438,1445,0,929,1975,239,0,5026
2013,Pakistan,Mera Kachori : Point,227,698,0,408,1042,71,0,2446,215,641,0,454,1077,119,0,2506
2013,Pakistan,Mayar : Point,31,100,0,89,179,19,0,418,40,112,0,83,239,25,0,499
2013,Pakistan,Malgagai : Point,239,744,0,571,1197,130,0,2881,223,816,0,615,1398,210,0,3262
2013,Pakistan,Lejay Karez : Point,30,75,0,58,140,9,0,312,43,67,0,82,227,42,0,461
2013,Pakistan,Lakhti Banda : Point,282,776,0,545,1259,157,0,3019,286,816,0,602,1290,226,0,3220
2013,Pakistan,Kotwai : Point,248,730,0,583,1135,89,0,2785,254,730,0,619,1007,183,0,2793
2013,Pakistan,Kotkai : Point,114,282,0,210,496,66,0,1168,108,351,0,236,608,99,0,1402
2013,Pakistan,Kot Chandna : Point,604,1905,0,1451,3093,152,0,7205,693,1788,0,1549,3119,310,0,7459
2013,Pakistan,Koga : Point,524,1011,0,855,1802,90,0,4282,548,1001,0,1010,1739,158,0,4456
2013,Pakistan,Khurasan : Point,156,376,0,330,948,74,0,1884,144,380,0,340,1043,100,0,2007
2013,Pakistan,Khoughani : Point,74,167,0,131,322,14,0,708,58,176,0,144,346,28,0,752
2013,Pakistan,Kheshki : Point,26,61,0,36,90,4,0,217,17,58,0,46,100,12,0,233
2013,Pakistan,Khazana : Point,263,731,0,580,1196,80,0,2850,260,700,0,677,1438,129,0,3204
2013,Pakistan,Khaki : Point,627,1901,0,1326,3049,216,0,7119,643,1886,0,1530,3178,342,0,7579
2013,Pakistan,Khairabad : Point,755,1997,0,908,2486,192,0,6338,763,2074,0,933,2554,299,0,6623
2013,Pakistan,Kesu : Point,28,82,0,70,148,6,0,334,32,105,0,94,176,15,0,422
2013,Pakistan,Kata Kanri : Point,240,593,0,458,928,89,0,2308,237,660,0,476,1118,126,0,2617
2013,Pakistan,Karachi : District,8,30,0,37,92,5,0,172,11,27,0,42,101,7,0,188
2013,Pakistan,Kalkatak : Point,19,106,0,72,165,7,0,369,31,122,0,90,246,11,0,500
2013,Pakistan,Kaghan : Point,75,274,0,116,365,26,0,856,87,289,0,139,369,36,0,920
2013,Pakistan,Kababian : Point,521,1261,0,933,2351,87,0,5153,568,1299,0,1016,3426,202,0,6511
2013,Pakistan,Jerma : Point,47,119,0,74,191,16,0,447,70,128,0,106,248,28,0,580
2013,Pakistan,Jalozai : Point,1766,2208,0,1104,4857,220,0,10155,2208,2870,0,1766,4636,441,0,11921
2013,Pakistan,Jalala : Point,590,1668,0,1176,2744,163,0,6341,611,1684,0,1340,2997,305,0,6937
2013,Pakistan,Ichrian : Point,221,531,0,392,972,65,0,2181,174,528,0,426,1041,113,0,2282
2013,Pakistan,Girdi Jungle : Point,886,2784,0,1544,3592,586,0,9392,1112,3237,0,2055,5373,896,0,12673
2013,Pakistan,Ghulam Banda : Point,346,897,0,739,1659,76,0,3717,395,924,0,895,1801,203,0,4218
2013,Pakistan,Ghiljo : Point,47,129,0,54,180,12,0,422,59,119,0,69,176,22,0,445
2013,Pakistan,Ghazi : Point,6,26,0,5,30,1,0,68,8,30,0,10,34,5,0,87
2013,Pakistan,Gandaf : Point,635,1545,0,1181,2439,195,0,5995,666,1597,0,1287,2717,246,0,6513
2013,Pakistan,Gamkol : Point,1508,3626,0,2955,6219,355,0,14663,1557,3610,0,3343,7484,669,0,16663
2013,Pakistan,Gambila : Point,63,171,0,123,269,28,0,654,100,177,0,145,321,51,0,794
2013,Pakistan,Domshivgar : Point,6,29,0,15,38,2,0,90,3,14,0,20,45,3,0,85
2013,Pakistan,Dodpa : Point,0,22,0,20,36,1,0,79,0,10,0,23,56,3,0,92
2013,Pakistan,Doaba : Point,233,546,0,474,1011,92,0,2356,258,576,0,515,1144,164,0,2657
2013,Pakistan,Darsamand : Point,206,498,0,345,911,90,0,2050,222,509,0,446,1024,142,0,2343
2013,Pakistan,Daraban : Point,2,12,0,5,12,0,0,31,4,5,0,7,14,1,0,31
2013,Pakistan,Dabara : Point,75,192,0,48,126,8,0,449,116,274,0,44,211,16,0,661
2013,Pakistan,Chichana : Point,159,381,0,313,734,53,0,1640,182,371,0,368,984,116,0,2021
2013,Pakistan,Chakdara : Point,472,1478,0,993,2218,117,0,5278,487,1511,0,1118,2599,191,0,5906
2013,Pakistan,Chagai,2,22,0,11,31,4,0,70,9,28,0,10,41,5,0,93
2013,Pakistan,Bizen Khel : Point,54,166,0,154,315,17,0,706,73,190,0,189,346,42,0,840
2013,Pakistan,Basu Mera : Point,162,476,0,499,1136,48,0,2321,183,523,0,573,1116,121,0,2516
2013,Pakistan,Barawal : Point,3,3,0,4,10,1,0,21,0,6,0,7,30,3,0,46
2013,Pakistan,Barary,298,976,0,549,1551,96,0,3470,279,993,0,610,1672,157,0,3711
2013,Pakistan,Barari : Point,5,8,0,3,13,0,0,29,6,6,0,9,20,0,0,41
2013,Pakistan,Barakai : Point,1029,2944,0,2705,5673,315,0,12666,1084,3091,0,2961,5487,620,0,13243
2013,Pakistan,Baka Khel : Point,27,67,0,48,104,11,0,257,31,87,0,68,162,19,0,367
2013,Pakistan,Baghicha : Point,27,58,0,43,99,7,0,234,26,64,0,43,103,12,0,248
2013,Pakistan,Badaber : Point,1104,3370,0,2172,5150,278,0,12074,1188,3446,0,2428,5899,554,0,13515
2013,Pakistan,Azakhel : Point,1045,2893,0,1907,3967,170,0,9982,1285,3094,0,2086,4342,343,0,11150
2013,Pakistan,Mohammad Kheil : Point,191,672,0,378,1135,33,0,2409,216,689,0,486,1177,144,0,2712
2013,Pakistan,Khyber Pakhtunkhwa : Province,85158,136557,0,80501,289459,14249,0,605924,102761,163475,0,108005,298587,27954,0,700782
2013,Pakistan,Islamabad : Federal capital territory,1225,3893,0,2982,7798,454,0,16352,1282,4145,0,3607,8945,896,0,18875
2013,Pakistan,Gandhi Khan Khel : Point,108,300,0,245,489,32,0,1174,138,314,0,236,471,71,0,1230
2013,Pakistan,Gahzgai Minara : Point,71,219,0,146,321,26,0,783,71,232,0,215,390,55,0,963
2013,Pakistan,Balochistan : Province,9913,28302,0,20837,51030,3566,0,113648,10346,29225,0,25001,58885,7728,0,131185
2013,Pakistan,Azad Kashmir : Pakistan administered area,209,702,0,542,1372,91,0,2916,221,755,0,585,1770,190,0,3521
2013,Panama,Darien : Provincia,68,71,0,70,149,14,0,372,68,57,0,60,161,25,0,371
2013,Panama,Panama : Dispersed in the country / territory,268,730,0,2066,3543,864,0,7471,262,809,0,2610,5307,975,0,9963
2013,Panama,Kuna Yala : Comarca - Indiginous region,5,13,0,16,25,1,0,60,4,12,0,14,29,1,0,60
2013,Peru,Peru : Dispersed in the country / territory,11,38,0,250,332,0,0,631,19,60,0,95,802,62,0,1038
2013,Philippines,Pangasinan,0,0,0,0,1,0,0,1,0,0,0,0,2,0,0,2
2013,Philippines,Negros Oriental,0,0,0,0,1,0,0,1,0,0,0,0,1,0,0,1
2013,Philippines,Dumaguete,0,0,0,0,0,0,0,0,0,0,0,0,1,0,0,1
2013,Philippines,Dagupan,0,0,0,0,0,0,0,0,0,0,0,0,1,0,0,1
2013,Philippines,Benguet,0,0,0,0,0,0,0,0,0,0,0,0,1,0,0,1
2013,Philippines,Zamboanga Peninsula (Region IX) : Region,0,0,0,0,0,0,0,0,0,0,0,0,0,1,0,1
2013,Philippines,Western Visayas (Region VI) : Region,0,0,0,0,0,0,0,0,0,0,0,0,1,1,0,2
2013,Philippines,Philippines : Dispersed in the country / territory,0,0,0,2,14,0,0,16,0,0,0,0,81,1,0,82
2013,Philippines,National Capital Region (NCR) : Region,0,1,0,1,15,0,0,17,0,4,0,1,76,4,0,85
2013,Philippines,MIMAROPA (Region IV-B) : Region,0,0,0,0,0,0,0,0,0,0,0,0,1,0,0,1
2013,Philippines,Davao (Region XI) : Region,0,2,0,0,1,0,0,3,0,0,0,0,2,1,0,3
2013,Philippines,Central Luzon (Region III) : Region,0,0,0,0,0,0,0,0,0,0,0,0,9,1,0,10
2013,Philippines,CALABARZON (Region IV-A ) : Region,0,1,0,4,5,1,0,11,0,1,0,0,20,1,0,22
2013,Palau,Koror : State,0,0,0,0,0,0,0,0,0,0,0,0,1,0,0,1
2013,Papua New Guinea,Port Moresby : National Capital District,0,0,0,0,0,0,0,0,0,0,0,1,14,0,0,15
2013,Papua New Guinea,Papua New Guinea : Dispersed in the country / territory,440,612,0,501,1789,126,0,3468,446,696,0,569,1746,145,0,3602
2013,Papua New Guinea,East Awin : Point,143,199,0,163,581,41,0,1127,145,226,0,185,568,47,0,1171
2013,Poland,Linin : Point,33,37,0,15,59,1,0,145,44,47,0,14,50,1,0,156
2013,Poland,Horbow : Point,14,19,0,7,35,0,0,75,15,16,0,5,30,1,0,67
2013,Poland,Grupa : Point,29,29,0,12,51,0,0,121,28,23,0,7,49,0,0,107
2013,Poland,Grotniki : Point,11,7,0,7,23,1,0,49,14,17,0,6,26,1,0,64
2013,Poland,Debak : Point,18,16,0,6,43,0,0,83,20,20,0,11,63,2,0,116
2013,Poland,Czerwony Bor : Point,3,4,0,4,8,0,0,19,13,5,0,1,7,0,0,26
2013,Poland,Bezwola II,10,13,0,6,26,0,0,55,11,15,0,8,22,2,0,58
2013,Poland,Bezwola,11,13,0,5,25,1,0,55,16,24,0,6,28,1,0,75
2013,Poland,Warsaw : Powiat - County,7,19,0,9,31,3,0,69,7,18,0,9,0,0,0,34
2013,Poland,Lukow : Powiat - County,24,31,0,13,43,1,0,112,30,30,0,12,38,0,0,110
2013,Poland,Lublin : Powiat - County,19,9,0,2,32,0,0,62,9,13,0,9,32,1,0,64
2013,Poland,Bialystok : Powiat - County,20,26,0,7,31,0,0,84,17,29,0,5,28,0,0,79
2013,Poland,Biala Podlaska : Powiat - County,1,7,0,4,14,0,0,26,8,11,0,4,20,0,0,43
2013,Paraguay,Paraguay : Dispersed in the country / territory,2,8,0,8,38,3,0,59,2,3,0,6,66,1,0,78
2013,Qatar,Qatar : Dispersed in the country / territory,6,6,0,10,46,3,0,71,9,5,0,6,44,6,0,70
2013,Rwanda,Kiziba : Point,1152,1636,0,1365,4266,483,0,8902,1119,1501,0,1366,2972,388,0,7346
2013,Rwanda,Kigali : Point,130,212,0,170,509,16,0,1037,96,215,0,165,513,25,0,1014
2013,Rwanda,Gihembe : Point,907,1476,0,1409,3860,476,0,8128,888,1549,0,1326,2585,277,0,6625
2013,Rwanda,Rwamagana : Akarere - District,7,5,0,3,15,0,0,30,7,8,0,2,5,0,0,22
2013,Rwanda,Rutsiro : Akarere - District,118,79,0,29,236,6,0,468,110,61,0,18,46,5,0,240
2013,Rwanda,Rusizi : Akarere - District,37,33,0,18,63,8,0,159,36,39,0,13,19,10,0,117
2013,Rwanda,Rulindo : Akarere - District,15,13,0,1,26,1,0,56,11,8,0,0,4,0,0,23
2013,Rwanda,Ruhango : Akarere - District,8,1,0,4,21,0,0,34,6,9,0,1,2,1,0,19
2013,Rwanda,Rubavu : Akarere - District,1192,1203,0,827,2524,210,0,5956,1214,1150,0,644,1045,116,0,4169
2013,Rwanda,Nyaruguru : Akarere - District,22,21,0,5,42,0,0,90,30,18,0,7,11,1,0,67
2013,Rwanda,Nyarugenge : Akarere - District,4,3,0,2,18,0,0,27,6,4,0,2,6,0,0,18
2013,Rwanda,Nyanza : Akarere - District,6,4,0,2,15,1,0,28,8,5,0,3,10,3,0,29
2013,Rwanda,Nyamasheke : Akarere - District,54,60,0,17,115,2,0,248,75,63,0,15,29,2,0,184
2013,Rwanda,Nyamagabe : Akarere - District,1722,2275,0,1652,4219,294,0,10162,1751,2254,0,1424,2381,243,0,8053
2013,Rwanda,Nyagatare (Cyangugu) : Akarere - District,3,1,0,1,3,0,0,8,0,1,0,0,4,1,0,6
2013,Rwanda,Nyabihu : Akarere - District,160,101,0,39,357,11,0,668,161,81,0,25,85,10,0,362
2013,Rwanda,Ngororero : Akarere - District,45,29,0,15,97,2,0,188,46,39,0,10,25,3,0,123
2013,Rwanda,Ngoma : Akarere - District,10,4,0,6,11,1,0,32,4,5,0,4,3,2,0,18
2013,Rwanda,Musanze : Akarere - District,80,66,0,11,195,5,0,357,94,56,0,18,59,0,0,227
2013,Rwanda,Muhanga : Akarere - District,7,6,0,2,17,0,0,32,7,5,0,2,6,1,0,21
2013,Rwanda,Kirehe : Akarere - District,1,2,0,2,6,1,0,12,1,0,0,1,4,1,0,7
2013,Rwanda,Kicukiro : Akarere - District,4,5,0,1,17,0,0,27,4,1,0,1,6,0,0,12
2013,Rwanda,Kayonza : Akarere - District,4,2,0,2,5,0,0,13,5,8,0,0,3,0,0,16
2013,Rwanda,Karongi : Akarere - District,122,104,0,36,232,5,0,499,116,99,0,21,39,5,0,280
2013,Rwanda,Kamonyi : Akarere - District,3,1,0,1,6,0,0,11,4,1,0,2,0,0,0,7
2013,Rwanda,Huye : Akarere - District,11,17,0,5,25,3,0,61,10,17,0,3,16,2,0,48
2013,Rwanda,Gisagara : Akarere - District,18,12,0,5,26,0,0,61,12,9,0,5,12,1,0,39
2013,Rwanda,Gicumbi : Akarere - District,6,5,0,2,14,0,0,27,6,4,0,0,3,2,0,15
2013,Rwanda,Gatsibo : Akarere - District,9,10,0,4,17,0,0,40,7,4,0,0,6,0,0,17
2013,Rwanda,Gasabo : Akarere - District,1090,1798,0,1344,3451,242,0,7925,1096,1761,0,1235,2001,188,0,6281
2013,Rwanda,Gakenke : Akarere - District,10,12,0,1,16,0,0,39,9,4,0,1,6,0,0,20
2013,Rwanda,Burera : Akarere - District,17,18,0,7,31,3,0,76,17,14,0,8,11,1,0,51
2013,Rwanda,Bugesera : Akarere - District,19,10,0,2,40,0,0,71,16,12,0,1,11,3,0,43
2013,Saudi Arabia,Jazan,1,0,0,0,1,0,0,2,0,0,0,0,2,0,0,2
2013,Saudi Arabia,Riyadh : Province,6,39,0,26,97,5,0,173,9,39,0,49,157,7,0,261
2013,Saudi Arabia,Madinah : Province,0,2,0,0,1,0,0,3,0,0,0,0,3,0,0,3
2013,Saudi Arabia,Khobar : Governorate,0,1,0,1,2,1,0,5,0,0,0,1,11,0,0,12
2013,Saudi Arabia,Jeddah : Governorate,5,19,0,27,35,4,0,90,5,24,0,17,54,5,0,105
2013,Saudi Arabia,Arar : Governorate,0,0,0,0,0,0,0,0,0,0,0,0,2,0,0,2
2013,Sudan,Wad Sherife village,7,65,0,73,274,29,0,448,16,76,0,71,133,18,0,314
2013,Sudan,Wad Sherife : Point,449,1294,0,1041,5062,773,0,8619,466,1366,0,1129,3045,711,0,6717
2013,Sudan,Wad Medani : Point,0,0,0,1,1,0,0,2,0,1,0,1,0,1,0,3
2013,Sudan,Wad El Hileau : Point,12,36,0,25,82,11,0,166,5,31,0,20,77,8,0,141
2013,Sudan,Um Shalaya : Point,822,839,0,560,1782,248,0,4251,847,763,0,564,958,134,0,3266
2013,Sudan,Um Sagata,0,0,0,3,1,0,0,4,0,1,0,0,1,1,0,3
2013,Sudan,Um Rakuba : Point,15,49,0,30,163,15,0,272,14,53,0,55,157,32,0,311
2013,Sudan,Um Gulja : Point,39,185,0,94,517,78,0,913,50,186,0,89,529,194,0,1048
2013,Sudan,Um Gargur : Point,371,772,0,622,2958,330,0,5053,366,804,0,738,2778,469,0,5155
2013,Sudan,Um brosh : Point,0,0,0,0,0,0,0,0,0,0,0,0,1,0,0,1
2013,Sudan,Um Ali : Point,2,12,0,10,15,0,0,39,5,6,0,7,8,2,0,28
2013,Sudan,Tokar : District,0,0,0,0,0,0,0,0,0,0,0,0,1,0,0,1
2013,Sudan,Suwakin : Point,3,8,0,3,18,1,0,33,2,4,0,4,43,2,0,55
2013,Sudan,Sinkat : District,0,0,0,0,0,0,0,0,0,0,0,0,1,0,0,1
2013,Sudan,Showak,0,3,0,4,13,2,0,22,0,6,0,7,15,2,0,30
2013,Sudan,Shagarab 3 : Point,152,619,0,525,1742,202,0,3240,157,629,0,469,1106,298,0,2659
2013,Sudan,Shagarab 2 : Point,260,1154,0,840,2637,239,0,5130,297,1214,0,878,1700,384,0,4473
2013,Sudan,Shagarab 1 : Point,362,1437,0,1001,4433,411,0,7644,381,1493,0,1114,4032,524,0,7544
2013,Sudan,Salmin : Point,0,1,0,0,1,0,0,2,0,1,0,0,1,0,0,2
2013,Sudan,Salalab : Point,2,42,0,29,138,4,0,215,2,37,0,42,181,12,0,274
2013,Sudan,Safawa : Point,0,0,0,0,3,1,0,4,0,0,0,0,0,0,0,0
2013,Sudan,Port Sudan : District,22,99,0,82,275,14,0,492,36,113,0,72,479,29,0,729
2013,Sudan,Nyala : Region,0,0,0,0,9,0,0,9,0,0,0,0,12,0,0,12
2013,Sudan,Nyala : District,0,0,0,0,1,0,0,1,0,0,0,0,8,0,0,8
2013,Sudan,New Halfa : Point,9,14,0,6,89,0,0,118,15,15,0,8,834,10,0,882
2013,Sudan,Mukjar : Point,51,108,0,54,149,20,0,382,58,91,0,57,124,17,0,347
2013,Sudan,Marghania : Point,2,22,0,9,88,4,0,125,1,17,0,17,122,9,0,166
2013,Sudan,Mafaza : Point,0,0,0,0,1,0,0,1,0,0,0,0,0,0,0,0
2013,Sudan,Laffa : Point,0,1,0,0,6,1,0,8,0,1,0,0,0,0,0,1
2013,Sudan,Kilo 7 : Point,1,23,0,17,77,16,0,134,0,36,0,21,65,18,0,140
2013,Sudan,Kilo 26 : Point,369,695,0,568,2358,308,0,4298,389,784,0,580,1846,406,0,4005
2013,Sudan,Khartoum North : Point,1,0,0,0,1,0,0,2,0,1,0,0,2,0,0,3
2013,Sudan,Karkora : Point,0,5,0,4,14,3,0,26,1,4,0,3,12,2,0,22
2013,Sudan,Kalakla : Point,0,0,0,0,4,0,0,4,0,0,0,2,1,1,0,4
2013,Sudan,Hawata : Point,1,4,0,0,3,0,0,8,1,1,0,1,0,0,0,3
2013,Sudan,Gulsa : Point,0,4,0,9,23,1,0,37,1,2,0,4,9,3,0,19
2013,Sudan,Girba : Point,309,552,0,412,1825,239,0,3337,318,600,0,431,1318,326,0,2993
2013,Sudan,Geref : Point,0,3,0,3,11,0,0,17,0,2,0,3,14,1,0,20
2013,Sudan,Fau Town : Point,0,1,0,0,1,0,0,2,0,2,0,1,0,0,0,3
2013,Sudan,Fau 5 : Point,8,86,0,63,235,36,0,428,8,94,0,67,225,54,0,448
2013,Sudan,Fath El Rahman : Point,1,22,0,18,95,17,0,153,3,20,0,20,68,24,0,135
2013,Sudan,El Geneina : Point,0,0,0,0,10,0,0,10,0,0,0,0,41,0,0,41
2013,Sudan,Dordeab : Point,0,2,0,3,5,0,0,10,0,1,0,0,2,0,0,3
2013,Sudan,Doka : Point,0,0,0,1,2,1,0,4,0,0,0,1,0,1,0,2
2013,Sudan,Diam El-Nour : Point,13,29,0,30,149,6,0,227,11,37,0,23,249,15,0,335
2013,Sudan,Dehama : Point,0,0,0,0,0,0,0,0,0,0,0,0,1,1,0,2
2013,Sudan,Daim : Point,1,2,0,3,5,1,0,12,0,3,0,3,15,1,0,22
2013,Sudan,Basonda : Point,0,0,0,0,1,0,0,1,1,1,0,0,0,0,0,2
2013,Sudan,Awad El Seid : Point,1,43,0,39,153,28,0,264,1,56,0,47,114,41,0,259
2013,Sudan,Asotriba : Point,0,0,0,0,0,0,0,0,0,0,0,0,2,1,0,3
2013,Sudan,Aroma : Point,2,3,0,0,4,0,0,9,0,0,0,3,6,1,0,10
2013,Sudan,Adingrar,0,0,0,0,1,0,0,1,0,0,0,0,1,0,0,1
2013,Sudan,Abuda : Point,146,270,0,212,790,87,0,1505,131,270,0,246,672,116,0,1435
2013,Sudan,Abu Rakham area : Point,6,26,0,30,107,17,0,186,7,26,0,39,93,28,0,193
2013,Sudan,Khartoum : Wilayat - State,286,686,0,833,4347,214,0,6366,275,693,0,888,5045,339,0,7240
2013,Sudan,Kassala : Wilayat - State,105,365,0,313,1369,103,0,2255,121,370,0,321,1656,144,0,2612
2013,Sudan,Gadaref : Wilayat - State,30,114,0,116,440,21,0,721,41,148,0,149,493,59,0,890
2013,Senegal,Saint Louis,1,2,0,0,9,0,0,12,3,1,0,0,13,1,0,18
2013,Senegal,Richard Toll : Point,1347,1627,0,755,2750,270,0,6749,1377,1527,0,724,2060,227,0,5915
2013,Senegal,Dakar/Thies : Point,6,17,0,16,29,1,0,69,10,25,0,20,58,3,0,116
2013,Senegal,Dakar : Point,100,132,0,130,946,22,0,1330,105,175,0,162,2038,39,0,2519
2013,Singapore,Singapore : Dispersed in the country / territory,0,0,0,0,2,0,0,2,0,0,0,0,1,0,0,1
2013,Solomon Islands,Honiara : Capital territory,0,0,0,0,1,0,0,1,0,0,0,0,2,0,0,2
2013,Sierra Leone,Tobanda : Point,2,12,0,15,22,2,0,53,3,13,0,14,35,2,0,67
2013,Sierra Leone,Taiama : Point,7,21,0,19,38,3,0,88,4,48,0,53,85,7,0,197
2013,Sierra Leone,Largo : Point,3,18,0,21,34,2,0,78,2,22,0,15,31,3,0,73
2013,Sierra Leone,Jimmi Bago,3,16,0,22,34,3,0,78,2,13,0,15,40,2,0,72
2013,Sierra Leone,Jembe : Point,2,20,0,17,30,2,0,71,2,18,0,14,28,2,0,64
2013,Sierra Leone,Gondama : Point,3,24,0,18,47,3,0,95,3,14,0,42,44,2,0,105
2013,Sierra Leone,Gerihun : Point,8,55,0,46,56,1,0,166,10,48,0,28,49,2,0,137
2013,Sierra Leone,Freetown : Point,23,74,0,124,143,12,0,376,20,80,0,86,163,7,0,356
2013,Sierra Leone,Bo : District,1,22,0,25,53,5,0,106,2,19,0,25,42,8,0,96
2013,Sierra Leone,Kenema : District,9,44,0,52,121,21,0,247,12,46,0,42,119,15,0,234
2013,Sierra Leone,Bandajuma : Point,2,8,0,5,21,1,0,37,3,12,0,15,28,1,0,59
2013,El Salvador,San Salvador : Departamento - Department,0,2,0,0,2,1,0,5,0,0,0,1,15,0,0,16
2013,El Salvador,La Union : Departamento - Department,0,0,0,0,5,2,0,7,0,0,0,0,14,4,0,18
2013,El Salvador,Cuscatlan : Departamento - Department,0,0,0,0,1,0,0,1,0,0,0,1,1,0,0,2
2013,Somalia,Hargeisa : District,697,1040,0,491,2349,29,0,4606,665,1023,0,498,2357,75,0,4618
2013,Somalia,Mudug : Gobolka - Region,34,56,0,9,106,2,0,207,55,57,0,10,108,10,0,240
2013,Somalia,Bari : Gobolka - Region,192,326,0,144,586,22,0,1270,212,301,0,126,671,38,0,1348
2013,Somalia,Banaadir : Gobolka - Region,8,14,0,3,17,0,0,42,8,7,0,1,23,0,0,39
2013,Serbia and Kosovo (S/RES/1244 (1999)),Vojvodina : Autonomous province,0,594,0,1363,10728,7381,0,20066,0,662,0,1454,12151,4259,0,18526
2013,Serbia and Kosovo (S/RES/1244 (1999)),Serbia : Dispersed in the country / territory,345,395,0,375,933,50,0,2098,345,395,0,375,932,50,0,2097
2013,Serbia and Kosovo (S/RES/1244 (1999)),Kosovo (S/RES/1244 (1999)) : Dispersed in the country / territory,1103,1243,0,1255,3859,1331,0,8791,1176,1253,0,1299,5073,1295,0,10096
2013,Serbia and Kosovo (S/RES/1244 (1999)),Central and Southern Serbia : Regional grouping,7,4772,0,7045,40707,15123,0,67654,11,5106,0,7408,41544,12008,0,66077
2013,Serbia and Kosovo (S/RES/1244 (1999)),Belgrade : Capital city,30,2982,0,4730,28332,12678,0,48752,17,3147,0,5104,29463,8773,0,46504
2013,South Sudan,Yusuf Batil,4189,4880,0,2288,7827,690,0,19874,4371,4866,0,2430,6609,883,0,19159
2013,South Sudan,Yida : Point,8830,9557,0,5295,13959,757,0,38398,9204,9170,0,4972,7666,577,0,31589
2013,South Sudan,Yei : County,137,167,0,111,244,1,0,660,113,162,0,150,741,2,0,1168
2013,South Sudan,Tambura : County,104,113,0,27,198,4,0,446,110,95,0,28,107,1,0,341
2013,South Sudan,Pochalla : County,208,446,0,293,785,51,0,1783,211,470,0,283,292,27,0,1283
2013,South Sudan,Naandi : Point,26,28,0,10,55,2,0,121,28,37,0,16,43,3,0,127
2013,South Sudan,Morobo : County,42,57,0,22,75,9,0,205,36,50,0,16,51,3,0,156
2013,South Sudan,Maridi : County,36,53,0,12,67,0,0,168,42,46,0,23,95,1,0,207
2013,South Sudan,Malakal : County,33,29,0,6,74,3,0,145,26,46,0,4,141,6,0,223
2013,South Sudan,Makpandu : Point,324,315,0,164,695,44,0,1542,299,304,0,156,665,44,0,1468
2013,South Sudan,Lelo,115,107,0,62,188,6,0,478,115,101,0,54,204,4,0,478
2013,South Sudan,Lasu : Point,788,863,0,509,1513,146,0,3819,736,843,0,556,1075,79,0,3289
2013,South Sudan,Kaya,2201,2240,0,1216,3812,352,0,9821,2241,2208,0,1097,2950,471,0,8967
2013,South Sudan,Juba : County,284,345,0,122,820,12,0,1583,327,275,0,147,3408,60,0,4217
2013,South Sudan,Gorom : Point,222,254,0,110,513,22,0,1121,244,294,0,135,651,11,0,1335
2013,South Sudan,Gendrassa,1963,2114,0,1032,3378,238,0,8725,2115,1988,0,1020,3107,334,0,8564
2013,South Sudan,Ezo : County,291,327,0,148,840,63,0,1669,320,306,0,139,507,61,0,1333
2013,South Sudan,Doro : Point,5723,5837,0,2805,9195,534,0,24094,6111,6012,0,3030,7681,494,0,23328
2013,South Sudan,Andari : Point,32,23,0,12,82,4,0,153,30,34,0,8,57,3,0,132
2013,South Sudan,Ajuong Thok,581,511,0,345,970,26,0,2433,591,577,0,789,2258,43,0,4258
2013,South Sudan,Source Yubu : Point,75,98,0,33,217,10,0,433,94,92,0,40,98,9,0,333
2013,Slovenia,Slovenia : Dispersed in the country / territory,2,9,0,6,37,0,0,54,4,18,0,26,115,0,0,163
2013,Slovenia,Ljubljana : Obcine - Municipality,0,0,0,0,3,0,0,3,0,0,0,1,17,0,0,18
2013,Swaziland,Malindza : Point,21,44,0,28,94,0,0,187,20,39,0,41,215,4,0,319
2013,Swaziland,Swaziland : Dispersed in the country / territory,16,34,0,27,140,2,0,219,17,44,0,39,217,3,0,320
2013,Sint Maarten (Dutch part),Sint Maarten (Dutch part) : Dispersed in the country / territory,0,0,0,0,1,0,0,1,0,0,0,1,2,0,0,3
2013,Syrian Arab Rep.,Tartous : Mohafazah - Governorate,14,28,0,28,104,12,0,186,14,23,0,35,98,21,0,191
2013,Syrian Arab Rep.,Syrian Arab Republic : Dispersed in the country / territory,65,96,0,96,380,29,0,666,49,111,0,93,366,51,0,670
2013,Syrian Arab Rep.,Raqqa : Mohafazah - Governorate,9,12,0,4,26,2,0,53,8,12,0,8,20,1,0,49
2013,Syrian Arab Rep.,Lattakia : Mohafazah - Governorate,3,31,0,23,99,13,0,169,20,22,0,47,95,15,0,199
2013,Syrian Arab Rep.,Idleb : Mohafazah - Governorate,1,8,0,11,43,1,0,64,8,18,0,10,40,1,0,77
2013,Syrian Arab Rep.,Homs : Mohafazah - Governorate,31,59,0,56,220,20,0,386,35,67,0,79,191,38,0,410
2013,Syrian Arab Rep.,Hassakeh : Mohafazah - Governorate,211,435,0,273,1121,136,0,2176,207,457,0,290,598,90,0,1642
2013,Syrian Arab Rep.,Hama : Mohafazah - Governorate,4,6,0,7,39,6,0,62,6,15,0,16,23,5,0,65
2013,Syrian Arab Rep.,Dayr Az-Zor : Mohafazah - Governorate,25,47,0,35,142,4,0,253,32,52,0,30,109,7,0,230
2013,Syrian Arab Rep.,Dara : Mohafazah - Governorate,18,52,0,33,117,6,0,226,22,54,0,41,87,11,0,215
2013,Syrian Arab Rep.,Damascus : Mohafazah - Governorate,888,1865,0,1696,7117,916,0,12482,895,1918,0,1715,6318,1133,0,11979
2013,Syrian Arab Rep.,As-Suweida : Mohafazah - Governorate,2,0,0,1,6,0,0,9,1,0,0,1,8,1,0,11
2013,Syrian Arab Rep.,Aleppo : Mohafazah - Governorate,54,101,0,78,382,28,0,643,75,107,0,93,337,43,0,655
2013,Syrian Arab Rep.,Al Qunaytirah : Mohafazah - Governorate,0,0,0,0,1,0,0,1,1,1,0,0,0,0,0,2
2013,Turks and Caicos Islands,Turks and Caicos Islands : Dispersed in the country / territory,0,0,0,0,2,0,0,2,0,0,0,0,8,0,0,8
2013,Chad,Treguine : Point,2047,2071,0,1576,4860,568,0,11122,2043,2114,0,1692,3567,452,0,9868
2013,Chad,Touloum : Point,2188,3466,0,3311,6773,636,0,16374,2206,3276,0,3014,3243,388,0,12127
2013,Chad,Oure Cassoni : Point,2551,4465,0,4506,8934,731,0,21187,2493,4353,0,3477,3573,332,0,14228
2013,Chad,Ngouboua : Point,81,118,0,120,6,0,0,325,74,100,0,49,5,0,0,228
2013,Chad,N'Djamena : Region,39,62,0,42,174,2,0,319,46,70,0,41,475,19,0,651
2013,Chad,Moyo : Point,974,1352,0,631,1790,177,0,4924,965,1273,0,605,1015,103,0,3961
2013,Chad,Mile : Point,1738,2787,0,2002,5019,455,0,12001,1714,2627,0,1789,2383,304,0,8817
2013,Chad,Kounoungou : Point,1483,2877,0,2193,5074,391,0,12018,1401,2787,0,2036,2344,290,0,8858
2013,Chad,Koldaga : Point,63,57,0,32,100,2,0,254,75,85,0,27,84,4,0,275
2013,Chad,Iridimi : Point,2008,4079,0,4035,2141,233,0,12496,2107,3834,0,2843,677,19,0,9480
2013,Chad,Goz Amer : Point,3185,3626,0,2015,6805,641,0,16272,3112,3656,0,2207,4284,574,0,13833
2013,Chad,Gondje : Point,786,1580,0,1270,2340,111,0,6087,759,1507,0,1344,1586,66,0,5262
2013,Chad,Gaga : Point,2034,2774,0,2026,5364,334,0,12532,2044,2673,0,2121,3544,322,0,10704
2013,Chad,Farchana : Point,2209,2686,0,2364,6366,712,0,14337,2286,2673,0,2435,4081,480,0,11955
2013,Chad,Dosseye : Point,1524,2569,0,1477,2915,177,0,8662,1488,2421,0,1336,1697,162,0,7104
2013,Chad,Djabal : Point,2090,2117,0,1634,4395,397,0,10633,2151,2171,0,1669,2711,300,0,9002
2013,Chad,Bredjing : Point,3550,3856,0,3193,9546,1136,0,21281,3595,3908,0,3303,6893,817,0,18516
2013,Chad,Belome : Point,2301,3108,0,2229,4818,399,0,12855,2361,2992,0,2101,3391,249,0,11094
2013,Chad,Bekourou : Point,178,180,0,78,264,12,0,712,203,179,0,74,173,8,0,637
2013,Chad,Amboko : Point,706,1336,0,1449,2167,119,0,5777,666,1270,0,1348,1551,114,0,4949
2013,Chad,Am Nabak : Point,1920,2963,0,2622,6250,596,0,14351,2000,2878,0,2156,2714,414,0,10162
2013,Chad,Abgadam : Point,2966,3625,0,2010,4036,354,0,12991,2965,3184,0,1094,1485,195,0,8923
2013,Togo,Tandjoare : Prefecture,1205,1433,0,626,2209,306,0,5779,1159,1517,0,485,295,48,0,3504
2013,Togo,Sotouboua : Prefecture,679,899,0,265,1374,146,0,3363,667,1001,0,448,937,141,0,3194
2013,Togo,Lome : Commune,91,111,0,108,461,10,0,781,102,118,0,107,672,22,0,1021
2013,Togo,Dankpen : Prefecture,169,252,0,120,397,63,0,1001,178,273,0,139,276,39,0,905
2013,Togo,Avepozo,97,107,0,53,421,6,0,684,94,94,0,64,552,6,0,810
2013,Thailand,Umpium : Point,487,770,0,710,2753,274,0,4994,546,820,0,692,2701,230,0,4989
2013,Thailand,Tham Hin : Point,289,400,0,272,1126,133,0,2220,303,418,0,271,1046,132,0,2170
2013,Thailand,Nu Po : Point,499,745,0,501,2096,234,0,4075,521,737,0,522,1930,223,0,3933
2013,Thailand,Mai Nai Soi : Point,572,978,0,592,2473,313,0,4928,612,1026,0,542,2565,301,0,5046
2013,Thailand,Mae Sot,0,13,0,11,75,2,0,101,2,6,0,10,127,3,0,148
2013,Thailand,Mae La Oon : Point,632,734,0,540,2217,241,0,4364,641,773,0,570,2257,261,0,4502
2013,Thailand,Mae La : Point,1393,2203,0,1891,6764,852,0,13103,1445,2284,0,1925,6005,782,0,12441
2013,Thailand,Ban Don Yang : Point,166,235,0,150,681,64,0,1296,171,244,0,161,565,68,0,1209
2013,Thailand,Mae Ra Ma Luang : Point,604,797,0,607,2092,231,0,4331,606,785,0,606,1944,288,0,4229
2013,Thailand,Bangkok : Metropolitan administration,211,282,0,139,1022,59,0,1713,202,296,0,175,1654,72,0,2399
2013,Thailand,Ban Mae Surin : Point,106,110,0,86,401,49,0,752,98,114,0,96,378,53,0,739
2013,Tajikistan,Tajikistan : Dispersed in the country / territory,0,0,0,0,4,0,0,4,2,0,0,0,5,0,0,7
2013,Tajikistan,Dushanbe : Capital city,2,3,0,9,39,1,0,54,1,14,0,7,41,1,0,64
2013,Turkmenistan,Mary : Region,0,0,0,0,0,0,0,0,0,0,0,0,1,0,0,1
2013,Turkmenistan,Turkmenbashi : District,0,0,0,0,5,4,0,9,0,0,0,0,4,0,0,4
2013,Turkmenistan,Turkmenabat : District,0,0,0,1,8,0,0,9,0,0,0,0,8,0,0,8
2013,Turkmenistan,Ashgabat : Capital city,0,0,0,0,5,2,0,7,0,0,0,0,7,0,0,7
2013,Timor-Leste,Dili : District,0,0,0,0,0,0,0,0,0,0,0,0,2,0,0,2
2013,Tonga,Nuku'alofa : Point,1,0,0,0,0,0,0,1,1,0,0,0,1,0,0,2
2013,Trinidad and Tobago,Port of Spain : Municipality,0,2,0,2,9,0,0,13,1,2,0,3,42,1,0,49
2013,Tunisia,Shousha : Point,2,2,0,0,15,0,0,19,5,1,0,3,78,2,0,89
2013,Tunisia,Nabeul,0,0,0,0,0,0,0,0,0,0,0,0,2,0,0,2
2013,Tunisia,Kef,0,0,0,0,0,0,0,0,0,0,0,0,1,0,0,1
2013,Tunisia,Kasserine,0,0,0,0,0,0,0,0,0,0,0,0,2,0,0,2
2013,Tunisia,Jendouba,0,1,0,0,0,0,0,1,1,0,0,0,1,0,0,2
2013,Tunisia,Zarzis : Mutamadiyah - Delegation,2,1,0,1,12,0,0,16,2,1,0,1,19,0,0,23
2013,Tunisia,Tunis : Wilayah - Governorate,15,14,0,5,104,9,0,147,13,13,0,20,207,6,0,259
2013,Tunisia,Sousse : Wilayah - Governorate,1,3,0,2,7,1,0,14,0,2,0,1,14,3,0,20
2013,Tunisia,Sfax : Wilayah - Governorate,0,4,0,0,3,0,0,7,2,1,0,2,6,0,0,11
2013,Tunisia,Monastir : Mutamadiyah - Delegation,0,0,0,0,1,0,0,1,0,0,0,0,4,0,0,4
2013,Tunisia,Medenine : Wilayah - Governorate,6,0,0,1,28,0,0,35,5,0,0,11,140,0,0,156
2013,Tunisia,Bizerte : Wilayah - Governorate,1,0,0,1,1,0,0,3,0,1,0,1,3,0,0,5
2013,Tunisia,Ben Gardane : Mutamadiyah - Delegation,8,19,0,5,42,1,0,75,10,22,0,18,149,3,0,202
2013,Turkey,Zonguldak,0,3,0,2,9,1,0,15,1,5,0,3,10,0,0,19
2013,Turkey,Yozgat Camp,2,8,0,7,12,0,0,29,1,6,0,9,4,0,0,20
2013,Turkey,Yozgat : Province,32,65,0,42,226,26,0,391,33,41,0,58,269,21,0,422
2013,Turkey,Yalova : Province,25,58,0,44,249,16,0,392,34,48,0,33,308,17,0,440
2013,Turkey,Van : Province,9,13,0,20,90,0,0,132,7,22,0,42,168,3,0,242
2013,Turkey,Usak : Province,25,44,0,22,131,7,0,229,21,45,0,37,197,10,0,310
2013,Turkey,Trabzon,0,2,0,0,2,0,0,4,1,0,0,1,8,0,0,10
2013,Turkey,Tokat : Province,40,50,0,52,232,11,0,385,43,64,0,62,316,15,0,500
2013,Turkey,Tekirdag : Province,1,2,0,1,4,0,0,8,0,3,0,3,6,1,0,13
2013,Turkey,Sivas : Province,29,48,0,44,173,5,0,299,20,58,0,53,253,8,0,392
2013,Turkey,Sirnak : Province,4,6,0,3,14,0,0,27,1,3,0,3,23,0,0,30
2013,Turkey,Sinop : Province,1,1,0,0,7,0,0,9,2,0,0,2,7,1,0,12
2013,Turkey,Siirt : Province,4,18,0,8,44,0,0,74,6,13,0,10,58,2,0,89
2013,Turkey,Sanliurfa : Province,5,8,0,6,25,0,0,44,7,16,0,12,40,0,0,75
2013,Turkey,Samsun,29,45,0,24,127,11,0,236,42,49,0,33,200,8,0,332
2013,Turkey,Sakarya : Province,70,121,0,83,430,27,0,731,89,133,0,115,544,34,0,915
2013,Turkey,Ordu,0,2,0,0,2,0,0,4,0,0,0,0,1,0,0,1
2013,Turkey,Nigde : Province,21,38,0,47,257,16,0,379,26,48,0,40,345,25,0,484
2013,Turkey,Nevsehir : Province,18,43,0,29,230,6,0,326,28,41,0,68,386,7,0,530
2013,Turkey,Mugla,0,0,0,0,1,0,0,1,0,0,0,0,0,0,0,0
2013,Turkey,Mersin : Province,47,82,0,60,283,23,0,495,48,86,0,60,358,15,0,567
2013,Turkey,Mardin : Province,5,22,0,12,39,1,0,79,5,21,0,17,56,1,0,100
2013,Turkey,Manisa : Province,1,4,0,0,19,3,0,27,4,3,0,2,23,1,0,33
2013,Turkey,Malatya : Province,17,37,0,27,122,2,0,205,16,39,0,40,173,8,0,276
2013,Turkey,Kutahya : Province,24,43,0,34,164,6,0,271,40,50,0,35,195,10,0,330
2013,Turkey,Konya : Province,37,62,0,51,242,7,0,399,43,58,0,61,331,9,0,502
2013,Turkey,Kirsehir : Province,66,101,0,54,315,44,0,580,59,108,0,81,428,34,0,710
2013,Turkey,Kirklareli : Province,0,3,0,4,13,2,0,22,2,7,0,4,12,1,0,26
2013,Turkey,Kirikkale : Province,40,49,0,31,185,8,0,313,41,52,0,40,239,6,0,378
2013,Turkey,Kilis : Province,0,0,0,0,0,0,0,0,0,0,0,0,3,0,0,3
2013,Turkey,Kayseri : Province,99,148,0,140,843,40,0,1270,94,206,0,160,1080,44,0,1584
2013,Turkey,Kastamonu : Province,24,32,0,31,131,7,0,225,19,35,0,40,217,6,0,317
2013,Turkey,Kars : Province,26,43,0,27,94,2,0,192,12,55,0,37,115,0,0,219
2013,Turkey,Karaman : Province,6,19,0,17,66,2,0,110,15,18,0,17,79,3,0,132
2013,Turkey,Karabuk,2,4,0,7,16,3,0,32,5,3,0,7,34,0,0,49
2013,Turkey,Izmit : Point,0,0,0,0,1,0,0,1,0,0,0,0,3,0,0,3
2013,Turkey,Izmir : Province,4,5,0,8,35,0,0,52,1,9,0,5,68,1,0,84
2013,Turkey,Istanbul : Province,73,135,0,130,733,31,0,1102,80,161,0,289,1341,45,0,1916
2013,Turkey,Isparta : Province,26,75,0,57,258,10,0,426,55,73,0,64,270,8,0,470
2013,Turkey,Igdir : Province,0,0,0,0,1,0,0,1,0,0,0,0,3,0,0,3
2013,Turkey,Hatay : Province,4,10,0,7,26,1,0,48,7,5,0,4,53,0,0,69
2013,Turkey,Hakkari : Province,0,0,0,0,0,0,0,0,0,0,0,0,2,0,0,2
2013,Turkey,Gumushane : Province,4,9,0,10,38,1,0,62,6,10,0,20,61,2,0,99
2013,Turkey,Giresun,0,1,0,1,3,0,0,5,0,0,0,3,5,0,0,8
2013,Turkey,Gaziantep : Province,37,95,0,72,266,12,0,482,47,87,0,69,382,14,0,599
2013,Turkey,Eskisehir : Province,38,76,0,68,401,22,0,605,49,101,0,88,500,21,0,759
2013,Turkey,Erzurum : Province,18,50,0,43,148,2,0,261,10,56,0,41,178,8,0,293
2013,Turkey,Erzincan : Province,9,40,0,21,72,2,0,144,14,42,0,24,114,3,0,197
2013,Turkey,Elazig,1,0,0,0,2,0,0,3,0,1,0,2,10,0,0,13
2013,Turkey,Edirne : Province,1,2,0,0,1,0,0,4,0,0,0,0,5,0,0,5
2013,Turkey,Duzce : Province,61,79,0,52,293,22,0,507,63,100,0,72,492,23,0,750
2013,Turkey,Denizli : Province,37,39,0,34,233,7,0,350,23,57,0,34,397,11,0,522
2013,Turkey,Corum : Province,46,75,0,55,273,24,0,473,42,86,0,79,328,19,0,554
2013,Turkey,Cankiri : Province,11,22,0,19,74,6,0,132,9,18,0,24,124,6,0,181
2013,Turkey,Canakkale : Province,0,5,0,3,23,1,0,32,3,5,0,4,50,3,0,65
2013,Turkey,Bursa : Province,0,2,0,1,3,1,0,7,1,0,0,1,3,0,0,5
2013,Turkey,Burdur : Province,26,53,0,61,267,7,0,414,29,51,0,161,304,6,0,551
2013,Turkey,Bolu : Province,25,40,0,27,129,6,0,227,24,49,0,39,177,10,0,299
2013,Turkey,Bilecik : Province,21,12,0,23,114,9,0,179,13,36,0,18,159,10,0,236
2013,Turkey,Bayburt : Province,11,22,0,9,44,1,0,87,5,17,0,9,60,1,0,92
2013,Turkey,Batman : Province,12,31,0,35,92,3,0,173,13,41,0,30,109,3,0,196
2013,Turkey,Balikesir : Province,16,31,0,35,171,2,0,255,23,50,0,67,160,5,0,305
2013,Turkey,Ardahan : Province,2,10,0,9,15,2,0,38,1,6,0,9,23,0,0,39
2013,Turkey,Antalya : Province,0,0,0,0,0,0,0,0,0,0,0,0,1,0,0,1
2013,Turkey,Ankara : Province,22,45,0,41,262,14,0,384,17,41,0,56,391,14,0,519
2013,Turkey,Amasya : Province,59,71,0,53,223,20,0,426,59,75,0,68,319,18,0,539
2013,Turkey,Aksaray : Province,50,84,0,56,248,14,0,452,29,79,0,84,342,10,0,544
2013,Turkey,Agri : Province,14,28,0,39,111,4,0,196,18,55,0,62,178,6,0,319
2013,Turkey,Adiyaman : Province,1,0,0,0,5,0,0,6,7,2,0,3,6,0,0,18
2013,Turkey,Adana : Province,53,134,0,85,488,20,0,780,66,136,0,130,683,24,0,1039
2013,Turkey,Turkey : Dispersed in the country / territory,4,1,0,3,10,2,0,20,1,4,0,19,31,1,0,56
2013,Turkey,Kahramanmaras : Province,13,32,0,20,77,3,0,145,11,25,0,17,82,0,0,135
2013,Turkey,Afyonkarahisar : Province,52,76,0,62,309,18,0,517,46,95,0,85,414,19,0,659
2013,United Rep. of Tanzania,Ulyankulu : Point,3041,6743,0,4122,10451,881,0,25238,2885,6433,0,4407,9664,672,0,24061
2013,United Rep. of Tanzania,Nyarugusu : Point,5340,7600,0,6072,15974,1011,0,35997,5538,7478,0,6109,13102,896,0,33123
2013,United Rep. of Tanzania,National Milling Co-operation Transit Centre : Point,14,15,0,9,31,2,0,71,8,13,0,13,42,5,0,81
2013,United Rep. of Tanzania,Mishamo : Point,3562,6667,0,5109,11820,1090,0,28248,3505,6721,0,4349,11390,1167,0,27132
2013,United Rep. of Tanzania,Kigoma : Region,1742,2103,0,2009,4554,367,0,10775,1730,2279,0,1993,5028,422,0,11452
2013,United Rep. of Tanzania,Katumba : Point,3622,7867,0,6290,14935,1351,0,34065,3725,7748,0,5617,13858,1403,0,32351
2013,United Rep. of Tanzania,Dar es Salaam : Region,4,2,0,1,4,0,0,11,1,2,0,2,16,0,0,21
2013,United Rep. of Tanzania,Chogo : Point,161,207,0,172,530,42,0,1112,154,230,0,221,354,65,0,1024
2013,Uganda,Rwamanja : Point,7223,6594,0,7894,3353,98,0,25162,7153,6915,0,8125,3595,91,0,25879
2013,Uganda,Rhino Camp : Point,888,1337,0,784,1838,169,0,5016,879,1413,0,990,1183,75,0,4540
2013,Uganda,Oruchinga : Point,627,962,0,1017,110,4,0,2720,613,925,0,862,93,2,0,2495
2013,Uganda,Nakivale : Point,6229,10744,0,11170,1846,44,0,30033,6295,10702,0,10975,1935,31,0,29938
2013,Uganda,Kyangwali : Point,4080,4686,0,4720,4094,237,0,17817,4002,4970,0,5075,3305,188,0,17540
2013,Uganda,Kiryandongo : District,279,493,0,389,1043,96,0,2300,300,493,0,419,862,78,0,2152
2013,Uganda,Kayaka II : Point,2336,2644,0,1895,3809,330,0,11014,2341,2689,0,1896,3507,295,0,10728
2013,Uganda,Kampala : City,2805,3847,0,4184,8930,586,0,20352,2815,3890,0,3880,11917,525,0,23027
2013,Uganda,Adjumani : District,989,1808,0,1226,3117,225,0,7365,999,2021,0,1464,2121,90,0,6695
2013,Uruguay,Montevideo : Department,0,7,0,13,64,8,0,92,2,9,0,12,116,14,0,153
2013,Uzbekistan,Termez : District,0,0,0,0,1,0,0,1,0,0,0,0,7,0,0,7
2013,Uzbekistan,Tashkent : City,4,9,0,8,36,3,0,60,6,5,0,8,48,6,0,73
2013,Venezuela (Bolivarian Republic of),Zulia : Point,21,23,0,30,72,3,0,149,27,32,0,26,84,6,0,175
2013,Venezuela (Bolivarian Republic of),Venezuela : Dispersed in the country / territory,102,235,0,367,1283,56,0,2043,124,286,0,381,1429,77,0,2297
2013,Venezuela (Bolivarian Republic of),Tachira : Point,32,32,0,33,68,5,0,170,27,38,0,38,94,5,0,202
2013,Venezuela (Bolivarian Republic of),Caracas : Point,7,7,0,5,51,1,0,71,9,6,0,5,121,4,0,145
2013,Venezuela (Bolivarian Republic of),Apure : Point,11,16,0,14,33,3,0,77,14,16,0,14,36,4,0,84
2013,British Virgin Islands,British Virgin Islands : Dispersed in the country / territory,0,0,0,0,0,0,0,0,0,0,0,0,3,0,0,3
2013,Vanuatu,Port Vila : Point,0,0,0,1,1,0,0,2,0,0,0,0,1,0,0,1
2013,Yemen,Rada' : District,29,18,0,17,56,5,0,125,25,33,0,32,62,5,0,157
2013,Yemen,Mukalla : Point,292,660,0,362,1875,109,0,3298,286,605,0,343,4135,143,0,5512
2013,Yemen,Al Kharaz : Point,1542,1790,0,1198,3417,131,0,8078,1325,1769,0,1270,4251,123,0,8738
2013,Yemen,Yemen : Dispersed in the country / territory,806,1432,0,6670,28715,121,0,37744,664,768,0,3614,79232,225,0,84503
2013,Yemen,Taizz: Muhafazah - Governorate,81,141,0,124,343,30,0,719,65,153,0,148,622,42,0,1030
2013,Yemen,Shabwah: Muhafazah - Governorate,34,96,0,76,241,12,0,459,30,85,0,66,255,7,0,443
2013,Yemen,Sanaâ€™a: Muhafazah â€“ Governorate,4503,8646,0,5258,22097,1078,0,41582,4648,9459,0,6013,24288,1388,0,45796
2013,Yemen,Sa'dah : Muhafazah - Governorate,4208,14532,0,9288,21224,1092,0,50344,3908,15796,0,11862,19688,1418,0,52672
2013,Yemen,"S,adah : Muhafazah - Governorate",643,3429,0,2349,7132,304,0,13857,684,3685,0,2879,6539,421,0,14208
2013,Yemen,Lahij: Muhafazah â€“ Governorate,95,338,0,233,451,29,0,1146,95,338,0,233,451,29,0,1146
2013,Yemen,Hajjah : Muhafazah - Governorate,2546,12178,0,7569,16801,940,0,40034,2541,12828,0,9302,15946,1191,0,41808
2013,Yemen,Hadramawt: Muhafazah - Governorate,56,198,0,137,264,17,0,672,55,194,0,134,259,16,0,658
2013,Yemen,Dhamar: Muhafazah â€“ Governorate,18,19,0,18,78,2,0,135,17,16,0,16,47,4,0,100
2013,Yemen,Dhamar : Muhafazah - Governorate,125,443,0,305,591,37,0,1501,128,455,0,314,607,38,0,1542
2013,Yemen,Amran : Muhafazah - Governorate,1468,6228,0,3944,9322,526,0,21488,1510,6507,0,4390,7450,573,0,20430
2013,Yemen,Al-Bayda: Muhafazah â€“ Governorate,8,34,0,33,86,7,0,168,14,23,0,23,92,2,0,154
2013,Yemen,Al-Bayda : Muhafazah - Governorate,222,785,0,542,1047,66,0,2662,229,811,0,560,1082,69,0,2751
2013,Yemen,Al Maharah: Muhafazah â€“ Governorate,147,170,0,76,416,8,0,817,131,162,0,66,1008,17,0,1384
2013,Yemen,Al Jawf : Muhafazah - Governorate,838,3592,0,2264,5504,302,0,12500,888,3880,0,2612,4476,342,0,12198
2013,Yemen,Al Hudaydah: Muhafazah - Governorate,20,40,0,41,109,24,0,234,19,55,0,55,104,19,0,252
2013,Yemen,Aden: Muhafazah â€“ Governorate,829,1665,0,1480,29812,343,0,34129,750,1663,0,1597,12432,410,0,16852
2013,Yemen,Abyan: Muhafazah â€“ Governorate,2266,5074,0,4084,19428,2292,0,33144,2599,5386,0,4507,17468,2025,0,31985
2013,Zambia,Meheba : Point,1402,2022,0,1421,3383,319,0,8547,1386,2061,0,1287,4014,511,0,9259
2013,Zambia,Mayukwayukwa : Point,972,1300,0,813,2348,148,0,5581,989,1235,0,848,2384,329,0,5785
2013,Zambia,Lusaka : District,352,774,0,597,2014,138,0,3875,423,755,0,697,3236,147,0,5258
2013,Zambia,Zambia : Dispersed in the country / territory,584,1437,0,1054,2634,248,0,5957,515,1422,0,1077,3309,420,0,6743
2013,Zimbabwe,Tongogara : Point,474,627,0,435,974,26,0,2536,478,674,0,538,1144,32,0,2866
2013,Zimbabwe,Harare : City,63,104,0,60,244,4,0,475,61,99,0,87,353,9,0,609
2014,Aruba,Aruba : Dispersed in the country / territory,0,0,0,0,1,0,0,1,0,0,0,0,4,0,0,4
2014,Afghanistan,Badakhshan,10,15,0,12,41,2,0,80,10,15,0,12,36,4,0,77
2014,Afghanistan,Zabul : Wilayat - Province,1145,1310,0,1380,2630,474,0,6939,1121,1295,0,1375,2586,506,0,6883
2014,Afghanistan,Wardak : Wilayat - Province,2422,2765,0,2924,5505,1011,0,14627,2371,2730,0,2914,5425,1076,0,14516
2014,Afghanistan,Uruzgan : Wilayat - Province,1935,2186,0,2332,4273,825,0,11551,1891,2156,0,2337,4241,869,0,11494
2014,Afghanistan,Urozgan : Wilayat - Province,9,13,0,12,36,2,0,72,9,14,0,10,32,3,0,68
2014,Afghanistan,Takhar : Wilayat - Province,255,355,0,312,947,56,0,1925,262,363,0,286,846,91,0,1848
2014,Afghanistan,Sar-e Pul : Wilayat - Province,84,120,0,103,334,15,0,656,86,123,0,93,294,28,0,624
2014,Afghanistan,Sar-e Pol : Wilayat - Province,1323,1565,0,1600,3325,508,0,8321,1305,1557,0,1573,3201,567,0,8203
2014,Afghanistan,Samangan : Wilayat - Province,144,182,0,176,426,46,0,974,143,181,0,166,396,59,0,945
2014,Afghanistan,Parwan : Wilayat - Province,767,947,0,926,2160,261,0,5061,763,949,0,897,2029,313,0,4951
2014,Afghanistan,Panjshir : Wilayat - Province,26,38,0,31,105,5,0,205,27,39,0,29,93,9,0,197
2014,Afghanistan,Panjsher : Wilayat - Province,106,122,0,128,241,45,0,642,104,120,0,129,238,47,0,638
2014,Afghanistan,Paktya : Wilayat - Province,1003,1302,0,1171,2951,297,0,6724,1006,1298,0,1154,2729,378,0,6565
2014,Afghanistan,Paktika : Wilayat - Province,5419,6925,0,6213,19696,857,0,39110,5412,7652,0,5481,17493,1597,0,37635
2014,Afghanistan,Paktia : Wilayat - Province,225,324,0,276,897,40,0,1762,233,333,0,248,792,75,0,1681
2014,Afghanistan,Nuristan : Wilayat - Province,495,564,0,600,1122,207,0,2988,485,558,0,596,1107,220,0,2966
2014,Afghanistan,Nimruz : Wilayat - Province,25,35,0,31,98,4,0,193,25,36,0,27,86,8,0,182
2014,Afghanistan,Nimroz : Wilayat - Province,41,47,0,50,92,17,0,247,40,46,0,49,90,19,0,244
2014,Afghanistan,Nangarhar : Wilayat - Province,11085,13433,0,13367,30126,3886,0,71897,10991,13505,0,12962,28457,4563,0,70478
2014,Afghanistan,Logar : Wilayat - Province,1598,1928,0,1934,4235,582,0,10277,1584,1924,0,1887,4030,671,0,10096
2014,Afghanistan,Laghman : Wilayat - Province,1150,1464,0,1392,3495,356,0,7857,1152,1476,0,1330,3232,453,0,7643
2014,Afghanistan,Kunduz : Wilayat - Province,2362,3075,0,2865,7568,676,0,16546,2380,3109,0,2708,6933,906,0,16036
2014,Afghanistan,Kunar : Wilayat - Province,3960,4853,0,4707,10459,1394,0,25373,3929,4821,0,4653,9924,1617,0,24944
2014,Afghanistan,Khost : Wilayat - Province,15470,19777,0,17740,56236,2452,0,111675,15455,21843,0,15653,49947,4561,0,107459
2014,Afghanistan,Kapisa : Wilayat - Province,707,833,0,858,1753,274,0,4425,698,828,0,843,1695,304,0,4368
2014,Afghanistan,Kandahar : Wilayat - Province,5126,6028,0,6194,12681,1996,0,32025,5052,5989,0,6106,12251,2212,0,31610
2014,Afghanistan,Kabul : Wilayat - Province,5610,7175,0,6802,17200,1719,0,38506,5631,7229,0,6492,15901,2204,0,37457
2014,Afghanistan,Jawzjan : Wilayat - Province,1342,1601,0,1621,3446,506,0,8516,1328,1594,0,1592,3302,571,0,8387
2014,Afghanistan,Hirat : Wilayat - Province,8011,9054,0,9659,17711,3414,0,47849,7828,8930,0,9671,17572,3594,0,47595
2014,Afghanistan,Hilmand : Wilayat - Province,221,318,0,270,879,40,0,1728,228,325,0,243,776,73,0,1645
2014,Afghanistan,Herat : Wilayat - Province,2314,2863,0,2806,6543,785,0,15311,2305,2868,0,2708,6149,944,0,14974
2014,Afghanistan,Helmand : Wilayat - Province,10555,12006,0,12733,23764,4438,0,63496,10329,11853,0,12716,23475,4707,0,63080
2014,Afghanistan,Ghor : Wilayat - Province,3209,3626,0,3869,7090,1367,0,19161,3135,3576,0,3872,7034,1439,0,19056
2014,Afghanistan,Ghazni : Wilayat - Province,3425,3917,0,4131,7837,1421,0,20731,3354,3873,0,4118,7712,1518,0,20575
2014,Afghanistan,Faryab : Wilayat - Province,3727,4253,0,4494,8467,1557,0,22498,3650,4202,0,4485,8347,1657,0,22341
2014,Afghanistan,Farah : Wilayat - Province,2399,2770,0,2894,5643,974,0,14680,2354,2742,0,2875,5515,1052,0,14538
2014,Afghanistan,Daykundi : Wilayat - Province,25,35,0,31,93,6,0,190,26,36,0,29,83,9,0,183
2014,Afghanistan,Bamyan: Wilayat - Province,9,13,0,11,37,2,0,72,10,14,0,10,32,3,0,69
2014,Afghanistan,Bamyan : Wilayat - Province,57,81,0,66,220,11,0,435,58,83,0,63,196,20,0,420
2014,Afghanistan,Balkh : Wilayat - Province,1890,2312,0,2287,5188,664,0,12341,1878,2312,0,2221,4902,783,0,12096
2014,Afghanistan,Baghlan : Wllayat - Province,473,680,0,578,1883,85,0,3699,488,698,0,520,1664,157,0,3527
2014,Afghanistan,Baghlan : Wilayat - Province,301,388,0,366,943,89,0,2087,302,391,0,346,867,116,0,2022
2014,Afghanistan,Badghis:Wllayet - Province,1,1,0,2,3,0,0,7,1,1,0,1,3,0,0,6
2014,Afghanistan,Badghis : Wllayat - Province,4,6,0,4,15,1,0,30,4,6,0,4,14,1,0,29
2014,Afghanistan,Badghis : Wilayat - Province,2327,2631,0,2804,5149,990,0,13901,2274,2595,0,2808,5110,1043,0,13830
2014,Afghanistan,Badakhshan : Wilayat - Province,213,246,0,259,500,88,0,1306,210,244,0,257,489,94,0,1294
2014,Albania,Tirana Urban : Point,6,3,0,4,20,2,0,35,9,2,0,7,32,1,0,51
2014,Albania,Tirana Camp : Point,0,0,0,1,100,50,0,151,0,0,0,0,250,55,0,305
2014,Albania,Shkoder,0,0,0,2,2,0,0,4,1,0,0,0,3,0,0,4
2014,Albania,Fier,0,0,0,0,0,0,0,0,0,0,0,0,1,0,0,1
2014,Albania,Babrru Centre,1,2,0,3,8,0,0,14,2,4,0,6,7,0,0,19
2014,Albania,Peshkopi : Bashki - Municipality,0,0,0,0,1,0,0,1,0,0,0,0,0,0,0,0
2014,Albania,Mamurras : Bashki - Municipality,0,1,0,0,1,0,0,2,0,2,0,0,0,0,0,2
2014,United Arab Emirates,Abu Dhabi : Emirate,31,46,0,36,192,19,0,324,21,50,0,42,179,17,0,309
2014,Argentina,Argentina : Dispersed in the country / territory,21,72,0,89,1065,320,0,1567,24,86,0,139,1944,599,0,2792
2014,Armenia,Yerevan : City,45,88,0,90,677,208,0,1108,61,84,0,94,753,144,0,1136
2014,Armenia,Vayots Dzor : Marz - Province,0,0,0,0,4,0,0,4,0,0,0,0,1,0,0,1
2014,Armenia,Tavush : Marz - Province,0,0,0,0,4,20,0,24,0,0,0,0,1,2,0,3
2014,Armenia,Syunik : Marz - Province,0,0,0,0,57,18,0,75,0,0,0,0,53,6,0,59
2014,Armenia,Shirak : Marz - Province,0,0,0,0,19,3,0,22,0,0,0,0,16,3,0,19
2014,Armenia,Lori : Marz - Province,0,0,0,0,47,14,0,61,0,0,0,0,40,10,0,50
2014,Armenia,Kotayk : Marz - Province,0,0,0,0,87,56,0,143,0,0,0,0,97,35,0,132
2014,Armenia,Gergharkunik : Marz - Province,0,0,0,0,36,12,0,48,0,0,0,0,42,14,0,56
2014,Armenia,Armavir : Marz - Province,0,0,0,0,51,38,0,89,0,0,0,0,47,17,0,64
2014,Armenia,Ararat : Marz - Province,0,0,0,0,35,33,0,68,0,0,0,0,47,39,0,86
2014,Armenia,Aragatsotn : Marz - Province,1,0,0,0,39,18,0,58,0,0,0,0,32,10,0,42
2014,Azerbaijan,Baku : Municipality,53,91,0,80,301,26,0,551,60,89,0,86,545,25,0,805
2014,Burundi,Musasa : Point,564,1016,0,547,1405,69,0,3601,603,958,0,627,1177,35,0,3400
2014,Burundi,Kinama: Point,789,1297,0,832,2009,101,0,5028,758,1354,0,850,1747,59,0,4768
2014,Burundi,Kavumu: Point,786,958,0,487,1344,51,0,3626,810,963,0,454,978,39,0,3244
2014,Burundi,Bwagiriza : Point,853,1231,0,705,1982,99,0,4870,892,1310,0,720,1586,102,0,4610
2014,Burundi,Butare : Point,5,8,0,1,7,1,0,22,2,7,0,3,16,1,0,29
2014,Burundi,Bujumbura: Town,1301,2359,0,1983,5732,326,0,11701,1293,2295,0,2003,5249,248,0,11088
2014,Burundi,Burundi : Dispersed in the country / territory,5821,7561,0,6165,17815,1430,0,38792,5670,7345,0,6770,20488,3040,0,43313
2014,Benin,Benin : Dispersed in the country / territory,18,30,0,34,145,7,0,234,24,35,0,29,155,6,0,249
2014,Burkina Faso,Mentao : Point,984,1394,0,588,2480,245,0,5691,1009,1437,0,632,1933,251,0,5262
2014,Burkina Faso,Goudebo : Point,668,1255,0,574,2159,180,0,4836,647,1279,0,593,1807,241,0,4567
2014,Burkina Faso,Dori,0,2,0,0,0,0,0,2,0,1,0,0,0,0,0,1
2014,Burkina Faso,Sag-Nioniogo : Point,139,207,0,107,426,34,0,913,135,245,0,153,356,43,0,932
2014,Burkina Faso,Ouagadougou : Point,40,67,0,40,187,4,0,338,35,50,0,59,261,13,0,418
2014,Burkina Faso,Burkina Faso : Dispersed in the country / territory,723,1108,0,569,1622,92,0,4114,725,1266,0,606,1226,119,0,3942
2014,Burkina Faso,Bobo-Dioulasso : Department,79,160,0,89,278,23,0,629,82,113,0,57,182,18,0,452
2014,Bangladesh,Nayapara : Point,1171,2181,0,1634,4924,256,0,10166,1244,2241,0,1616,3641,271,0,9013
2014,Bangladesh,Kutupalong : Point,811,1528,0,1061,3247,161,0,6808,866,1578,0,1070,2676,178,0,6368
2014,Bangladesh,Rangamati : Zila - District,0,0,0,0,0,0,0,0,0,0,0,0,2,1,0,3
2014,Bangladesh,Narsingdi : Zila - District,0,0,0,0,0,0,0,0,0,0,0,0,1,0,0,1
2014,Bangladesh,Dhaka : Zila - District,2,3,0,2,6,0,0,13,1,1,0,2,13,1,0,18
2014,Bangladesh,Cox's Bazar : Zila - District,0,6,0,4,13,0,0,23,0,4,0,5,15,4,0,28
2014,Bangladesh,Chittagong : Zila - District,0,0,0,0,2,0,0,2,0,0,0,0,2,0,0,2
2014,Bangladesh,Bandarban : Zila - District,1,5,0,4,9,1,0,20,0,2,0,3,13,2,0,20
2014,Bahrain,Bahrain : Dispersed in the country / territory,17,18,0,24,100,7,0,166,23,15,0,19,118,12,0,187
2014,Bahamas,Carmichael Detention Center,0,0,0,0,0,0,0,0,0,0,0,0,1,0,0,1
2014,Bahamas,Bahamas : Dispersed in the country / territory,0,1,0,0,6,0,0,7,0,0,0,0,22,0,0,22
2014,Bosnia and Herzegovina,Republika Srpska : Entity,0,121,0,256,2369,580,0,3326,0,153,0,222,2351,620,0,3346
2014,Bosnia and Herzegovina,Federation of Bosnia and Herzegovina : Entity,0,0,0,3,14,1,0,18,0,2,0,5,35,1,0,43
2014,Bosnia and Herzegovina,Bosnia and Herzegovina : Dispersed in the country / territory,3,10,0,12,47,5,0,77,0,13,0,9,40,2,0,64
2014,Belarus,Horad Minsk : City,14,36,0,36,107,19,0,212,22,32,0,27,228,8,0,317
2014,Belarus,Brest Oblast - Region,0,1,0,1,4,0,0,6,0,1,0,1,13,1,0,16
2014,Belarus,Vitebsk : Oblast - Region,9,16,0,8,58,10,0,101,6,13,0,13,80,6,0,118
2014,Belarus,Mogilev : Oblast - Region,0,1,0,2,17,0,0,20,1,2,0,1,26,0,0,30
2014,Belarus,Minsk : Oblast - Region,4,10,0,9,49,8,0,80,4,14,0,7,53,4,0,82
2014,Belarus,Grodno : Oblast - Region,1,4,0,2,15,3,0,25,0,7,0,4,24,2,0,37
2014,Belarus,Gomel : Oblast - Region,4,9,0,8,28,9,0,58,1,6,0,5,63,5,0,80
2014,Belarus,Brest : Oblast - Region,0,0,0,0,0,0,0,0,0,0,0,0,2,0,0,2
2014,Belize,Belize : Dispersed in the country / territory,7,7,0,10,31,1,0,56,6,5,0,6,45,6,0,68
2014,Bolivia (Plurinational State of),Yapacani : Point,1,1,0,1,4,0,0,7,0,1,0,0,5,0,0,6
2014,Bolivia (Plurinational State of),Tarija : Department,0,0,0,0,1,0,0,1,0,0,0,0,1,0,0,1
2014,Bolivia (Plurinational State of),Sucre : Point,0,0,0,0,0,0,0,0,0,0,0,0,1,0,0,1
2014,Bolivia (Plurinational State of),Santa Cruz : Department,5,0,0,6,18,1,0,30,3,1,0,8,43,1,0,56
2014,Bolivia (Plurinational State of),Palos Blanco : Point,0,1,0,0,2,0,0,3,0,0,0,0,3,0,0,3
2014,Bolivia (Plurinational State of),La Paz : Department,0,8,0,32,202,7,0,249,5,15,0,29,290,9,0,348
2014,Bolivia (Plurinational State of),El Beni : Department,0,0,0,3,0,0,0,3,0,1,0,1,1,0,0,3
2014,Bolivia (Plurinational State of),Cochabamba : Department,1,7,0,6,13,0,0,27,5,5,0,6,23,0,0,39
2014,Brazil,Piaui : Estado - State,0,0,0,0,0,0,0,0,0,0,0,0,1,0,0,1
2014,Brazil,Paraíba,0,0,0,0,1,0,0,1,0,2,0,0,7,0,0,9
2014,Brazil,Pará : Estado - State,0,0,0,0,1,0,0,1,0,0,0,0,32,3,0,35
2014,Brazil,Goias : Estado - State,1,1,0,0,14,0,0,16,1,1,0,1,176,3,0,182
2014,Brazil,Bahia : Estado - State,0,0,0,0,20,1,0,21,0,0,0,0,24,1,0,25
2014,Brazil,Acre : Estado - State,2,10,0,17,198,4,0,231,7,16,0,11,1234,16,0,1284
2014,Brazil,Sao Paulo : Estado - State,38,64,0,45,810,25,0,982,56,87,0,73,4287,42,0,4545
2014,Brazil,Santa Catarina : Estado - State,5,3,0,6,125,0,0,139,5,5,0,6,933,1,0,950
2014,Brazil,Roraima : Estado - State,0,2,0,3,49,1,0,55,2,7,0,1,209,1,0,220
2014,Brazil,Rondonia : Estado - State,0,0,0,0,1,0,0,1,0,0,0,2,10,0,0,12
2014,Brazil,Rio Grande do Sul : Estado - State,3,2,0,2,97,3,0,107,15,5,0,6,629,3,0,658
2014,Brazil,Rio Grande do Norte : Estado - State,0,2,0,4,10,0,0,16,1,0,0,1,21,0,0,23
2014,Brazil,Rio de Janeiro : Estado - State,13,29,0,17,466,8,0,533,16,44,0,26,1170,6,0,1262
2014,Brazil,Pernambuco : Estado - State,1,2,0,1,7,0,0,11,0,1,0,0,7,0,0,8
2014,Brazil,Paraná : Estado - State,9,13,0,8,134,6,0,170,17,14,0,16,2782,2,0,2831
2014,Brazil,Minas Gerais : Estado - State,0,0,0,0,30,1,0,31,1,0,0,1,68,2,0,72
2014,Brazil,Mato Grosso do Sul : Estado - State,1,3,0,4,23,0,0,31,1,4,0,5,67,1,0,78
2014,Brazil,Mato Grosso : Estado - State,0,1,0,0,9,0,0,10,0,0,0,0,51,1,0,52
2014,Brazil,Maranhao : Estado - State,0,1,0,0,2,0,0,3,0,0,0,0,8,0,0,8
2014,Brazil,Espirito Santo : Estado - State,0,6,0,3,25,3,0,37,1,4,0,6,146,4,0,161
2014,Brazil,Distrito Federal : Distrito Federal - Federal district,4,7,0,10,178,2,0,201,16,16,0,11,951,8,0,1002
2014,Brazil,Ceará : Estado - State,2,1,0,3,32,0,0,38,1,0,0,2,73,2,0,78
2014,Brazil,Brazil : Estado - State,0,0,0,0,8,0,0,8,0,0,0,0,12,0,0,12
2014,Brazil,Brazil : Dispersed in the country / territory,61,110,0,105,8313,28,0,8617,92,312,0,114,21932,62,0,22512
2014,Brazil,Amazonas : Estado - State,4,15,0,10,135,11,0,175,9,13,0,18,434,9,0,483
2014,Brazil,Amapá : Estado - State,0,0,0,0,0,1,0,1,0,0,0,0,7,0,0,7
2014,Barbados,Barbados : Dispersed in the country / territory,0,0,0,0,0,0,0,0,0,0,0,0,1,0,0,1
2014,Botswana,Dukwi : Point,164,214,0,145,474,13,0,1010,176,212,0,117,1286,46,0,1837
2014,Central African Rep.,Batalimo,9,19,0,11,27,5,0,71,18,10,0,6,39,2,0,75
2014,Central African Rep.,Zemio : Sous-prefecture,315,310,0,169,834,80,0,1708,397,331,0,162,717,73,0,1680
2014,Central African Rep.,Haut-Mbomou: Obo/Mboki,55,87,0,34,128,13,0,317,71,94,0,37,63,8,0,273
2014,Central African Rep.,Bangui : Commune,146,216,0,155,525,16,0,1058,139,222,0,175,564,20,0,1120
2014,Central African Rep.,Bambari: Pladama-Ouaka,168,265,0,103,392,41,0,969,216,287,0,114,190,25,0,832
2014,Canada,Canada : Dispersed in the country / territory,876,1193,0,828,7842,742,0,11481,838,1258,0,956,10678,447,0,14177
2014,Switzerland,Switzerland : Dispersed in the country / territory,2043,2540,0,1771,12045,764,0,19163,2117,2701,0,2652,20262,510,0,28242
2014,China,Zhejiang : Province,0,0,0,0,2,0,0,2,0,0,0,0,9,0,0,9
2014,China,Xinjiang,0,0,0,0,0,0,0,0,0,0,0,0,1,0,0,1
2014,China,Tianjin : Municipality,0,1,0,0,1,0,0,2,1,3,0,0,4,0,0,8
2014,China,Shanxi : Province,0,0,0,0,0,0,0,0,0,0,0,0,2,0,0,2
2014,China,Shan Dong : Province,0,1,0,1,1,0,0,3,0,0,0,0,1,0,0,1
2014,China,Shaanxi : Province,0,0,0,0,0,0,0,0,0,0,0,0,1,0,0,1
2014,China,Neimenggu : Province,0,0,0,0,1,0,0,1,0,0,0,0,1,0,0,1
2014,China,Liaoning : Province,0,0,0,0,0,0,0,0,0,0,0,0,1,0,0,1
2014,China,Jiangsu : Province,1,1,0,0,4,0,0,6,3,3,0,0,4,0,0,10
2014,China,Ji Lin : Province,1,0,0,0,2,0,0,3,0,0,0,0,2,0,0,2
2014,China,Hunan : Province,0,0,0,0,1,0,0,1,0,1,0,0,1,0,0,2
2014,China,Hubei : Province,2,0,0,1,24,0,0,27,1,1,0,0,21,0,0,23
2014,China,Hebei : Province,2,1,0,1,34,2,0,40,3,1,0,1,122,2,0,129
2014,China,Hainan : Province,0,0,0,0,0,0,0,0,0,0,0,0,1,0,0,1
2014,China,Guangdong : Province,9,8,0,5,78,0,0,100,7,8,0,6,186,0,0,207
2014,China,Fujian : Province,0,0,0,0,3,0,0,3,0,0,0,0,2,0,0,2
2014,China,Beijing : Municipality,0,3,0,2,9,0,0,14,1,3,0,1,12,0,0,17
2014,China,Guangxi : Autonomous Region,0,0,0,0,0,0,0,0,0,0,0,0,1,0,0,1
2014,China,China : Dispersed in the country / territory,0,0,0,0,0,0,0,0,0,0,0,0,4,0,0,4
2014,Côte d'Ivoire,Tabou : Departement,52,103,0,67,274,6,0,502,35,78,0,69,216,6,0,404
2014,Côte d'Ivoire,Guiglo : Departement,6,10,0,20,45,5,0,86,10,21,0,16,26,2,0,75
2014,Côte d'Ivoire,Abidjan : Departement,38,108,0,71,425,25,0,667,41,130,0,92,618,37,0,918
2014,Cameroon,Zamboi,33,50,0,18,71,4,0,176,31,57,0,18,42,8,0,156
2014,Cameroon,Yokosire : Point,64,153,0,151,335,23,0,726,66,154,0,159,205,36,0,620
2014,Cameroon,Yarmbang : Point,67,196,0,144,297,34,0,738,74,203,0,115,171,23,0,586
2014,Cameroon,Yaounde : Point,819,1250,0,811,3233,96,0,6209,868,1134,0,823,4919,89,0,7833
2014,Cameroon,Yamba : Point,139,339,0,235,507,51,0,1271,141,309,0,225,369,33,0,1077
2014,Cameroon,Woumbou : Point,65,202,0,85,287,10,0,649,77,153,0,107,197,17,0,551
2014,Cameroon,Toktoyo : Point,221,438,0,287,817,46,0,1809,223,443,0,299,563,83,0,1611
2014,Cameroon,Timangolo : Point,602,1026,0,528,1619,100,0,3875,611,1006,0,456,1383,151,0,3607
2014,Cameroon,Tapare : Point,12,34,0,30,54,6,0,136,17,41,0,33,41,7,0,139
2014,Cameroon,Sodepa,14,30,0,15,45,4,0,108,13,27,0,16,33,3,0,92
2014,Cameroon,Sodenou,32,67,0,42,102,5,0,248,33,56,0,46,72,8,0,215
2014,Cameroon,Soa,7,4,0,3,24,0,0,38,6,6,0,3,73,0,0,88
2014,Cameroon,Simi,11,32,0,17,42,5,0,107,11,32,0,19,22,4,0,88
2014,Cameroon,Sangmelima,0,0,0,0,0,0,0,0,0,0,0,0,1,0,0,1
2014,Cameroon,Sandji II,17,32,0,10,46,5,0,110,24,27,0,5,56,0,0,112
2014,Cameroon,Sandji,27,46,0,38,100,5,0,216,21,47,0,42,67,10,0,187
2014,Cameroon,Sandaye : Point,9,31,0,18,49,2,0,109,16,20,0,24,42,4,0,106
2014,Cameroon,Samba : Point,22,58,0,78,133,9,0,300,27,50,0,63,85,15,0,240
2014,Cameroon,Ouro-Adde : Point,79,192,0,149,312,24,0,756,87,209,0,151,212,18,0,677
2014,Cameroon,Obala,0,8,0,6,9,0,0,23,4,3,0,4,10,0,0,21
2014,Cameroon,Nyambaka,7,26,0,15,36,4,0,88,9,29,0,26,18,8,0,90
2014,Cameroon,Nyabi : Point,158,376,0,334,905,49,0,1822,171,323,0,308,590,67,0,1459
2014,Cameroon,Nkolafamba,8,8,0,2,17,1,0,36,8,9,0,6,18,0,0,41
2014,Cameroon,Ngunbela : Point,2,9,0,4,14,1,0,30,2,3,0,7,13,1,0,26
2014,Cameroon,Nguindi : Point,24,50,0,58,121,4,0,257,17,50,0,36,70,11,0,184
2014,Cameroon,Ngazi : Point,8,38,0,21,46,3,0,116,11,26,0,16,36,3,0,92
2014,Cameroon,Ngassiri,0,3,0,2,2,0,0,7,0,0,0,3,1,0,0,4
2014,Cameroon,Ngaoundere,2,6,0,9,12,3,0,32,3,7,0,5,4,0,0,19
2014,Cameroon,Ngaoui : Point,550,1377,0,1163,2451,176,0,5717,592,1452,0,1098,1510,208,0,4860
2014,Cameroon,Ndokayo : Point,513,963,0,658,1597,111,0,3842,464,974,0,611,1133,134,0,3316
2014,Cameroon,Nandoungue : Point,84,183,0,155,304,32,0,758,95,157,0,146,213,31,0,642
2014,Cameroon,Nabemo : Point,48,98,0,89,206,10,0,451,67,121,0,94,153,19,0,454
2014,Cameroon,Monatele,0,2,0,1,0,0,0,3,0,0,0,0,1,0,0,1
2014,Cameroon,Mokolo,0,0,0,0,2,1,0,3,0,2,0,0,0,1,0,3
2014,Cameroon,Moinam,12,18,0,17,37,1,0,85,7,27,0,5,25,6,0,70
2014,Cameroon,Mobe : Point,18,63,0,44,108,6,0,239,28,65,0,54,69,9,0,225
2014,Cameroon,Minawao,2213,2684,0,1647,4122,344,0,11010,2234,2789,0,1485,3397,374,0,10279
2014,Cameroon,Mimbang : Point,0,7,0,5,21,0,0,33,2,3,0,9,23,2,0,39
2014,Cameroon,Mikila : Point,33,95,0,72,164,9,0,373,46,94,0,59,114,12,0,325
2014,Cameroon,Mfou,8,9,0,6,15,0,0,38,4,8,0,5,25,0,0,42
2014,Cameroon,Mengong,0,0,0,0,0,0,0,0,0,0,0,0,1,0,0,1
2014,Cameroon,Mengang,0,0,0,0,0,0,0,0,0,0,0,0,1,0,0,1
2014,Cameroon,Meiganga : Point,220,490,0,450,957,55,0,2172,236,526,0,440,628,83,0,1913
2014,Cameroon,Meidougou : Point,220,555,0,453,1063,70,0,2361,227,598,0,495,691,82,0,2093
2014,Cameroon,Mboumama : Point,109,201,0,140,408,18,0,876,92,215,0,131,292,36,0,766
2014,Cameroon,Mboula : Point,22,67,0,65,137,8,0,299,20,87,0,52,94,19,0,272
2014,Cameroon,Mborguene : Point,22,80,0,69,154,7,0,332,26,81,0,80,141,11,0,339
2014,Cameroon,Mbonga : Point,29,64,0,58,143,4,0,298,28,78,0,54,111,17,0,288
2014,Cameroon,Mbondo : Point,19,85,0,69,141,13,0,327,29,82,0,57,121,14,0,303
2014,Cameroon,Mbomba,3,11,0,12,17,1,0,44,4,12,0,10,10,6,0,42
2014,Cameroon,Mbile : Point,797,1344,0,709,2287,145,0,5282,827,1319,0,664,2164,213,0,5187
2014,Cameroon,Mbewe : Point,7,29,0,21,42,10,0,109,15,20,0,9,31,6,0,81
2014,Cameroon,Mbarang : Point,52,101,0,101,172,16,0,442,68,108,0,69,121,16,0,382
2014,Cameroon,Mbankomo,0,0,0,0,0,0,0,0,0,0,0,0,1,0,0,1
2014,Cameroon,Mbalmayo,1,2,0,1,6,0,0,10,1,5,0,2,5,0,0,13
2014,Cameroon,Maroua,0,2,0,1,9,1,0,13,0,0,0,3,3,1,0,7
2014,Cameroon,Mandjou : Point,334,772,0,602,1333,94,0,3135,338,765,0,567,790,103,0,2563
2014,Cameroon,Lokoti : Point,82,169,0,113,276,17,0,657,66,146,0,123,226,23,0,584
2014,Cameroon,Limbe,0,0,0,0,1,0,0,1,0,0,0,0,3,0,0,3
2014,Cameroon,Kribi,1,0,0,0,1,0,0,2,0,0,0,0,3,0,0,3
2014,Cameroon,Kousseri,0,0,0,0,0,0,0,0,0,0,0,0,1,0,0,1
2014,Cameroon,Kounde,4,7,0,4,11,2,0,28,4,6,0,5,4,1,0,20
2014,Cameroon,Kouba : Point,20,69,0,54,113,8,0,264,17,55,0,44,66,16,0,198
2014,Cameroon,Kombo Laka : Point,51,146,0,113,267,19,0,596,55,179,0,96,229,32,0,591
2014,Cameroon,Kole : Point,15,50,0,51,114,10,0,240,17,55,0,51,53,4,0,180
2014,Cameroon,Kette : Point,313,550,0,394,1079,48,0,2384,289,652,0,305,728,92,0,2066
2014,Cameroon,Kenzou : Point,673,1192,0,846,2398,123,0,5232,652,1207,0,779,1863,183,0,4684
2014,Cameroon,Kambele,10,32,0,20,39,7,0,108,19,23,0,12,37,5,0,96
2014,Cameroon,Goundjel : Point,0,4,0,4,11,0,0,19,0,1,0,3,13,0,0,17
2014,Cameroon,Goro,33,95,0,85,142,10,0,365,24,86,0,70,117,19,0,316
2014,Cameroon,Gomana,10,31,0,32,50,2,0,125,17,43,0,22,25,3,0,110
2014,Cameroon,Gbiti : Point,905,1700,0,1150,3363,152,0,7270,854,1683,0,1073,2644,283,0,6537
2014,Cameroon,Gbakim : Point,17,38,0,50,111,2,0,218,26,27,0,42,100,6,0,201
2014,Cameroon,Gbabio,0,0,0,1,2,0,0,3,1,1,0,0,5,0,0,7
2014,Cameroon,Garoua,5,17,0,8,32,2,0,64,4,18,0,9,99,7,0,137
2014,Cameroon,Gargapela : Point,59,157,0,123,240,22,0,601,89,149,0,110,137,18,0,503
2014,Cameroon,Garga Sarali : Point,82,106,0,89,267,19,0,563,61,147,0,100,220,21,0,549
2014,Cameroon,Garga Libona : Point,74,184,0,151,379,28,0,816,70,213,0,177,245,27,0,732
2014,Cameroon,Gandinang : Point,0,1,0,1,6,1,0,9,2,3,0,1,3,0,0,9
2014,Cameroon,Gado Badzere : Point,1538,2530,0,1186,4014,219,0,9487,1567,2388,0,1030,2963,309,0,8257
2014,Cameroon,Fada : Point,27,56,0,49,124,5,0,261,26,64,0,42,89,14,0,235
2014,Cameroon,Edea,0,0,0,0,1,0,0,1,0,0,0,0,0,0,0,0
2014,Cameroon,Ebolowa,1,2,0,1,0,0,0,4,0,0,0,0,4,0,0,4
2014,Cameroon,Dschang,0,1,0,1,0,0,0,2,0,0,0,2,1,0,0,3
2014,Cameroon,Douala : Point,583,799,0,518,2439,67,0,4406,557,757,0,517,3503,48,0,5382
2014,Cameroon,Djohong : Point,20,68,0,50,117,6,0,261,20,58,0,40,100,11,0,229
2014,Cameroon,Djaoro Mone,43,83,0,62,116,9,0,313,26,91,0,42,64,6,0,229
2014,Cameroon,Djalingo : Point,23,43,0,36,94,11,0,207,15,47,0,55,72,7,0,196
2014,Cameroon,Dir : Point,9,33,0,17,62,1,0,122,6,25,0,28,33,6,0,98
2014,Cameroon,Digou Adamou : Point,1,4,0,4,12,1,0,22,0,8,0,8,10,3,0,29
2014,Cameroon,Dang Patou : Point,47,87,0,71,181,9,0,395,30,90,0,67,120,11,0,318
2014,Cameroon,Damissa,54,125,0,59,184,9,0,431,65,130,0,67,147,15,0,424
2014,Cameroon,Colomine,24,48,0,39,73,6,0,190,20,48,0,38,59,5,0,170
2014,Cameroon,Buea,0,0,0,0,0,0,0,0,0,0,0,0,2,0,0,2
2014,Cameroon,Bouli : Point,51,89,0,80,188,14,0,422,40,82,0,69,139,10,0,340
2014,Cameroon,Boulembe : Point,39,125,0,126,214,15,0,519,51,109,0,110,160,17,0,447
2014,Cameroon,Boubara : Point,64,126,0,119,318,24,0,651,51,130,0,113,236,29,0,559
2014,Cameroon,Borgop : Point,942,1503,0,670,2188,175,0,5478,978,1443,0,562,1595,194,0,4772
2014,Cameroon,Bombe Pana,42,93,0,65,148,5,0,353,41,93,0,78,110,11,0,333
2014,Cameroon,Boforo,34,73,0,61,133,8,0,309,29,102,0,66,60,9,0,266
2014,Cameroon,Bigoro,28,43,0,36,89,6,0,202,28,46,0,54,64,9,0,201
2014,Cameroon,Betare Oya : Point,20,17,0,7,75,0,0,119,15,16,0,3,38,1,0,73
2014,Cameroon,Belabo,1,1,0,1,2,0,0,5,1,3,0,4,2,0,0,10
2014,Cameroon,Beke Chantier,27,41,0,17,64,1,0,150,25,56,0,17,53,10,0,161
2014,Cameroon,Bedobo : Point,54,130,0,104,267,14,0,569,49,112,0,80,184,17,0,442
2014,Cameroon,Bazzama : Point,45,96,0,90,195,13,0,439,32,75,0,92,128,13,0,340
2014,Cameroon,Batouri,3,9,0,10,29,0,0,51,12,14,0,10,50,2,0,88
2014,Cameroon,Baham,0,0,0,0,4,0,0,4,0,0,0,0,1,0,0,1
2014,Cameroon,Bagodo : Point,18,84,0,78,180,7,0,367,16,91,0,92,129,19,0,347
2014,Cameroon,Bafouck : Point,56,126,0,98,219,14,0,513,56,114,0,69,188,23,0,450
2014,Cameroon,Bafia,0,0,0,0,0,0,0,0,0,0,0,0,1,0,0,1
2014,Cameroon,Babongo : Point,0,2,0,0,6,0,0,8,0,4,0,4,1,2,0,11
2014,Cameroon,Awae,0,0,0,0,0,0,0,0,0,0,0,0,1,0,0,1
2014,Cameroon,Alhamdou,58,134,0,64,176,8,0,440,64,138,0,64,108,9,0,383
2014,Cameroon,Adinkol : Point,33,70,0,49,112,11,0,275,30,75,0,60,79,13,0,257
2014,Cameroon,Zembe Borongo : Point,143,337,0,311,702,49,0,1542,151,394,0,281,423,68,0,1317
2014,Cameroon,Tongo Gandima : Point,129,338,0,220,576,48,0,1311,145,327,0,244,377,80,0,1173
2014,Cameroon,Ndanga Gandima : Point,49,121,0,76,246,16,0,508,56,101,0,103,172,29,0,461
2014,Cameroon,Guiwa Yangamo : Point,37,135,0,96,230,19,0,517,51,131,0,84,165,25,0,456
2014,Cameroon,Garoua-Boulai : Point,940,2018,0,1591,3963,273,0,8785,903,2010,0,1513,2398,327,0,7151
2014,Cameroon,Dakere Babongo : Point,56,96,0,60,169,11,0,392,44,88,0,64,103,11,0,310
2014,Cameroon,Cameroon : Dispersed in the country / territory,2565,4266,0,1959,6751,425,0,15966,2611,4236,0,1749,5514,561,0,14671
2014,Cameroon,Batoua Godole : Point,178,414,0,347,727,55,0,1721,130,412,0,370,458,63,0,1433
2014,Dem. Rep. of the Congo,Mole,1605,1610,0,888,3002,121,0,7226,1578,1505,0,1150,3629,70,0,7932
2014,Dem. Rep. of the Congo,Mboti,56,40,0,27,98,5,0,226,61,53,0,36,165,10,0,325
2014,Dem. Rep. of the Congo,Inke,1232,1447,0,597,2260,133,0,5669,1310,1465,0,875,1945,79,0,5674
2014,Dem. Rep. of the Congo,Boyabu,1498,1587,0,704,2974,158,0,6921,1500,1486,0,821,2285,70,0,6162
2014,Dem. Rep. of the Congo,Walungu : Territoire,1,11,0,5,35,0,0,52,8,22,0,5,61,0,0,96
2014,Dem. Rep. of the Congo,Uvira : Point,9,695,0,417,1203,109,0,2433,10,617,0,433,1404,93,0,2557
2014,Dem. Rep. of the Congo,Tshopo : District,4654,6045,0,3005,8927,791,0,23422,4641,6032,0,3031,7020,474,0,21198
2014,Dem. Rep. of the Congo,Tshabobo : Point,65,102,0,28,137,5,0,337,37,89,0,31,149,11,0,317
2014,Dem. Rep. of the Congo,Sud-Kivu : Province,71619,93071,0,45801,136938,12143,0,359572,71039,91703,0,46560,108166,7252,0,324720
2014,Dem. Rep. of the Congo,Sud Ubangi,1032,937,0,532,2128,79,0,4708,1101,850,0,715,2665,47,0,5378
2014,Dem. Rep. of the Congo,Shabunda : Point,42,121,0,109,510,1,0,783,32,179,0,146,563,6,0,926
2014,Dem. Rep. of the Congo,Nord-Kivu : Province,103726,137502,0,66526,202145,17775,0,527674,104686,135347,0,68666,159874,10702,0,479275
2014,Dem. Rep. of the Congo,Nord Ubangi,1163,1296,0,981,2345,365,0,6150,1116,1317,0,1229,1597,338,0,5597
2014,Dem. Rep. of the Congo,Mwenga : Territoire,89,144,0,102,368,8,0,711,89,134,0,83,218,10,0,534
2014,Dem. Rep. of the Congo,Mwene Ditu : Point,34,49,0,33,63,8,0,187,33,36,0,36,66,11,0,182
2014,Dem. Rep. of the Congo,Maniema : Province,30039,39467,0,18907,57591,5107,0,151111,29951,38934,0,19567,45370,3057,0,136879
2014,Dem. Rep. of the Congo,Lusuku : Point,19,28,0,12,53,3,0,115,31,33,0,10,57,4,0,135
2014,Dem. Rep. of the Congo,Lubumbashi : Point,48,103,0,57,203,12,0,423,60,108,0,39,247,12,0,466
2014,Dem. Rep. of the Congo,Likasi : City,0,0,0,2,0,1,0,3,0,1,0,1,2,0,0,4
2014,Dem. Rep. of the Congo,Kolwezi,1,3,0,0,4,0,0,8,0,1,0,1,1,0,0,3
2014,Dem. Rep. of the Congo,Kipushi,1,2,0,0,4,2,0,9,1,4,0,0,5,2,0,12
2014,Dem. Rep. of the Congo,Kinshasa : Province,140,202,0,182,600,115,0,1239,134,181,0,182,506,83,0,1086
2014,Dem. Rep. of the Congo,Kimaza : Point,37,51,0,23,96,1,0,208,42,49,0,32,189,16,0,328
2014,Dem. Rep. of the Congo,Katshia : Point,33,48,0,23,66,5,0,175,32,44,0,27,61,8,0,172
2014,Dem. Rep. of the Congo,Katanga : Province,72599,95589,0,45453,142440,12747,0,368828,72873,95347,0,48002,112453,7848,0,336523
2014,Dem. Rep. of the Congo,Kambove : Territoire,0,0,0,0,1,0,0,1,0,0,0,0,0,0,0,0
2014,Dem. Rep. of the Congo,Kalehe : Point,116,123,0,94,383,9,0,725,130,166,0,121,435,33,0,885
2014,Dem. Rep. of the Congo,Kahemba : Point,26,70,0,39,98,25,0,258,36,95,0,40,42,8,0,221
2014,Dem. Rep. of the Congo,Kabare : Point,9,22,0,10,51,2,0,94,9,21,0,8,51,2,0,91
2014,Dem. Rep. of the Congo,Ituri : District,50602,66468,0,32034,97464,8598,0,255166,50446,65716,0,33080,76934,5148,0,231324
2014,Dem. Rep. of the Congo,Isiro : Point,4,3,0,7,14,1,0,29,2,5,0,5,18,0,0,30
2014,Dem. Rep. of the Congo,Ingbokolo : Point,52,73,0,30,177,20,0,352,44,49,0,25,64,10,0,192
2014,Dem. Rep. of the Congo,Haut-Uele : District,11712,15235,0,7577,22477,1994,0,58995,11669,15185,0,7623,17683,1203,0,53363
2014,Dem. Rep. of the Congo,Goma : Point,75,131,0,89,183,2,0,480,71,92,0,81,161,1,0,406
2014,Dem. Rep. of the Congo,Fizi : Point,144,515,0,275,668,77,0,1679,128,503,0,271,679,65,0,1646
2014,Dem. Rep. of the Congo,Equateur : Province,13762,16669,0,8172,25227,2277,0,66107,13811,16739,0,8397,19481,1412,0,59840
2014,Dem. Rep. of the Congo,Dungu : Point,8,3,0,0,14,0,0,25,3,4,0,1,17,4,0,29
2014,Dem. Rep. of the Congo,Doruma : Point,34,24,0,13,54,6,0,131,22,26,0,14,46,9,0,117
2014,Dem. Rep. of the Congo,Dilolo : Point,23,34,0,15,39,3,0,114,18,30,0,6,45,3,0,102
2014,Dem. Rep. of the Congo,Buta : Point,3,5,0,5,12,0,0,25,4,4,0,2,11,1,0,22
2014,Dem. Rep. of the Congo,Bukavu : Point,31,31,0,10,96,3,0,171,31,35,0,29,88,3,0,186
2014,Dem. Rep. of the Congo,Bondo : Point,562,613,0,424,1579,90,0,3268,603,691,0,422,970,85,0,2771
2014,Dem. Rep. of the Congo,Bas-Uele : District,5309,6895,0,3435,10184,912,0,26735,5298,6891,0,3469,8016,548,0,24222
2014,Dem. Rep. of the Congo,Bas-Congo : Province,1662,2110,0,1204,5218,521,0,10715,1761,2183,0,1335,3721,367,0,9367
2014,Dem. Rep. of the Congo,Aru-Wani,58,97,0,43,108,20,0,326,43,87,0,47,9,0,0,186
2014,Dem. Rep. of the Congo,Aru-Offa,14,12,0,4,20,1,0,51,5,11,0,6,2,0,0,24
2014,Dem. Rep. of the Congo,Aru-Loni I,55,92,0,50,126,8,0,331,79,102,0,60,32,0,0,273
2014,Dem. Rep. of the Congo,Aru : Point,0,4,0,1,4,0,0,9,2,4,0,2,6,2,0,16
2014,Dem. Rep. of the Congo,Ariwara : Point,66,111,0,54,138,10,0,379,57,93,0,34,110,16,0,310
2014,Dem. Rep. of the Congo,Aba : Point,5,6,0,3,15,2,0,31,3,11,0,4,15,1,0,34
2014,Congo,Tchiamba-Nza : Point,1,6,0,5,25,1,0,38,1,6,0,5,25,0,0,37
2014,Congo,Sangha : Departement,36,155,0,148,249,8,0,596,33,155,0,149,447,6,0,790
2014,Congo,Pool : Departement,30,96,0,80,139,2,0,347,39,98,0,68,289,3,0,497
2014,Congo,Pointe Noire : Point,45,48,0,23,167,10,0,293,34,74,0,37,396,8,0,549
2014,Congo,Oyo : Point,14,45,0,47,68,3,0,177,11,39,0,51,154,1,0,256
2014,Congo,Okoyo : District,0,3,0,2,2,0,0,7,0,1,0,0,8,0,0,9
2014,Congo,Niari : Departement,0,2,0,2,1,0,0,5,2,0,0,3,5,0,0,10
2014,Congo,Ngo : Point,15,69,0,57,56,1,0,198,20,68,0,37,190,2,0,317
2014,Congo,Malolo : Point,5,38,0,26,88,12,0,169,4,46,0,33,89,12,0,184
2014,Congo,Loukolela : Point,414,568,0,272,894,53,0,2201,393,572,0,260,1130,49,0,2404
2014,Congo,Kondi Mbaka : Point,4,18,0,22,74,4,0,122,2,29,0,29,108,11,0,179
2014,Congo,Komi : Point,2,9,0,6,25,4,0,46,6,5,0,9,29,4,0,53
2014,Congo,Kintele,5,10,0,3,20,0,0,38,8,5,0,4,69,0,0,86
2014,Congo,Impfondo : Point,695,1768,0,1027,3012,331,0,6833,717,1694,0,1008,3312,225,0,6956
2014,Congo,Enyelle,74,62,0,37,250,3,0,426,70,63,0,44,294,2,0,473
2014,Congo,Dolisie: Point,0,0,0,0,1,0,0,1,1,0,0,0,0,0,0,1
2014,Congo,Brazzaville : Capital,510,1009,0,880,2876,94,0,5369,502,1018,0,871,4459,74,0,6924
2014,Congo,Betou : Point,1919,2612,0,1852,4162,239,0,10784,1814,2652,0,2139,4963,162,0,11730
2014,Colombia,Turbo,0,0,0,0,11,0,0,11,0,0,0,0,60,0,0,60
2014,Colombia,Tuluá : Point,0,0,0,0,0,0,0,0,0,0,0,0,1,0,0,1
2014,Colombia,Pasto,0,0,0,0,0,0,0,0,0,0,0,0,2,0,0,2
2014,Colombia,Medellín : Point,0,0,0,0,1,1,0,2,1,0,0,0,13,0,0,14
2014,Colombia,Maicao : Point,0,0,0,0,1,0,0,1,1,0,0,0,0,0,0,1
2014,Colombia,Ibagué : Point,0,0,0,0,1,0,0,1,0,0,0,0,1,0,0,1
2014,Colombia,Duitama : Point,0,0,0,0,1,0,0,1,0,0,0,0,1,0,0,1
2014,Colombia,Cúcuta : Point,1,1,0,1,4,0,0,7,2,0,0,2,17,1,0,22
2014,Colombia,Cartagena : Point,0,0,0,0,1,1,0,2,0,0,0,0,9,0,0,9
2014,Colombia,Cali : Point,0,1,0,1,3,0,0,5,0,2,0,0,5,1,0,8
2014,Colombia,Buenaventura : Point,0,0,0,0,0,0,0,0,0,0,0,0,2,0,0,2
2014,Colombia,Barranquilla,0,0,0,0,1,0,0,1,0,0,0,0,0,0,0,0
2014,Colombia,Barcelona : Point,0,0,0,0,0,0,0,0,0,0,0,0,1,0,0,1
2014,Colombia,Arauca,1,1,0,2,1,0,0,5,2,1,0,0,2,0,0,5
2014,Colombia,Tumaco : Municipality,0,1,0,0,1,0,0,2,0,2,0,0,0,0,0,2
2014,Colombia,San Andres Islas : Department,0,0,0,0,2,0,0,2,0,0,0,0,2,0,0,2
2014,Colombia,Pereira : Municipality,0,0,0,0,1,0,0,1,0,2,0,0,2,0,0,4
2014,Colombia,Leticia : Municipality,0,0,0,0,0,0,0,0,0,0,0,0,1,0,0,1
2014,Colombia,Bogota : Capital district,6,4,0,4,38,10,0,62,5,2,0,5,121,15,0,148
2014,Cuba,Villaclara : Provincia,0,0,0,0,0,0,0,0,0,0,0,0,22,0,0,22
2014,Cuba,Villa Clara : Provincia,0,0,0,0,1,0,0,1,0,0,0,0,1,0,0,1
2014,Cuba,Mayabeque : Provincia,0,0,0,0,0,0,0,0,0,0,0,0,1,0,0,1
2014,Cuba,Matanzas : Provincia,0,1,0,1,1,0,0,3,0,1,0,0,14,0,0,15
2014,Cuba,Las Tunas : Provincia,0,0,0,0,0,0,0,0,0,0,0,0,12,0,0,12
2014,Cuba,La Habana : Provincia,3,1,0,0,14,0,0,18,1,0,0,0,42,0,0,43
2014,Cuba,Holguin : Provincia,0,0,0,0,0,0,0,0,0,0,0,0,24,0,0,24
2014,Cuba,Guantánamo : Provincia,0,0,0,0,0,0,0,0,0,0,0,0,32,0,0,32
2014,Cuba,Granma : Provincia,0,0,0,0,0,0,0,0,0,0,0,0,14,0,0,14
2014,Cuba,Cienfuegos : Provincia,0,0,0,0,1,0,0,1,0,0,0,0,31,0,0,31
2014,Cuba,Camaguey : Provincia,0,0,0,1,1,0,0,2,0,1,0,0,11,0,0,12
2014,Cuba,Artemisa : Provincia,0,0,0,0,0,0,0,0,0,0,0,0,1,0,0,1
2014,Cuba,Santiago de Cuba : Provincia,0,0,0,0,0,0,0,0,0,0,0,0,8,0,0,8
2014,Cuba,Sancti Spiritus : Provincia,0,0,0,0,0,0,0,0,0,0,0,0,11,0,0,11
2014,Cuba,Pinar del Rio : Provincia,0,2,0,1,5,0,0,8,0,0,0,0,18,0,0,18
2014,Cuba,Ciego de Avila : Provincia,0,0,0,0,0,0,0,0,0,0,0,0,13,0,0,13
2014,Curaçao,Curacao : Dispersed in the country / territory,0,3,0,6,27,2,0,38,3,2,0,2,32,1,0,40
2014,Cayman Islands,Grand Cayman,0,0,0,0,2,0,0,2,0,0,0,1,5,0,0,6
2014,Germany,Germany : Dispersed in the country / territory,16785,21353,0,15336,104457,12435,0,170366,18134,23532,0,21560,208993,12496,0,284715
2014,Djibouti,Hol-Hol : Point,111,225,0,146,383,12,0,877,131,248,0,157,301,25,0,862
2014,Djibouti,Djibouti : Point,135,297,0,192,1043,22,0,1689,93,331,0,199,1748,40,0,2411
2014,Djibouti,Ali-Addeh : Point,757,1458,0,1022,5402,230,0,8869,756,1479,0,946,6220,253,0,9654
2014,Dominican Rep.,Dominican Republic : Dispersed in the country / territory,47,101,0,107,398,31,0,684,37,113,0,87,387,46,0,670
2014,Algeria,Algiers : Wilaya - Province,8,6,0,2,31,0,0,47,11,7,0,4,54,0,0,76
2014,Algeria,Algeria : Dispersed in the country / territory,302,278,0,172,863,32,0,1647,324,331,0,258,2270,44,0,3227
2014,Ecuador,Ecuador : Dispersed in the country / territory,437,3437,0,3816,22732,1262,0,31684,468,3406,0,3838,24375,1629,0,33716
2014,Egypt,Suez : Muhafazah - Governorate,10,7,0,48,22,1,0,88,11,17,0,58,22,3,0,111
2014,Egypt,South Sinai : Muhafazah - Governorate,2,1,0,12,6,2,0,23,0,4,0,28,1,3,0,36
2014,Egypt,Sohag : Muhafazah - Governorate,4,2,0,10,3,0,0,19,5,2,0,11,2,1,0,21
2014,Egypt,Red Sea : Muhafazah - Governorate,79,65,0,301,112,23,0,580,76,55,0,359,100,24,0,614
2014,Egypt,Qena : Muhafazah - Governorate,0,2,0,7,2,0,0,11,1,4,0,9,0,0,0,14
2014,Egypt,Port-Said : Muhafazah - Governorate,50,52,0,231,75,23,0,431,66,61,0,234,77,22,0,460
2014,Egypt,North Sinai : Muhafazah - Governorate,4,1,0,11,6,1,0,23,2,2,0,18,4,2,0,28
2014,Egypt,New Valley : Muhafazah - Governorate,2,0,0,2,1,0,0,5,0,1,0,5,2,0,0,8
2014,Egypt,Monofiya : Muhafazah - Governorate,157,121,0,552,183,48,0,1061,157,158,0,580,274,40,0,1209
2014,Egypt,Menia : Muhafazah - Governorate,9,9,0,30,15,1,0,64,8,8,0,46,17,1,0,80
2014,Egypt,Matrouh : Muhafazah - Governorate,62,45,0,212,80,10,0,409,87,47,0,225,86,14,0,459
2014,Egypt,Luxor : Muhafazah - Governorate,1,2,0,6,1,1,0,11,2,1,0,7,1,0,0,11
2014,Egypt,Kalyobiya : Muhafazah - Governorate,953,779,0,3571,1364,254,0,6921,1045,826,0,3841,1386,240,0,7338
2014,Egypt,Kafr El Shiekh : Muhafazah - Governorate,19,26,0,87,40,6,0,178,25,29,0,85,46,11,0,196
2014,Egypt,Ismailia : Muhafazah - Governorate,68,61,0,281,95,15,0,520,71,57,0,322,101,18,0,569
2014,Egypt,Helwan : Muhafazah - Governorate,216,355,0,1922,348,46,0,2887,203,300,0,1531,354,53,0,2441
2014,Egypt,Giza : Muhafazah - Governorate,845,868,0,5065,1110,336,0,8224,846,943,0,5454,1213,296,0,8752
2014,Egypt,Gharbeya : Muhafazah - Governorate,47,38,0,229,74,19,0,407,50,63,0,217,85,19,0,434
2014,Egypt,Fayoum : Muhafazah - Governorate,13,11,0,55,27,4,0,110,13,16,0,47,15,3,0,94
2014,Egypt,El-Beheira : Muhafazah - Governorate,46,30,0,145,61,10,0,292,48,35,0,142,55,14,0,294
2014,Egypt,Egypt : Dispersed in the country / territory,6374,8085,0,5690,13105,880,0,34134,7094,5158,0,10703,14499,595,0,38049
2014,Egypt,Damietta : Muhafazah - Governorate,792,702,0,2937,1044,257,0,5732,814,766,0,2978,1140,205,0,5903
2014,Egypt,Dakahliya : Muhafazah - Governorate,241,227,0,914,324,59,0,1765,250,239,0,989,378,69,0,1925
2014,Egypt,Cairo : Muhafazah - Governorate,2452,2929,0,14654,3985,854,0,24874,2548,3179,0,15476,4261,788,0,26252
2014,Egypt,Beni Suef : Muhafazah - Governorate,12,6,0,23,14,2,0,57,7,9,0,21,13,2,0,52
2014,Egypt,Asyut : Muhafazah - Governorate,10,13,0,50,25,1,0,99,15,18,0,38,15,2,0,88
2014,Egypt,Aswan : Muhafazah - Governorate,2,2,0,15,8,0,0,27,2,5,0,24,4,2,0,37
2014,Egypt,Alexandria : Muhafazah - Governorate,1785,1697,0,7456,2559,660,0,14157,1866,1803,0,7272,2720,687,0,14348
2014,Egypt,Al Sharqia : Muhafazah - Governorate,508,367,0,1798,687,123,0,3483,534,394,0,1961,693,115,0,3697
2014,Egypt,6th October : Muhafazah - Governorate,2458,2385,0,10933,3606,862,0,20244,2596,2599,0,11498,3828,863,0,21384
2014,Eritrea,Emkulu : Point,242,342,0,180,521,26,0,1311,276,335,0,226,583,33,0,1453
2014,Eritrea,Asmara : Point,1,2,0,1,6,0,0,10,0,2,0,4,8,0,0,14
2014,Eritrea,Gash Barka : Zoba - Region,10,12,0,3,26,0,0,51,9,16,0,9,45,2,0,81
2014,Estonia,Estonia : Dispersed in the country / territory,2,3,0,2,26,3,0,36,4,7,0,2,134,2,0,149
2014,Ethiopia,Urban OCPs,6,12,0,25,63,17,0,123,10,14,0,20,132,18,0,194
2014,Ethiopia,Tongo Camp : Point,1012,1356,0,709,2155,185,0,5417,1071,1432,0,822,2276,189,0,5790
2014,Ethiopia,Tierkidi:Point,4821,8065,0,3719,11093,550,0,28248,4814,8340,0,4002,3527,195,0,20878
2014,Ethiopia,Sherkole : Point,877,1303,0,717,2052,88,0,5037,937,1413,0,870,2479,93,0,5792
2014,Ethiopia,Sheder : Point,893,1635,0,1412,1917,64,0,5921,877,1635,0,1287,2808,138,0,6745
2014,Ethiopia,Okugo:Point,572,810,0,376,1578,160,0,3496,623,887,0,376,765,49,0,2700
2014,Ethiopia,Melkadida : Point,3683,7802,0,3627,8380,455,0,23947,3834,8052,0,3892,4443,477,0,20698
2014,Ethiopia,Mai-Ayni : Point,759,650,0,504,4160,46,0,6119,860,790,0,972,8993,74,0,11689
2014,Ethiopia,Leitchour:Point,4506,8284,0,3788,10555,581,0,27714,4621,8390,0,4070,2736,183,0,20000
2014,Ethiopia,Kule Camp,4621,6658,0,2888,10638,638,0,25443,4694,6751,0,3430,5720,278,0,20873
2014,Ethiopia,Kobe Camp : Point,3917,6770,0,2482,6813,538,0,20520,3820,6977,0,2873,4462,562,0,18694
2014,Ethiopia,Kebribeyah : Point,1382,1887,0,1197,2843,259,0,7568,1412,1856,0,1236,3257,228,0,7989
2014,Ethiopia,Hitsats,269,495,0,614,6639,25,0,8042,324,688,0,1180,22959,42,0,25193
2014,Ethiopia,Hilaweyn : Point,3854,7172,0,2588,6929,385,0,20928,3950,7007,0,2904,3696,405,0,17962
2014,Ethiopia,Fugnido : Point,5044,7511,0,4208,12167,743,0,29673,5093,7661,0,4635,5970,188,0,23547
2014,Ethiopia,Erebti,37,118,0,58,154,8,0,375,41,127,0,73,120,14,0,375
2014,Ethiopia,Dalool,640,1224,0,719,1736,75,0,4394,672,1274,0,713,776,104,0,3539
2014,Ethiopia,Buramino : Point,3677,7456,0,2650,7287,417,0,21487,3651,7495,0,2848,3586,404,0,17984
2014,Ethiopia,Bokolmanyo : Point,3690,6938,0,3175,7865,447,0,22115,3638,7223,0,3655,4569,465,0,19550
2014,Ethiopia,Berhale : Point,385,1234,0,561,1253,51,0,3484,421,1258,0,584,764,81,0,3108
2014,Ethiopia,Bambasi Camp : Point,1382,1789,0,813,2911,267,0,7162,1427,1841,0,990,2622,259,0,7139
2014,Ethiopia,Ayne-Deeb,372,698,0,480,1150,63,0,2763,333,673,0,334,284,84,0,1708
2014,Ethiopia,Awbarre : Point,1003,1644,0,1274,2944,165,0,7030,977,1614,0,1342,1993,106,0,6032
2014,Ethiopia,Ashura,524,615,0,335,1055,69,0,2598,561,665,0,821,1441,72,0,3560
2014,Ethiopia,Asaita : Point,566,1078,0,576,1994,182,0,4396,601,1196,0,728,1860,217,0,4602
2014,Ethiopia,Adiharush : Point,443,936,0,659,6371,40,0,8449,508,1003,0,1104,22921,105,0,25641
2014,Ethiopia,Shimelba (Shire/Shiraro) : Point,437,520,0,344,1121,174,0,2596,451,519,0,399,1957,184,0,3510
2014,Ethiopia,Borena : Awrajja - Zone,227,335,0,293,685,121,0,1661,209,383,0,258,485,111,0,1446
2014,Ethiopia,Addis Ababa : Astedader akabibi - Chartered city,229,421,0,313,1647,85,0,2695,231,506,0,375,2058,177,0,3347
2014,Ethiopia,Ad-Damazin Transit Centre : Point,84,373,0,145,616,56,0,1274,94,366,0,182,590,92,0,1324
2014,Fiji,Suva : Point,1,1,0,3,5,0,0,10,2,1,0,1,8,0,0,12
2014,Fiji,Nadi,0,0,0,0,1,0,0,1,0,0,0,0,0,0,0,0
2014,Fiji,Lotoka,0,0,0,0,0,0,0,0,0,0,0,0,1,0,0,1
2014,Gabon,Tchibanga : Point,0,0,0,1,4,0,0,5,0,2,0,0,5,0,0,7
2014,Gabon,Port-Gentil : Point,5,3,0,3,23,2,0,36,9,2,0,1,61,8,0,81
2014,Gabon,Pana/Dienga : Point,0,0,0,0,0,0,0,0,0,0,0,0,2,0,0,2
2014,Gabon,Oyem : Point,0,0,0,0,1,0,0,1,0,0,0,0,5,0,0,5
2014,Gabon,Okondja : Point,1,0,0,2,0,0,0,3,0,0,0,1,11,1,0,13
2014,Gabon,Ntoum : Point,0,2,0,0,3,0,0,5,0,2,0,0,5,0,0,7
2014,Gabon,Ngwoni : Point,0,1,0,0,1,0,0,2,0,0,0,0,3,0,0,3
2014,Gabon,Ndjole : Point,0,0,0,0,0,0,0,0,0,0,0,0,1,1,0,2
2014,Gabon,Mounana : Point,1,0,0,1,8,0,0,10,0,0,0,4,9,1,0,14
2014,Gabon,Mouila : Point,1,3,0,1,10,0,0,15,0,1,0,2,4,0,0,7
2014,Gabon,Moanda : Point,19,24,0,12,47,0,0,102,15,17,0,15,91,1,0,139
2014,Gabon,Mitzic : Point,0,0,0,0,0,0,0,0,0,0,0,0,4,0,0,4
2014,Gabon,Makokou : Point,1,1,0,0,1,0,0,3,0,2,0,1,1,0,0,4
2014,Gabon,Libreville : Point,65,78,0,80,340,8,0,571,64,90,0,85,549,35,0,823
2014,Gabon,Leconi,0,0,0,0,0,0,0,0,0,0,0,0,3,1,0,4
2014,Gabon,Lastoursville : Point,0,2,0,1,2,0,0,5,0,0,0,0,7,0,0,7
2014,Gabon,Lambarene : Point,0,0,0,0,0,1,0,1,0,0,0,0,2,1,0,3
2014,Gabon,Koulamoutou : Point,15,22,0,9,40,0,0,86,25,14,0,13,69,2,0,123
2014,Gabon,Gamba : Point,0,0,0,0,1,0,0,1,0,0,0,0,0,0,0,0
2014,Gabon,Franceville : Point,64,60,0,34,175,1,0,334,53,71,0,30,287,10,0,451
2014,Gabon,Booue : Point,0,0,0,0,1,0,0,1,0,0,0,0,0,0,0,0
2014,Gabon,Bongoville : Point,0,0,0,0,3,0,0,3,1,0,0,0,1,0,0,2
2014,Gabon,Bitam : Point,0,0,0,0,0,0,0,0,0,0,0,0,1,0,0,1
2014,Gabon,Akieni : Point,2,1,0,2,2,0,0,7,1,2,0,2,4,0,0,9
2014,Gabon,Gabon : Dispersed in the country /territory,0,0,0,0,0,0,0,0,0,0,0,0,1,0,0,1
2014,Georgia,Vale : Point,0,0,0,0,2,0,0,2,0,0,0,0,1,0,0,1
2014,Georgia,Tbilisi : City,5,0,0,1,7,1,0,14,1,0,0,2,20,1,0,24
2014,Georgia,Martqop’i : Point,0,0,0,0,4,0,0,4,0,0,0,0,8,0,0,8
2014,Georgia,Kutaisi,0,0,0,0,1,0,0,1,0,0,0,0,0,0,0,0
2014,Georgia,Batumi,0,0,0,0,1,0,0,1,0,0,0,0,1,0,0,1
2014,Georgia,Georgia : Dispersed in the country / territory,11210,11900,0,11899,78081,28805,0,141895,11788,12889,0,13171,66994,18380,0,123222
2014,Ghana,Western region environa,2,3,0,0,12,2,0,19,0,3,0,0,18,2,0,23
2014,Ghana,Volta : Region,164,237,0,156,603,45,0,1205,156,251,0,142,822,48,0,1419
2014,Ghana,Northen Region,1,1,0,0,1,0,0,3,0,0,0,0,2,0,0,2
2014,Ghana,Krisan : Point,32,53,0,32,160,6,0,283,48,65,0,45,512,7,0,677
2014,Ghana,Fetentaa : Point,139,168,0,119,555,24,0,1005,137,159,0,98,582,13,0,989
2014,Ghana,Egyeikroum : Point,118,149,0,118,659,20,0,1064,137,169,0,95,632,14,0,1047
2014,Ghana,Buduburam : Point,203,402,0,352,1848,68,0,2873,219,426,0,359,1836,59,0,2899
2014,Ghana,Asanti Region,1,1,0,1,10,1,0,14,2,5,0,1,31,0,0,39
2014,Ghana,Ampain : Point,277,398,0,326,1488,69,0,2558,300,384,0,300,1148,30,0,2162
2014,Ghana,Accra : District,77,115,0,110,787,28,0,1117,74,154,0,113,1292,47,0,1680
2014,Ghana,Central Region and its environs,0,0,0,2,4,1,0,7,0,1,0,1,1,0,0,3
2014,Guinea,Nzerekore : Prefecture,2,2,0,4,52,5,0,65,1,2,0,5,45,5,0,58
2014,Guinea,Laine : Point,10,20,0,29,73,5,0,137,9,23,0,24,70,5,0,131
2014,Guinea,Kountaya : Point,10,15,0,12,32,3,0,72,11,17,0,9,21,5,0,63
2014,Guinea,Kouankan : Point,422,575,0,579,1310,84,0,2970,350,519,0,563,1146,60,0,2638
2014,Guinea,Gbonodou,29,49,0,48,144,11,0,281,19,72,0,67,131,30,0,319
2014,Guinea,Conakry : Special zone,69,139,0,140,544,3,0,895,67,135,0,148,811,20,0,1181
2014,Guinea,Beyla : Prefecture,24,29,0,15,71,4,0,143,22,28,0,13,27,4,0,94
2014,Gambia,Gambia : Dispersed in the country / territory,644,1697,0,1393,2004,224,0,5962,632,1834,0,1293,1671,217,0,5647
2014,Guinea-Bissau,Varela ,16,32,0,13,69,8,0,138,16,33,0,11,55,15,0,130
2014,Guinea-Bissau,Tarrero,21,21,0,9,74,11,0,136,23,21,0,7,63,5,0,119
2014,Guinea-Bissau,Sungutoto,24,44,0,17,113,20,0,218,12,56,0,34,72,12,0,186
2014,Guinea-Bissau,Sindina,16,41,0,21,75,2,0,155,26,39,0,25,42,8,0,140
2014,Guinea-Bissau,Sedengal,14,28,0,15,63,9,0,129,21,31,0,31,41,9,0,133
2014,Guinea-Bissau,Sancoma,18,42,0,20,96,12,0,188,28,36,0,28,56,10,0,158
2014,Guinea-Bissau,Saiam,24,41,0,26,76,6,0,173,21,33,0,25,42,8,0,129
2014,Guinea-Bissau,Pelundo,11,57,0,16,58,10,0,152,9,25,0,19,44,7,0,104
2014,Guinea-Bissau,Papia,21,28,0,13,54,8,0,124,18,36,0,20,36,3,0,113
2014,Guinea-Bissau,Mbaiam,27,33,0,26,71,10,0,167,21,34,0,24,44,5,0,128
2014,Guinea-Bissau,Maque,9,22,0,11,38,1,0,81,9,13,0,13,26,1,0,62
2014,Guinea-Bissau,Mandina,9,8,0,3,44,8,0,72,5,11,0,5,23,5,0,49
2014,Guinea-Bissau,Kassolol,13,17,0,7,32,8,0,77,4,14,0,2,28,9,0,57
2014,Guinea-Bissau,Jolmete : Point,36,47,0,46,110,10,0,249,27,58,0,40,87,10,0,222
2014,Guinea-Bissau,Ingorezinho,25,33,0,19,70,5,0,152,28,36,0,12,57,10,0,143
2014,Guinea-Bissau,Ingore,15,27,0,12,69,10,0,133,12,22,0,19,48,12,0,113
2014,Guinea-Bissau,Erame,14,44,0,16,79,16,0,169,18,44,0,20,35,13,0,130
2014,Guinea-Bissau,Djendem,4,13,0,4,17,2,0,40,7,9,0,5,17,3,0,41
2014,Guinea-Bissau,Djegue ,21,52,0,31,111,23,0,238,24,55,0,26,75,7,0,187
2014,Guinea-Bissau,Djambam,18,23,0,12,49,4,0,106,11,21,0,14,27,4,0,77
2014,Guinea-Bissau,Djacumundo,24,37,0,23,75,16,0,175,23,47,0,20,60,7,0,157
2014,Guinea-Bissau,Catel,12,15,0,11,32,4,0,74,10,20,0,14,26,4,0,74
2014,Guinea-Bissau,Caruai,15,22,0,11,41,13,0,102,19,39,0,6,29,11,0,104
2014,Guinea-Bissau,Carabane,14,25,0,17,72,7,0,135,19,22,0,20,55,6,0,122
2014,Guinea-Bissau,Canjandi,23,33,0,14,81,15,0,166,21,49,0,18,74,7,0,169
2014,Guinea-Bissau,Campada,12,23,0,9,61,10,0,115,8,17,0,17,53,3,0,98
2014,Guinea-Bissau,Bufa,9,21,0,9,27,5,0,71,9,21,0,5,14,2,0,51
2014,Guinea-Bissau,Bigene : Point,27,58,0,32,96,18,0,231,21,61,0,33,63,13,0,191
2014,Guinea-Bissau,Beguingue II,22,32,0,24,106,19,0,203,32,43,0,25,50,8,0,158
2014,Guinea-Bissau,Barraca Lugar,11,19,0,5,40,6,0,81,9,21,0,3,19,1,0,53
2014,Guinea-Bissau,Bachil,35,52,0,39,98,17,0,241,33,65,0,33,57,8,0,196
2014,Guinea-Bissau,Asselem,10,16,0,7,36,8,0,77,8,20,0,5,31,6,0,70
2014,Guinea-Bissau,Sao Domingos : Point,0,2,0,2,2,1,0,7,1,1,0,3,5,1,0,11
2014,Guinea-Bissau,Bissau : Autonomous sector,8,8,0,6,28,5,0,55,10,12,0,5,106,9,0,142
2014,Guinea-Bissau,Barraca Mandioca,11,19,0,11,39,5,0,85,12,19,0,11,26,7,0,75
2014,Guyana,Guyana : Dispersed in the country / territory,0,0,0,3,4,0,0,7,0,1,0,1,3,0,0,5
2014,"China, Hong Kong SAR","Hong Kong SAR, China : Dispersed in the country / territory",50,31,0,24,935,5,0,1045,51,42,0,25,1236,3,0,1357
2014,Honduras,Trujillo : Municipio,0,0,0,0,0,0,0,0,0,0,0,0,5,0,0,5
2014,Honduras,Ceiba : Municipio,0,0,0,0,0,0,0,0,0,0,0,0,2,0,0,2
2014,Honduras,Tegucigalpa : Municipio,1,0,0,0,4,0,0,5,2,1,0,0,2,0,0,5
2014,Honduras,Islas de la Bahia : Departamento,0,0,0,0,2,0,0,2,0,0,0,0,0,0,0,0
2014,Honduras,Honduras : Dispersed in the country / territory,2,0,0,2,4,0,0,8,1,1,0,0,12,0,0,14
2014,Honduras,Comayagua : Departamento,0,0,0,0,1,0,0,1,0,0,0,0,0,0,0,0
2014,Croatia,Vinkovci : Point,0,0,0,0,1,0,0,1,0,0,0,0,0,0,0,0
2014,Croatia,Rijeka : Point,0,0,0,0,0,0,0,0,0,0,0,0,2,0,0,2
2014,Croatia,Kutina : Point,0,2,0,3,7,0,0,12,0,0,0,3,10,0,0,13
2014,Croatia,Jezevo : Point,0,0,0,0,0,0,0,0,0,0,0,0,5,0,0,5
2014,Croatia,Bjelovar : Point,0,0,0,0,0,0,0,0,0,0,0,0,1,0,0,1
2014,Croatia,Grad Zagreb : Grad - City,4,5,0,8,19,0,0,36,3,3,0,13,155,0,0,174
2014,Haiti,Port au Prince : Point,0,0,0,0,0,0,0,0,0,0,0,0,5,0,0,5
2014,Indonesia,Yogyakarta,0,0,0,0,0,0,0,0,0,0,0,0,57,3,0,60
2014,Indonesia,Sumatera Utara,74,103,0,63,335,8,0,583,101,90,0,140,753,10,0,1094
2014,Indonesia,Sulawesi Utara,0,0,0,1,0,0,0,1,0,0,0,69,197,1,0,267
2014,Indonesia,Sulawesi Tenggara,0,1,0,1,11,0,0,13,1,1,0,1,14,0,0,17
2014,Indonesia,Sulawesi Selatan,64,78,0,41,306,8,0,497,91,89,0,166,862,5,0,1213
2014,Indonesia,Riau,24,26,0,10,82,2,0,144,20,39,0,167,378,3,0,607
2014,Indonesia,Papua,0,0,0,0,0,0,0,0,0,0,0,0,1,0,0,1
2014,Indonesia,Nusa Tenggara Timur,1,5,0,2,11,0,0,19,3,1,0,66,155,1,0,226
2014,Indonesia,Nusa Tenggara Barat,0,0,0,0,0,0,0,0,0,0,0,0,0,1,0,1
2014,Indonesia,Kepulauan Riau,3,7,0,2,25,0,0,37,8,16,0,111,389,0,0,524
2014,Indonesia,Kalimantan Timur,2,4,0,0,3,0,0,9,0,2,0,70,214,0,0,286
2014,Indonesia,Kalimantan Barat,0,0,0,0,0,1,0,1,0,0,0,54,158,0,0,212
2014,Indonesia,Jawa Timur,0,0,0,0,0,0,0,0,0,0,0,47,348,0,0,395
2014,Indonesia,Jawa Tengah,5,6,0,4,16,0,0,31,6,8,0,3,29,0,0,46
2014,Indonesia,Jakarta,50,65,0,64,355,9,0,543,55,87,0,292,966,18,0,1418
2014,Indonesia,Banten,14,14,0,10,56,2,0,96,12,16,0,15,156,7,0,206
2014,Indonesia,Bali,2,6,0,3,18,1,0,30,5,4,0,18,58,1,0,86
2014,Indonesia,Sumatera Barat : Provinsi - Province,0,0,0,0,0,0,0,0,0,0,0,0,1,0,0,1
2014,Indonesia,Jawa Barat : Provinsi - Province,48,71,0,61,280,16,0,476,53,73,0,328,1425,14,0,1893
2014,Indonesia,Indonesia: other locations (dispersed in territory),14,10,0,6,19,1,0,50,11,18,0,6,68,0,0,103
2014,India,Delhi : Union territory,1272,2227,0,1629,9134,662,0,14924,1389,2306,0,2174,9568,578,0,16015
2014,Ireland,Ireland : Dispersed in the country / territory,91,191,0,240,2257,159,0,2938,102,186,0,257,4382,129,0,5056
2014,Iran (Islamic Rep. of),Ziveh : Point,7,20,0,29,100,11,0,167,7,19,0,20,80,12,0,138
2014,Iran (Islamic Rep. of),Varmahang : Point,1,1,0,2,2,0,0,6,0,0,0,0,3,0,0,3
2014,Iran (Islamic Rep. of),Torbat e jam : Shahrestan - County,137,255,0,305,1173,106,0,1976,139,260,0,326,1254,160,0,2139
2014,Iran (Islamic Rep. of),Tehran : Shahrestan - County,2,3,0,4,13,1,0,23,4,4,0,5,14,0,0,27
2014,Iran (Islamic Rep. of),Taft : Shahrestan - County,30,41,0,114,224,12,0,421,39,80,0,92,260,19,0,490
2014,Iran (Islamic Rep. of),Sultanieh : Point,0,0,0,1,4,3,0,8,0,0,0,1,5,5,0,11
2014,Iran (Islamic Rep. of),Sonqor : Shahrestan - County,1,4,0,4,11,3,0,23,1,5,0,6,9,2,0,23
2014,Iran (Islamic Rep. of),Saveh : Shahrestan - County,363,580,0,448,891,22,0,2304,450,530,0,601,920,120,0,2621
2014,Iran (Islamic Rep. of),Sarvestan : Shahrestan - County,34,41,0,47,115,6,0,243,28,33,0,42,117,17,0,237
2014,Iran (Islamic Rep. of),Rafsanjan : Shahrestan - County,376,550,0,574,586,204,0,2290,374,515,0,651,560,265,0,2365
2014,Iran (Islamic Rep. of),Mohajerin : Point,230,247,0,326,908,84,0,1795,227,300,0,302,894,109,0,1832
2014,Iran (Islamic Rep. of),Meybod : Shahrestan - County,150,143,0,184,670,26,0,1173,154,152,0,180,630,33,0,1149
2014,Iran (Islamic Rep. of),Khuzestan : Ostan - Province,0,1,0,0,3,0,0,4,1,0,0,0,3,0,0,4
2014,Iran (Islamic Rep. of),Khorasan : Ostan - Province,0,0,0,0,0,0,0,0,0,0,0,0,2,0,0,2
2014,Iran (Islamic Rep. of),Kerman : Shahrestan - County,1,0,0,1,1,0,0,3,1,1,0,1,3,0,0,6
2014,Iran (Islamic Rep. of),Jahrom : Shahrestan - County,8,13,0,15,55,7,0,98,6,9,0,11,54,4,0,84
2014,Iran (Islamic Rep. of),Dilzeh : Point,4,6,0,12,20,3,0,45,7,5,0,8,23,2,0,45
2014,Iran (Islamic Rep. of),Dalaki : Point,27,9,0,10,26,2,0,74,26,8,0,14,21,0,0,69
2014,Iran (Islamic Rep. of),Bezileh : Point,1,2,0,2,15,1,0,21,1,4,0,4,12,1,0,22
2014,Iran (Islamic Rep. of),Bardsir : Shahrestan - County,249,250,0,301,598,32,0,1430,245,260,0,294,594,29,0,1422
2014,Iran (Islamic Rep. of),Bani Najjar : Point,150,143,0,184,670,26,0,1173,154,152,0,180,630,33,0,1149
2014,Iran (Islamic Rep. of),Ardakan : Shahrestan - County,151,227,0,250,619,30,0,1277,162,226,0,258,686,45,0,1377
2014,Iran (Islamic Rep. of),Abazar : Point,3,10,0,12,46,7,0,78,7,10,0,16,63,2,0,98
2014,Iraq,Wasit : Muhafazah - Province,2,0,0,1,12,1,0,16,4,3,0,2,8,1,0,18
2014,Iraq,Sulaymaniyah : Muhafazah - Province,2213,2469,0,1997,6970,426,0,14075,2401,2612,0,2825,11909,417,0,20164
2014,Iraq,Salah al-Din : Muhafazah - Province,4,6,0,5,12,4,0,31,1,8,0,9,30,4,0,52
2014,Iraq,Qadissiya : Muhafazah - Province,0,5,0,7,7,1,0,20,3,4,0,1,9,1,0,18
2014,Iraq,Ninewa : Muhafazah - Province,136,226,0,158,754,84,0,1358,126,252,0,172,735,72,0,1357
2014,Iraq,Najaf : Muhafazah - Province,10,12,0,4,67,6,0,99,12,14,0,16,113,5,0,160
2014,Iraq,Muthanna : Muhafazah - Province,1,2,0,0,1,0,0,4,0,0,0,1,0,0,0,1
2014,Iraq,Missan : Muhafazah - Province,0,0,0,0,0,0,0,0,0,0,0,0,0,1,0,1
2014,Iraq,Kirkuk : Muhafazah - Province,47,72,0,26,140,12,0,297,65,81,0,45,228,14,0,433
2014,Iraq,Kerbala : Muhafazah - Province,9,18,0,11,89,8,0,135,15,16,0,6,67,11,0,115
2014,Iraq,Erbil : Muhafazah - Province,8761,9457,0,6608,23423,1233,0,49482,8848,9841,0,9403,39584,1131,0,68807
2014,Iraq,Duhok : Muhafazah - Province,8616,9096,0,6113,23104,1071,0,48000,8849,9654,0,7273,30744,904,0,57424
2014,Iraq,Diyala : Muhafazah - Province,14,34,0,36,105,4,0,193,19,33,0,28,97,7,0,184
2014,Iraq,Basrah : Muhafazah - Province,6,45,0,50,150,19,0,270,18,55,0,56,142,10,0,281
2014,Iraq,Baghdad : Muhafazah - Province,311,471,0,996,2664,472,0,4914,354,526,0,2174,3058,566,0,6678
2014,Iraq,Babylon : Muhafazah - Province,1,3,0,2,6,0,0,12,1,7,0,2,13,2,0,25
2014,Iraq,Anbar : Muhafazah - Province,364,640,0,364,1111,120,0,2599,355,629,0,379,808,84,0,2255
2014,Israel,Israel : Dispersed in the country / territory,300,400,0,300,4901,100,0,6001,300,400,0,800,32025,200,0,33725
2014,Jamaica,Jamaica : Dispersed in the country / territory,0,1,0,0,8,0,0,9,1,2,0,2,8,0,0,13
2014,Jordan,Zarqa: Azraq Camp,1141,1181,0,600,2481,113,0,5516,1145,1225,0,792,2553,84,0,5799
2014,Jordan,Zarqa : Governorate,4324,5584,0,3713,13138,1089,0,27848,4607,5989,0,3835,11272,800,0,26503
2014,Jordan,Tafilah : Governorate,236,267,0,143,542,28,0,1216,244,262,0,135,524,29,0,1194
2014,Jordan,Mafraq : Zataari Camp,7888,9233,0,5777,18008,1324,0,42230,8424,9744,0,6189,17241,945,0,42543
2014,Jordan,Mafraq : Governorate,6225,8366,0,5525,17917,1681,0,39714,6713,8739,0,5722,14665,1056,0,36895
2014,Jordan,Madaba : Governorate,984,1155,0,740,2682,215,0,5776,991,1229,0,800,2492,154,0,5666
2014,Jordan,Maan : Governorate,616,725,0,508,1700,110,0,3659,613,752,0,526,1651,79,0,3621
2014,Jordan,Karak : Governorate,869,1006,0,558,2200,185,0,4818,857,1086,0,629,2128,140,0,4840
2014,Jordan,Jarash : Governorate,929,1185,0,796,2653,241,0,5804,964,1229,0,823,2127,158,0,5301
2014,Jordan,Irbid : Governorate,11927,15620,0,9911,34859,3317,0,75634,12612,16409,0,10282,27603,2353,0,69259
2014,Jordan,Balqa : Governorate,1761,2119,0,1367,5116,388,0,10751,1806,2246,0,1456,4615,304,0,10427
2014,Jordan,Aqabah : Governorate,233,283,0,170,774,68,0,1528,273,311,0,205,810,56,0,1655
2014,Jordan,Amman : Governorate,15648,19116,0,11981,54227,5719,0,106691,16359,20365,0,13230,57008,4630,0,111592
2014,Jordan,Ajlun : Governorate,816,1079,0,705,2261,196,0,5057,1001,1200,0,750,1590,142,0,4683
2014,Jordan,Zarqa : Emirates Jordanian Camp (EJC) ,450,559,0,284,853,60,0,2206,415,520,0,288,730,37,0,1990
2014,Jordan,Jordan : Dispersed in the country / territory,157,201,0,164,648,60,0,1230,178,239,0,173,669,25,0,1284
2014,Kazakhstan,West Kazakhstan,0,0,0,1,0,0,0,1,0,0,0,0,0,0,0,0
2014,Kazakhstan,Petropavlovsk,0,0,0,0,0,0,0,0,0,0,0,0,1,0,0,1
2014,Kazakhstan,Kostanai,0,0,0,1,1,0,0,2,0,0,0,0,2,0,0,2
2014,Kazakhstan,Astana : City,0,0,0,0,0,0,0,0,0,0,0,0,2,0,0,2
2014,Kazakhstan,Almaty : City,20,30,0,32,134,9,0,225,23,36,0,35,161,10,0,265
2014,Kazakhstan,Zhambyl : Oblast - Province,0,0,0,0,1,0,0,1,0,0,0,0,1,1,0,2
2014,Kazakhstan,South Kazakhstan : Oblast - Province,6,15,0,10,41,2,0,74,4,13,0,8,84,4,0,113
2014,Kazakhstan,Almaty : Oblast - Province,1,0,0,1,13,2,0,17,1,1,0,1,17,1,0,21
2014,Kenya,Nairobi : Province,1593,3561,0,3163,16756,941,0,26014,1667,3744,0,3156,16037,652,0,25256
2014,Kenya,Kambioos : Point,1994,3143,0,1446,3381,289,0,10253,2104,3701,0,1880,2863,291,0,10839
2014,Kenya,Kakuma : Point,12844,19143,0,13218,36273,1819,0,83297,13280,21469,0,18893,40245,895,0,94782
2014,Kenya,Ifo : Point,6419,10757,0,6294,18034,1472,0,42976,6875,11221,0,7282,15635,1455,0,42468
2014,Kenya,Ifo 2 : Point,5000,7838,0,3426,8635,729,0,25628,5262,8917,0,4534,7522,789,0,27024
2014,Kenya,Hagadera : Point,8319,13032,0,7980,23128,1817,0,54276,8896,13631,0,9122,20012,1742,0,53403
2014,Kenya,Dagahaley : Point,6979,12376,0,6814,17757,1429,0,45355,7143,13059,0,7734,14466,1390,0,43792
2014,Kyrgyzstan,Osh City : Shaar - City,1,6,0,7,8,0,0,22,6,3,0,3,10,0,0,22
2014,Kyrgyzstan,Bishkek : Shaar - City,35,41,0,55,136,6,0,273,30,40,0,59,243,0,0,372
2014,Cambodia,Phnom Penh : Autonomous municipality,1,3,0,1,15,3,0,23,3,2,0,4,69,3,0,81
2014,Saint Kitts and Nevis,Saint Kitts and Nevis : Dispersed in the country / territory,0,0,0,0,0,0,0,0,0,0,0,0,2,0,0,2
2014,Rep. of Korea,Yeosu,0,0,0,0,0,0,0,0,0,0,0,0,2,0,0,2
2014,Rep. of Korea,Yangju : Point,1,0,0,0,8,0,0,9,3,0,0,0,66,0,0,69
2014,Rep. of Korea,Yangju,0,0,0,0,0,0,0,0,0,0,0,0,2,0,0,2
2014,Rep. of Korea,Whasung : Point,0,0,0,0,3,1,0,4,0,0,0,0,10,1,0,11
2014,Rep. of Korea,Ulsan,1,0,0,0,1,0,0,2,1,0,0,0,7,0,0,8
2014,Rep. of Korea,Suwon : Point,0,0,0,0,1,0,0,1,0,0,0,0,39,1,0,40
2014,Rep. of Korea,Sacheon,0,0,0,0,0,0,0,0,0,0,0,0,1,0,0,1
2014,Rep. of Korea,Pusan,2,1,0,1,6,0,0,10,1,3,0,1,41,0,0,46
2014,Rep. of Korea,Pohang : Point,0,0,0,0,0,0,0,0,0,0,0,0,1,0,0,1
2014,Rep. of Korea,Mokpo,0,0,0,0,1,0,0,1,2,0,0,0,10,0,0,12
2014,Rep. of Korea,Jeonju,0,0,0,0,1,0,0,1,0,0,0,0,7,0,0,7
2014,Rep. of Korea,Inchon Airport,0,0,0,0,1,0,0,1,0,0,0,0,5,0,0,5
2014,Rep. of Korea,Incheon Airport,1,1,0,0,7,0,0,9,3,1,0,0,14,0,0,18
2014,Rep. of Korea,Gwangju,1,1,0,0,8,0,0,10,3,2,0,0,109,0,0,114
2014,Rep. of Korea,Goyang,0,0,0,0,0,0,0,0,0,0,0,1,1,0,0,2
2014,Rep. of Korea,Changwon,1,0,0,1,0,0,0,2,2,0,0,1,12,0,0,15
2014,Rep. of Korea,Ansan,0,0,0,0,0,0,0,0,1,0,0,0,4,0,0,5
2014,Rep. of Korea,Seoul : Teukbyeolsi - Capital metropolitan city,59,50,0,14,409,14,0,546,42,46,0,33,2754,15,0,2890
2014,Rep. of Korea,Jeju - Do (Province),0,0,0,0,119,0,0,119,0,0,0,0,104,1,0,105
2014,Rep. of Korea,Inchon: Gwangyeoksi - Metropolitan,1,0,0,0,3,0,0,4,1,1,0,1,32,0,0,35
2014,Rep. of Korea,Inchon: Gwangyeoksi - Metropolican,0,1,0,0,1,0,0,2,0,0,0,0,2,0,0,2
2014,Rep. of Korea,Inchon - Yeongjongdo,0,1,0,0,2,0,0,3,1,0,0,0,3,0,0,4
2014,Rep. of Korea,Daejeon : Gwangyeoksi - Metropolitan city,1,2,0,0,4,1,0,8,0,0,0,3,13,1,0,17
2014,Rep. of Korea,Daegu : Gwangyeoksi - Metropolitan city,1,1,0,0,12,1,0,15,0,0,0,1,125,0,0,126
2014,Rep. of Korea,Cheongju : Point,0,1,0,0,2,0,0,3,0,0,0,0,6,0,0,6
2014,Lebanon,South : Mohafazah - Governorate,13307,15163,0,8038,34218,2042,0,72768,13954,15810,0,8472,25946,1390,0,65572
2014,Lebanon,North : Mohafazah - Governorate,25626,30445,0,18358,71345,5035,0,150809,25917,31576,0,18689,55835,3678,0,135695
2014,Lebanon,Mount Lebanon : Mohafazah - Governorate,26374,30842,0,15649,74773,4543,0,152181,27654,32754,0,17003,68636,3574,0,149621
2014,Lebanon,Beqaa : Mohafazah - Governorate,37684,47128,0,29894,103741,6578,0,225025,38306,48999,0,27789,63117,5013,0,183224
2014,Lebanon,Beirut : Mohafazah - Governorate,2590,3034,0,1589,7774,491,0,15478,2730,3278,0,1791,8568,439,0,16806
2014,Liberia,River Ghee : County,133,283,0,111,428,38,0,993,151,310,0,113,206,13,0,793
2014,Liberia,PTP : Point,1336,1777,0,818,3373,312,0,7616,1340,1848,0,1047,3230,219,0,7684
2014,Liberia,Nimba : County,32,55,0,35,140,17,0,279,28,49,0,24,72,7,0,180
2014,Liberia,Montserrado : County,32,61,0,73,274,3,0,443,35,58,0,64,470,16,0,643
2014,Liberia,Maryland : County,99,211,0,96,344,38,0,788,83,200,0,117,316,17,0,733
2014,Liberia,Little Wlebbo : Point,943,1182,0,555,1889,111,0,4680,840,1205,0,522,1175,59,0,3801
2014,Liberia,Grand Gedeh : County,363,548,0,225,1241,207,0,2584,326,526,0,278,928,110,0,2168
2014,Liberia,Bahn : Point,458,734,0,335,1201,71,0,2799,485,750,0,373,797,53,0,2458
2014,Libya,Tripoli : Popularate,1407,2552,0,1535,9007,485,0,14986,1442,2910,0,2012,14766,752,0,21882
2014,Saint Lucia,Saint Lucia : Dispersed in the country / territory,0,0,0,0,0,0,0,0,0,0,0,0,3,0,0,3
2014,Sri Lanka,Vavuniya : District,3,5,0,5,35,8,0,56,3,4,0,6,30,2,0,45
2014,Sri Lanka,Mannar : District,4,9,0,1,32,4,0,50,9,11,0,4,42,3,0,69
2014,Sri Lanka,Kandy : District,0,0,0,1,2,0,0,3,1,1,0,1,5,0,0,8
2014,Sri Lanka,Kaluthara,4,4,0,1,11,1,0,21,8,4,0,3,44,0,0,59
2014,Sri Lanka,Jaffna : District,3,2,0,8,37,8,0,58,0,0,0,5,30,8,0,43
2014,Sri Lanka,Gampaha : District,75,88,0,45,284,19,0,511,70,71,0,57,368,13,0,579
2014,Sri Lanka,Colombo : District,6,20,0,16,51,3,0,96,9,19,0,11,144,1,0,184
2014,Sri Lanka,Trincomalee : District,5,8,0,5,27,3,0,48,3,8,0,3,29,2,0,45
2014,Sri Lanka,Sri Lanka : Dispersed in the country / territory,0,0,0,0,2,0,0,2,0,0,0,0,4,0,0,4
2014,Sri Lanka,Mullaitivu : District,0,2,0,1,7,0,0,10,2,4,0,2,6,1,0,15
2014,Sri Lanka,Kilinochchi : District,3,4,0,5,23,1,0,36,2,4,0,1,14,1,0,22
2014,Lesotho,Lesotho : Dispersed in the country / territory,3,1,0,0,13,0,0,17,2,2,0,3,21,0,0,28
2014,Lithuania,RRC Rukla : Point,0,3,0,5,5,0,0,13,1,2,0,6,17,0,0,26
2014,Lithuania,FRC Pabrade : Point,5,8,0,1,33,0,0,47,3,10,0,7,49,0,0,69
2014,Lithuania,Vilnius : Savivaldybe - Municipality,4,3,0,0,10,1,0,18,4,4,0,0,22,0,0,30
2014,Lithuania,Siauliai: Savivaldybe -Municipality,0,0,0,0,1,0,0,1,0,0,0,0,0,0,0,0
2014,Lithuania,Lithuania : Dispersed in the country / territory,0,2,0,7,960,517,0,1486,0,2,0,6,1494,657,0,2159
2014,Lithuania,Kaunas : Savivaldybe - Municipality,4,2,0,1,4,0,0,11,0,0,0,0,6,0,0,6
2014,Lithuania,Jonavos Raj. : Savivaldybe - Municipality,1,2,0,0,4,0,0,7,0,3,0,2,6,1,0,12
2014,Latvia,Latvia : Dispersed in the country / territory,13,7,0,10,74,12,0,116,8,16,0,15,265,2,0,306
2014,"China, Macao SAR","Macao SAR, China : Dispersed in the country / territory",0,0,0,0,1,0,0,1,0,0,0,1,4,0,0,5
2014,Morocco,Morocco : Dispersed in the country / territory,137,124,0,138,651,17,0,1067,140,122,0,190,1509,20,0,1981
2014,Rep. of Moldova,Republic of Moldova : Dispersed in the country / territory,9,18,0,7,1120,205,0,1359,9,18,0,15,976,143,0,1161
2014,Madagascar,Madagascar : Dispersed in the country / territory,0,0,0,2,6,0,0,8,0,1,0,0,11,0,0,12
2014,Mexico,Mexico : Dispersed in the country / territory,20,43,0,75,380,4,0,522,14,39,0,66,652,2,0,773
2014,The former Yugoslav Republic of Macedonia,Vizbegovo : Point,11,55,0,26,126,2,0,220,7,68,0,75,1174,7,0,1331
2014,The former Yugoslav Republic of Macedonia,Veles,0,2,0,1,2,0,0,5,0,1,0,0,1,0,0,2
2014,The former Yugoslav Republic of Macedonia,Valandovo : Opština - Municipality,0,1,0,1,1,1,0,4,0,0,0,2,2,1,0,5
2014,The former Yugoslav Republic of Macedonia,Tetovo : Opština - Municipality,1,8,0,5,35,14,0,63,0,9,0,7,17,2,0,35
2014,The former Yugoslav Republic of Macedonia,Stip : Opština - Municipality,3,2,0,2,6,2,0,15,0,8,0,3,2,1,0,14
2014,The former Yugoslav Republic of Macedonia,Skopje : City,36,113,0,83,370,51,0,653,47,115,0,98,347,30,0,637
2014,The former Yugoslav Republic of Macedonia,Probistip : Opština - Municipality,0,0,0,0,0,1,0,1,0,0,0,0,0,0,0,0
2014,The former Yugoslav Republic of Macedonia,Prilep : Opština - Municipality,0,1,0,1,1,0,0,3,0,0,0,1,7,0,0,8
2014,The former Yugoslav Republic of Macedonia,Ohrid,0,0,0,0,0,0,0,0,0,0,0,1,0,0,0,1
2014,The former Yugoslav Republic of Macedonia,Negotino,0,0,0,0,2,0,0,2,0,0,0,0,0,1,0,1
2014,The former Yugoslav Republic of Macedonia,Kumanovo : Opština - Municipality,5,5,0,0,29,3,0,42,4,3,0,1,4,0,0,12
2014,The former Yugoslav Republic of Macedonia,Kumanovo,0,0,0,3,13,1,0,17,0,2,0,0,10,1,0,13
2014,The former Yugoslav Republic of Macedonia,Kocani : Opština - Municipality,0,0,0,0,0,0,0,0,0,0,0,0,1,0,0,1
2014,The former Yugoslav Republic of Macedonia,Kicevo : Opština - Municipality,0,0,0,0,9,2,0,11,0,1,0,0,5,0,0,6
2014,The former Yugoslav Republic of Macedonia,Kavadarci : Opština - Municipality,0,0,0,0,2,0,0,2,0,0,0,0,0,0,0,0
2014,The former Yugoslav Republic of Macedonia,Gostivar : Opština - Municipality,0,6,0,3,21,1,0,31,1,5,0,3,9,1,0,19
2014,The former Yugoslav Republic of Macedonia,Bitola : Opština - Municipality,2,1,0,3,2,1,0,9,2,4,0,1,3,1,0,11
2014,The former Yugoslav Republic of Macedonia,Berovo : Opština - Municipality,0,0,0,0,1,0,0,1,0,0,0,0,0,0,0,0
2014,Mali,Tombouctou,583,1216,0,566,2185,243,0,4793,595,1220,0,648,1965,231,0,4659
2014,Mali,Sikasso : Region,45,51,0,35,116,3,0,250,41,54,0,25,115,2,0,237
2014,Mali,Segou,10,25,0,16,30,8,0,89,7,18,0,13,37,7,0,82
2014,Mali,Mopti : Region,105,218,0,78,389,41,0,831,111,196,0,85,312,52,0,756
2014,Mali,Koulikoro,1,6,0,6,17,1,0,31,5,3,0,2,11,1,0,22
2014,Mali,Kidal,2,5,0,2,14,1,0,24,3,8,0,6,17,0,0,34
2014,Mali,Kayes : Region,1494,1640,0,1029,1856,149,0,6168,1663,1737,0,1051,1995,192,0,6638
2014,Mali,Gao : Region,672,1203,0,598,2068,210,0,4751,749,1261,0,591,1569,192,0,4362
2014,Mali,Faragouana : Point,2,3,0,2,6,0,0,13,1,4,0,3,12,0,0,20
2014,Mali,Bamako : District,191,272,0,230,812,27,0,1532,194,272,0,216,797,22,0,1501
2014,Montenegro,Ulcinj : Opština - Municipality,1,1,0,9,30,18,0,59,1,6,0,14,32,10,0,63
2014,Montenegro,Tivat : Opština - Municipality,2,2,0,10,33,25,0,72,1,1,0,15,43,20,0,80
2014,Montenegro,Savnik : Opština - Municipality,0,0,0,0,0,0,0,0,0,0,0,0,0,1,0,1
2014,Montenegro,Rozaj : Opština - Municipality,2,5,0,8,46,5,0,66,1,8,0,16,29,9,0,63
2014,Montenegro,Podgorica : Opština - Municipality,106,217,0,224,579,195,0,1321,133,240,0,266,614,155,0,1408
2014,Montenegro,Pluzine : Opština - Municipality,0,0,0,0,2,0,0,2,0,0,0,0,1,0,0,1
2014,Montenegro,Pljevlja : Opština - Municipality,2,3,0,2,14,5,0,26,4,5,0,5,10,4,0,28
2014,Montenegro,Plav : Opština - Municipality,0,7,0,5,103,47,0,162,0,4,0,15,90,47,0,156
2014,Montenegro,Niksic : Opština - Municipality,4,8,0,10,64,21,0,107,2,8,0,12,62,9,0,93
2014,Montenegro,Montenegro : Dispersed in the country / territory,1,5,0,5,78,41,0,130,0,6,0,3,68,28,0,105
2014,Montenegro,Mojkovac : Opština - Municipality,0,0,0,1,12,3,0,16,0,2,0,2,5,2,0,11
2014,Montenegro,Kotor : Opština - Municipality,0,5,0,1,14,16,0,36,0,2,0,4,21,9,0,36
2014,Montenegro,Kolasin : Opština - Municipality,0,2,0,0,14,10,0,26,0,2,0,3,18,3,0,26
2014,Montenegro,Herceg Novi : Opština - Municipality,2,6,0,9,94,57,0,168,3,5,0,17,88,32,0,145
2014,Montenegro,Danilovgrad : Opština - Municipality,0,3,0,7,23,25,0,58,0,4,0,9,34,13,0,60
2014,Montenegro,Cetinje : Opština - Municipality,0,0,0,0,1,0,0,1,0,0,0,0,2,1,0,3
2014,Montenegro,Budva : Opština - Municipality,0,9,0,10,58,41,0,118,1,5,0,8,60,26,0,100
2014,Montenegro,Bijelo Polje : Opština - Municipality,0,2,0,4,37,10,0,53,1,1,0,6,35,10,0,53
2014,Montenegro,Berane : Opština - Municipality,33,54,0,59,227,94,0,467,37,70,0,52,227,56,0,442
2014,Montenegro,Bar : Opština - Municipality,9,23,0,25,122,100,0,279,12,21,0,24,192,64,0,313
2014,Montenegro,Andrijevica : Opština - Municipality,0,2,0,9,54,31,0,96,0,3,0,10,48,20,0,81
2014,Mongolia,Ulaanbaatar : Capital city,0,0,0,0,4,0,0,4,2,0,0,0,9,0,0,11
2014,Mozambique,Tete : Provincia,22,44,0,36,104,1,0,207,22,43,0,37,183,4,0,289
2014,Mozambique,Sofala : Provincia,0,4,0,2,12,1,0,19,0,3,0,1,25,1,0,30
2014,Mozambique,Niassa : Provincia,3,15,0,17,35,1,0,71,4,22,0,11,61,1,0,99
2014,Mozambique,Maratane : Point,773,957,0,667,2059,85,0,4541,736,1070,0,662,3425,39,0,5932
2014,Mozambique,Manica : Provincia,3,3,0,1,21,0,0,28,2,5,0,0,92,1,0,100
2014,Mozambique,Gaza : Provincia,0,2,0,4,8,0,0,14,0,5,0,3,17,0,0,25
2014,Mozambique,Zambezia : Provincia,5,8,0,2,33,0,0,48,4,6,0,9,88,0,0,107
2014,Mozambique,Nampula : Provincia,136,210,0,113,589,14,0,1062,146,224,0,157,1890,21,0,2438
2014,Mozambique,Maputo Provincia : Provincia,3,38,0,34,93,4,0,172,3,34,0,31,142,4,0,214
2014,Mozambique,Maputo : Cidade capital - Capital City,33,175,0,132,549,19,0,908,44,175,0,148,1060,33,0,1460
2014,Mozambique,Inhambane : Provincia,0,2,0,2,10,0,0,14,0,2,0,4,23,0,0,29
2014,Mozambique,Cabo Delgado : Provincia,1,5,0,1,11,0,0,18,0,3,0,2,30,1,0,36
2014,Mauritania,Mbera : Point,4581,6851,0,2691,11641,1440,0,27204,4586,6640,0,2627,6790,1063,0,21706
2014,Mauritania,Nouakchott and Nouadhibou : Regional grouping,68,99,0,67,249,9,0,492,80,77,0,46,432,10,0,645
2014,Malawi,Dzaleka : Point,1633,2222,0,1558,4032,131,0,9576,1635,2374,0,1685,4992,111,0,10797
2014,Malaysia,Kuala Lumpur : Wilayah Persekutuan - Federal territory,7377,4228,0,2959,30830,728,0,46122,7767,4835,0,4720,86325,852,0,104499
2014,Namibia,Osire : Point,136,192,0,146,487,14,0,975,150,207,0,187,729,15,0,1288
2014,Namibia,Namibia : Dispersed in the country / territory,16,22,0,10,63,1,0,112,18,27,0,20,149,1,0,215
2014,Niger,Tazalit,188,355,0,111,408,36,0,1098,229,346,0,128,338,33,0,1074
2014,Niger,Tabareybarey : Point,553,1333,0,584,2024,174,0,4668,574,1283,0,568,931,123,0,3479
2014,Niger,Mangaize : Point,506,978,0,378,1393,105,0,3360,519,1020,0,445,900,110,0,2994
2014,Niger,Intikane,884,2281,0,760,2536,138,0,6599,913,2324,0,706,2017,179,0,6139
2014,Niger,Goure,3,4,0,11,41,5,0,64,1,9,0,5,43,8,0,66
2014,Niger,Camp Abala : Point,825,2258,0,948,2839,224,0,7094,864,2129,0,935,1733,183,0,5844
2014,Niger,Ayourou : Point,7,31,0,13,64,4,0,119,11,27,0,13,24,5,0,80
2014,Niger,Niamey : Capital district,297,804,0,497,1403,173,0,3174,274,725,0,398,595,92,0,2084
2014,Nigeria,Lagos : State,34,44,0,39,204,2,0,323,41,46,0,30,518,6,0,641
2014,Nigeria,Cross Rivers ,0,4,0,2,3,2,0,11,0,1,0,0,0,0,0,1
2014,Nigeria,Benue : State,5,20,0,12,38,4,0,79,1,10,0,10,35,3,0,59
2014,Nigeria,Nigeria : Dispersed in the country / territory,49,90,0,43,195,2,0,379,59,72,0,47,414,10,0,602
2014,Nicaragua,Palacaguina : Municipio,0,0,0,0,0,0,0,0,0,0,0,0,2,0,0,2
2014,Nicaragua,Nicaragua : Dispersed in the country / territory,8,14,0,31,95,15,0,163,9,24,0,19,97,9,0,158
2014,Nicaragua,Managua : Departamento,0,0,0,1,2,0,0,3,0,1,0,0,12,0,0,13
2014,Nepal,Sanischare : Point,258,318,0,239,1322,158,0,2295,252,280,0,276,1362,210,0,2380
2014,Nepal,Kathmandu: District,0,0,0,0,2,0,0,2,0,0,0,3,4,1,0,8
2014,Nepal,Kathmandu : District,32,43,0,19,144,6,0,244,30,56,0,32,195,5,0,318
2014,Nepal,Beldangi : Point,874,1162,0,1019,5284,629,0,8968,874,1309,0,1106,5477,840,0,9606
2014,Nepal,Nepal : Dispersed in the country / territory,0,1,0,1,9,4,0,15,0,1,0,0,20,1,0,22
2014,Oman,Oman : Dispersed in the country / territory,25,42,0,17,109,10,0,203,21,33,0,18,101,6,0,179
2014,Pakistan,Zar Karez : Point,67,478,0,365,804,56,0,1770,69,468,0,454,880,113,0,1984
2014,Pakistan,Zangal Patai : Point,1,13,0,9,35,0,0,58,1,10,0,16,40,3,0,70
2014,Pakistan,Zafarabad : Point,52,395,0,232,467,19,0,1165,62,387,0,301,626,74,0,1450
2014,Pakistan,Yakaghund : Point,68,404,0,197,416,24,0,1109,65,380,0,208,440,40,0,1133
2014,Pakistan,Utmanzai : Point,53,459,0,370,830,46,0,1758,63,520,0,391,879,108,0,1961
2014,Pakistan,Urguch : Point,1,2,0,8,9,0,0,20,0,4,0,4,20,0,0,28
2014,Pakistan,Toor : Point,59,271,0,191,397,22,0,940,56,295,0,197,579,35,0,1162
2014,Pakistan,Togh Sarai : Point,556,617,0,309,1358,62,0,2902,617,802,0,494,1235,123,0,3271
2014,Pakistan,Timer : Point,165,1185,0,853,1938,85,0,4226,185,1226,0,894,1984,175,0,4464
2014,Pakistan,Thall : Point,275,1450,0,1203,2722,255,0,5905,271,1618,0,1350,2695,408,0,6342
2014,Pakistan,Surkhab : Point,133,669,0,531,1283,56,0,2672,117,691,0,639,1450,195,0,3092
2014,Pakistan,Sund Rawal : Point,0,5,0,10,17,2,0,34,0,8,0,16,39,6,0,69
2014,Pakistan,Sindh : Province,2579,6457,0,5446,13757,608,0,28847,2736,6807,0,5700,16280,1486,0,33009
2014,Pakistan,Shindand : Point,39,227,0,160,333,19,0,778,37,211,0,178,373,35,0,834
2014,Pakistan,Shaikh Abad : Point,107,653,0,522,1158,72,0,2512,106,640,0,521,1273,103,0,2643
2014,Pakistan,Saranan : Point,411,2175,0,1808,4145,192,0,8731,464,2184,0,2022,4299,548,0,9517
2014,Pakistan,Rata Kulachi : Point,7,53,0,29,69,6,0,164,6,45,0,47,111,12,0,221
2014,Pakistan,Rakh Zandani : Point,0,0,0,1,1,0,0,2,0,1,0,2,5,0,0,8
2014,Pakistan,Quetta : District,129,386,0,306,997,63,0,1881,142,369,0,349,437,25,0,1322
2014,Pakistan,Pusha Pul : Point,12,108,0,52,109,8,0,289,10,93,0,79,197,19,0,398
2014,Pakistan,Punjab : Province,4957,17223,0,13782,33690,1844,0,71496,5273,18493,0,15581,41391,3647,0,84385
2014,Pakistan,Posti : Point,5,22,0,16,27,1,0,71,3,23,0,14,33,6,0,79
2014,Pakistan,Pir Alizai : Point,168,1159,0,692,1449,73,0,3541,161,1102,0,774,1893,210,0,4140
2014,Pakistan,Peshawar : District,148,359,0,337,1106,63,0,2013,160,362,0,362,710,35,0,1629
2014,Pakistan,Panian : Point,1179,5755,0,5453,13377,670,0,26434,1367,6098,0,5699,12901,1317,0,27382
2014,Pakistan,Padhana : Point,195,981,0,986,2222,115,0,4499,210,1003,0,1066,2335,249,0,4863
2014,Pakistan,Old Shamshatoo,997,5891,0,4213,11397,400,0,22898,1059,6135,0,4772,12345,1059,0,25370
2014,Pakistan,Old Akora : Point,937,4671,0,3174,7589,213,0,16584,951,4838,0,3481,8191,744,0,18205
2014,Pakistan,Oblan : Point,228,1153,0,917,1981,127,0,4406,243,1194,0,948,2021,203,0,4609
2014,Pakistan,New Durrani : Point,375,417,0,208,917,42,0,1959,417,542,0,333,833,82,0,2207
2014,Pakistan,New Akora : Point,21,57,0,9,45,2,0,134,19,53,0,16,156,5,0,249
2014,Pakistan,Naurang,21,121,0,112,256,13,0,523,24,134,0,137,282,35,0,612
2014,Pakistan,Naguman : Point,49,388,0,312,663,29,0,1441,61,395,0,357,748,70,0,1631
2014,Pakistan,Nagar : Point,3,28,0,21,37,2,0,91,4,28,0,20,50,4,0,106
2014,Pakistan,Munda : Point,199,1342,0,910,2136,95,0,4682,194,1349,0,949,1984,230,0,4706
2014,Pakistan,Mera Kachori : Point,110,642,0,453,1067,59,0,2331,93,607,0,469,1130,108,0,2407
2014,Pakistan,Mayar : Point,16,85,0,71,165,11,0,348,23,97,0,76,217,23,0,436
2014,Pakistan,Malgagai : Point,92,717,0,534,1151,118,0,2612,84,790,0,570,1388,190,0,3022
2014,Pakistan,Lejay Karez : Point,12,57,0,49,111,7,0,236,18,47,0,52,171,26,0,314
2014,Pakistan,Lakhti Banda : Point,138,759,0,545,1259,153,0,2854,117,820,0,584,1332,217,0,3070
2014,Pakistan,Kotwai : Point,99,624,0,552,1077,77,0,2429,94,625,0,576,912,159,0,2366
2014,Pakistan,Kotkai : Point,56,285,0,208,500,67,0,1116,46,349,0,202,622,91,0,1310
2014,Pakistan,Kot Chandna : Point,272,1875,0,1340,3151,128,0,6766,302,1820,0,1408,3217,283,0,7030
2014,Pakistan,Koga : Point,253,1122,0,802,1879,79,0,4135,261,1150,0,907,1806,145,0,4269
2014,Pakistan,Khurasan : Point,70,378,0,296,925,68,0,1737,65,387,0,319,988,99,0,1858
2014,Pakistan,Khoughani : Point,37,159,0,125,330,13,0,664,29,167,0,132,348,27,0,703
2014,Pakistan,Kheshki : Point,13,64,0,36,92,3,0,208,5,58,0,48,106,13,0,230
2014,Pakistan,Khazana : Point,125,764,0,564,1262,69,0,2784,139,738,0,618,1505,127,0,3127
2014,Pakistan,Khaki : Point,326,1823,0,1337,3165,200,0,6851,328,1849,0,1425,3321,327,0,7250
2014,Pakistan,Khairabad : Point,392,1849,0,1083,2499,169,0,5992,392,1777,0,1221,2638,293,0,6321
2014,Pakistan,Kesu : Point,8,91,0,54,166,5,0,324,11,105,0,96,182,15,0,409
2014,Pakistan,Kata Kanri : Point,95,630,0,440,953,89,0,2207,99,664,0,465,1145,114,0,2487
2014,Pakistan,Karachi : District,28,63,0,78,206,7,0,382,34,59,0,75,197,4,0,369
2014,Pakistan,Kalkatak : Point,5,90,0,67,154,5,0,321,9,108,0,76,214,8,0,415
2014,Pakistan,Kaghan : Point,38,249,0,159,359,23,0,828,41,261,0,184,370,31,0,887
2014,Pakistan,Kababian : Point,268,1250,0,922,2376,77,0,4893,250,1341,0,987,3389,184,0,6151
2014,Pakistan,Jerma : Point,26,115,0,74,192,13,0,420,33,129,0,99,254,24,0,539
2014,Pakistan,Jalozai : Point,2732,3035,0,1518,6677,304,0,14266,3035,3946,0,2428,6070,607,0,16086
2014,Pakistan,Jalala : Point,280,1695,0,1170,2902,153,0,6200,283,1738,0,1305,3150,292,0,6768
2014,Pakistan,Ichrian : Point,114,517,0,394,988,62,0,2075,95,500,0,386,1060,110,0,2151
2014,Pakistan,Girdi Jungle : Point,317,2318,0,1334,3076,482,0,7527,359,2809,0,1634,4315,732,0,9849
2014,Pakistan,Ghulam Banda : Point,170,935,0,687,1754,73,0,3619,196,974,0,821,1907,190,0,4088
2014,Pakistan,Ghiljo : Point,29,128,0,56,173,9,0,395,24,132,0,67,177,21,0,421
2014,Pakistan,Ghazi : Point,4,16,0,9,28,1,0,58,1,26,0,11,33,4,0,75
2014,Pakistan,Gandaf : Point,335,1566,0,1122,2556,170,0,5749,347,1644,0,1268,2837,223,0,6319
2014,Pakistan,Gamkol : Point,722,3806,0,2803,6513,324,0,14168,789,3791,0,3051,7799,643,0,16073
2014,Pakistan,Gambila : Point,32,166,0,124,256,22,0,600,52,187,0,136,331,41,0,747
2014,Pakistan,Domshivgar : Point,3,25,0,16,38,2,0,84,0,10,0,19,37,4,0,70
2014,Pakistan,Dodpa : Point,0,16,0,24,38,1,0,79,0,8,0,19,60,4,0,91
2014,Pakistan,Doaba : Point,120,535,0,454,1010,82,0,2201,117,585,0,473,1126,154,0,2455
2014,Pakistan,Darsamand : Point,79,496,0,344,902,86,0,1907,101,518,0,407,1011,127,0,2164
2014,Pakistan,Daraban : Point,0,13,0,3,13,0,0,29,0,6,0,7,12,1,0,26
2014,Pakistan,Dabara : Point,30,187,0,47,121,7,0,392,42,273,0,53,206,15,0,589
2014,Pakistan,Chichana : Point,95,387,0,300,755,47,0,1584,82,423,0,319,1011,109,0,1944
2014,Pakistan,Chakdara : Point,212,1449,0,1024,2257,105,0,5047,219,1536,0,1091,2629,182,0,5657
2014,Pakistan,Chagai,0,18,0,13,28,3,0,62,3,25,0,8,35,5,0,76
2014,Pakistan,Bizen Khel : Point,23,167,0,146,310,15,0,661,36,182,0,182,354,35,0,789
2014,Pakistan,Basu Mera : Point,76,436,0,476,1191,44,0,2223,109,461,0,553,1162,124,0,2409
2014,Pakistan,Barawal : Point,2,2,0,4,8,1,0,17,0,5,0,5,27,3,0,40
2014,Pakistan,Barary,134,873,0,632,1604,89,0,3332,136,846,0,688,1733,149,0,3552
2014,Pakistan,Barari : Point,1,10,0,0,13,0,0,24,2,8,0,7,17,0,0,34
2014,Pakistan,Barakai : Point,468,2949,0,2555,5844,278,0,12094,492,3166,0,2734,5710,590,0,12692
2014,Pakistan,Baka Khel : Point,17,65,0,50,104,8,0,244,18,83,0,66,155,18,0,340
2014,Pakistan,Baghicha : Point,11,69,0,35,114,6,0,235,14,83,0,41,111,13,0,262
2014,Pakistan,Badaber : Point,558,3085,0,2206,5176,241,0,11266,563,3248,0,2349,5973,519,0,12652
2014,Pakistan,Azakhel : Point,455,3016,0,1829,4001,144,0,9445,622,3258,0,2009,4525,332,0,10746
2014,Pakistan,Mohammad Kheil : Point,78,588,0,426,1094,32,0,2218,97,545,0,556,1175,132,0,2505
2014,Pakistan,Khyber Pakhtunkhwa : Province,144341,193079,0,109721,421657,19673,0,888471,159298,238905,0,156532,408196,39223,0,1002154
2014,Pakistan,Islamabad : Federal capital territory,1305,3505,0,2980,7781,425,0,15996,1453,3772,0,3400,8943,844,0,18412
2014,Pakistan,Gandhi Khan Khel : Point,56,274,0,230,457,25,0,1042,80,312,0,214,475,59,0,1140
2014,Pakistan,Gahzgai Minara : Point,22,170,0,135,285,21,0,633,28,173,0,203,360,45,0,809
2014,Pakistan,Balochistan : Province,8830,23398,0,19537,45210,2850,0,99825,9435,24083,0,22407,51444,6497,0,113866
2014,Pakistan,Azad Kashmir : Pakistan administered area,131,637,0,524,1311,80,0,2683,137,691,0,537,1661,159,0,3185
2014,Panama,Darien : Provincia,16,21,0,30,67,7,0,141,17,20,0,28,85,8,0,158
2014,Panama,Panama : Dispersed in the country / territory,268,730,0,2064,3761,866,0,7689,262,809,0,2613,5907,991,0,10582
2014,Panama,Kuna Yala : Comarca - Indiginous region,3,13,0,16,25,1,0,58,4,6,0,14,22,1,0,47
2014,Peru,Peru : Dispersed in the country / territory,12,27,0,255,328,12,0,634,16,60,0,89,834,57,0,1056
2014,Philippines,Region 7,0,0,0,0,1,0,0,1,0,0,0,0,3,0,0,3
2014,Philippines,Region 6,0,0,0,0,0,0,0,0,0,0,0,0,1,0,0,1
2014,Philippines,Region 5,0,0,0,0,0,0,0,0,0,0,0,0,1,0,0,1
2014,Philippines,Region 12,0,0,0,0,0,0,0,0,0,0,0,0,2,0,0,2
2014,Philippines,Region 1,0,0,0,0,1,0,0,1,0,0,0,0,7,0,0,7
2014,Philippines,SARANGANI PROVINCE,77,114,0,80,319,39,0,629,87,119,0,61,231,44,0,542
2014,Philippines,Philippines : Dispersed in the country / territory,0,0,0,0,37,0,0,37,0,0,0,0,188,0,0,188
2014,Philippines,National Capital Region,0,1,0,3,16,1,0,21,1,2,0,2,88,6,0,99
2014,Philippines,MIMAROPA (Region IV-B) : Region,0,0,0,0,0,0,0,0,0,0,0,0,0,1,0,1
2014,Philippines,Davao (Region XI) : Region,0,2,0,0,1,0,0,3,0,0,0,0,2,1,0,3
2014,Philippines,Central Luzon (Region III) : Region,0,0,0,0,0,0,0,0,0,0,0,0,8,0,0,8
2014,Philippines,CALABARZON (Region IV-A ) : Region,0,0,0,0,10,0,0,10,0,0,0,0,12,2,0,14
2014,Palau,Koror : State,0,0,0,0,0,0,0,0,0,0,0,0,1,0,0,1
2014,Poland,Linin : Point,21,35,0,14,38,1,0,109,22,41,0,10,38,1,0,112
2014,Poland,Horbow : Point,14,10,0,4,20,0,0,48,11,15,0,1,21,0,0,48
2014,Poland,Grupa : Point,8,20,0,5,22,1,0,56,10,8,0,7,24,0,0,49
2014,Poland,Grotniki : Point,8,5,0,1,17,0,0,31,10,4,0,4,17,1,0,36
2014,Poland,Debak : Point,6,12,0,1,19,0,0,38,6,5,0,6,20,0,0,37
2014,Poland,Czerwony Bor : Point,10,13,0,4,30,0,0,57,10,11,0,7,26,1,0,55
2014,Poland,Bezwola II,11,4,0,1,34,2,0,52,7,7,0,5,34,2,0,55
2014,Poland,Bezwola,10,11,0,4,24,1,0,50,7,8,0,5,29,1,0,50
2014,Poland,Warsaw : Powiat - County,7,9,0,8,34,4,0,62,7,7,0,9,0,0,0,23
2014,Poland,Lukow : Powiat - County,7,15,0,9,19,0,0,50,9,13,0,12,18,0,0,52
2014,Poland,Lublin : Powiat - County,7,9,0,4,23,0,0,43,10,10,0,12,23,2,0,57
2014,Poland,Bialystok : Powiat - County,10,17,0,7,27,1,0,62,13,18,0,7,22,0,0,60
2014,Poland,Biala Podlaska : Powiat - County,4,6,0,6,23,2,0,41,5,5,0,3,29,1,0,43
2014,Paraguay,Paraguay : Dispersed in the country / territory,1,11,0,10,45,4,0,71,2,5,0,5,82,1,0,95
2014,Qatar,Qatar : Dispersed in the country / territory,8,14,0,15,71,5,0,113,12,13,0,7,68,8,0,108
2014,Romania,Romania : Dispersed in the country / territory,87,98,0,69,406,30,0,690,116,106,0,88,1143,39,0,1492
2014,Rwanda,Kiziba : Point,1234,1622,0,1329,4527,507,0,9219,1171,1508,0,1317,3393,424,0,7813
2014,Rwanda,Kigali : Point,133,235,0,192,598,22,0,1180,116,233,0,182,577,32,0,1140
2014,Rwanda,Gihembe : Point,988,1285,0,1289,3963,509,0,8034,906,1410,0,1218,2982,277,0,6793
2014,Rwanda,Rubavu : Akarere - District,706,444,0,130,1476,60,0,2816,705,381,0,108,297,28,0,1519
2014,Rwanda,Nyamagabe : Akarere - District,1646,2306,0,1717,4305,308,0,10282,1709,2258,0,1561,2443,252,0,8223
2014,Rwanda,Nyagatare (Cyangugu) : Akarere - District,189,158,0,50,387,13,0,797,176,136,0,47,62,7,0,428
2014,Rwanda,Gisagara : Akarere - District,706,937,0,658,1675,133,0,4109,724,916,0,511,661,70,0,2882
2014,Rwanda,Gatsibo : Akarere - District,1066,1788,0,1406,3687,266,0,8213,1100,1694,0,1339,2245,197,0,6575
2014,Saudi Arabia,Riyadh : Province,6,39,0,26,98,5,0,174,9,39,0,49,158,7,0,262
2014,Saudi Arabia,Madinah : Province,0,2,0,0,1,0,0,3,0,0,0,0,3,0,0,3
2014,Saudi Arabia,Khobar : Governorate,0,1,0,1,2,1,0,5,0,0,0,1,9,0,0,10
2014,Saudi Arabia,Jeddah : Governorate,3,19,0,27,39,4,0,92,5,24,0,17,59,5,0,110
2014,Saudi Arabia,Arar : Governorate,0,0,0,0,0,0,0,0,0,0,0,0,2,0,0,2
2014,Sudan,Wad Sherife village,4,66,0,76,275,29,0,450,8,79,0,76,143,18,0,324
2014,Sudan,Wad Sherife : Point,280,1363,0,1107,5034,770,0,8554,302,1415,0,1200,3184,708,0,6809
2014,Sudan,Wad Medani : Point,0,2,0,2,4,0,0,8,0,6,0,1,1,2,0,10
2014,Sudan,Wad El Hileau : Point,7,41,0,25,82,11,0,166,3,33,0,20,79,8,0,143
2014,Sudan,Um Shalaya : Point,961,589,0,1859,249,825,0,4483,886,587,0,1102,140,900,0,3615
2014,Sudan,Um Sagata,0,0,0,3,1,0,0,4,0,1,0,0,1,1,0,3
2014,Sudan,Um Rakuba : Point,0,4,0,3,15,2,0,24,4,4,0,2,22,4,0,36
2014,Sudan,Um Gulja : Point,0,9,0,5,29,4,0,47,5,7,0,7,39,7,0,65
2014,Sudan,Um Gargur : Point,266,858,0,638,2975,330,0,5067,267,888,0,758,2825,466,0,5204
2014,Sudan,Um Ali : Point,1,12,0,11,15,0,0,39,4,7,0,7,9,2,0,29
2014,Sudan,Suwakin : Point,1,9,0,3,12,0,0,25,2,3,0,2,37,1,0,45
2014,Sudan,Sinkat : District,0,0,0,0,0,0,0,0,0,0,0,0,1,0,0,1
2014,Sudan,Showak,0,3,0,3,12,2,0,20,0,5,0,6,15,2,0,28
2014,Sudan,Shagarab 3 : Point,260,680,0,530,1737,201,0,3408,246,697,0,473,1188,300,0,2904
2014,Sudan,Shagarab 2 : Point,508,1267,0,855,2766,244,0,5640,487,1354,0,911,1809,392,0,4953
2014,Sudan,Shagarab 1 : Point,747,1693,0,1163,4397,431,0,8431,810,1752,0,1292,4521,533,0,8908
2014,Sudan,Salmin : Point,0,1,0,0,1,0,0,2,0,1,0,0,1,0,0,2
2014,Sudan,Salalab : Point,10,43,0,30,128,4,0,215,12,32,0,43,170,12,0,269
2014,Sudan,Safawa : Point,0,0,0,0,3,1,0,4,0,0,0,0,0,0,0,0
2014,Sudan,Port Sudan : District,16,88,0,84,255,13,0,456,28,106,0,68,452,29,0,683
2014,Sudan,Nyala : District,0,0,0,1,891,1,0,893,2,5,0,3,898,2,0,910
2014,Sudan,New Halfa : Point,6,16,0,4,86,0,0,112,9,17,0,7,796,9,0,838
2014,Sudan,Mukjar : Point,130,74,0,159,46,42,0,451,115,66,0,139,44,55,0,419
2014,Sudan,Marghania : Point,1,13,0,4,40,3,0,61,0,9,0,12,81,2,0,104
2014,Sudan,Mafaza : Point,0,0,0,0,1,0,0,1,0,0,0,0,0,0,0,0
2014,Sudan,Laffa : Point,0,1,0,0,6,1,0,8,0,1,0,0,0,0,0,1
2014,Sudan,Kilo 7 : Point,0,22,0,19,77,16,0,134,1,36,0,21,67,18,0,143
2014,Sudan,Kilo 26 : Point,246,795,0,596,2353,310,0,4300,290,869,0,596,1932,406,0,4093
2014,Sudan,Karkora : Point,0,5,0,4,14,3,0,26,1,3,0,4,12,2,0,22
2014,Sudan,Kalakla : Point,0,0,0,0,0,0,0,0,0,0,0,0,2,1,0,3
2014,Sudan,Hawata : Point,0,5,0,0,3,0,0,8,1,1,0,1,0,0,0,3
2014,Sudan,Gulsa : Point,0,3,0,10,23,1,0,37,1,2,0,4,10,3,0,20
2014,Sudan,Girba : Point,232,609,0,437,1827,236,0,3341,235,657,0,462,1290,322,0,2966
2014,Sudan,Geref : Point,0,2,0,0,5,0,0,7,0,1,0,1,8,0,0,10
2014,Sudan,Fau Town : Point,0,1,0,0,1,0,0,2,0,2,0,1,0,0,0,3
2014,Sudan,Fau 5 : Point,4,91,0,66,232,35,0,428,7,101,0,68,231,54,0,461
2014,Sudan,Fath El Rahman : Point,0,22,0,19,95,17,0,153,0,23,0,20,70,24,0,137
2014,Sudan,El Geneina : Point,0,2,0,1,1,0,0,4,0,0,0,14,3,0,0,17
2014,Sudan,Dordeab : Point,0,2,0,3,3,0,0,8,0,1,0,0,1,0,0,2
2014,Sudan,Doka : Point,0,0,0,1,2,1,0,4,0,0,0,1,0,1,0,2
2014,Sudan,Diam El-Nour : Point,6,23,0,23,118,4,0,174,7,31,0,20,218,13,0,289
2014,Sudan,Dehama : Point,0,0,0,0,0,0,0,0,0,0,0,0,1,1,0,2
2014,Sudan,Daim : Point,0,0,0,1,0,0,0,1,0,0,0,0,1,1,0,2
2014,Sudan,Blue Nile,170,477,0,292,979,39,0,1957,192,523,0,246,1118,138,0,2217
2014,Sudan,Basonda : Point,0,0,0,0,1,0,0,1,1,1,0,0,0,0,0,2
2014,Sudan,Awad El Seid : Point,0,42,0,41,153,28,0,264,1,55,0,46,120,41,0,263
2014,Sudan,Asotriba : Point,0,0,0,0,0,0,0,0,0,0,0,0,2,1,0,3
2014,Sudan,Aroma : Point,0,5,0,0,4,0,0,9,0,0,0,3,6,0,0,9
2014,Sudan,Adingrar,0,0,0,0,1,0,0,1,0,0,0,0,1,0,0,1
2014,Sudan,Abuda : Point,103,295,0,211,772,86,0,1467,100,286,0,251,687,115,0,1439
2014,Sudan,Abu Rakham area : Point,4,27,0,31,105,17,0,184,1,30,0,39,79,27,0,176
2014,Sudan,White Nile :Wilayat - State,6582,9932,0,5748,13927,1509,0,37698,6523,9225,0,6208,9786,1185,0,32927
2014,Sudan,Northern Darfur : Wilayat - State,0,0,0,0,2,0,0,2,0,0,0,0,4,0,0,4
2014,Sudan,Khartoum : Wilayat - State,3277,5189,0,4082,21908,661,0,35117,3278,5531,0,4420,22610,945,0,36784
2014,Sudan,Kassala : Wilayat - State,135,356,0,294,1296,99,0,2180,112,394,0,306,1483,139,0,2434
2014,Sudan,Gadaref : Wilayat - State,46,358,0,229,1094,110,0,1837,58,397,0,284,1211,274,0,2224
2014,Senegal,Saint Louis,1,2,0,0,9,0,0,12,3,1,0,0,13,1,0,18
2014,Senegal,Richard Toll : Point,1347,1627,0,755,2748,270,0,6747,1377,1525,0,724,2060,227,0,5913
2014,Senegal,Dakar/Thies : Point,6,17,0,16,29,1,0,69,10,25,0,20,58,3,0,116
2014,Senegal,Dakar : Point,125,165,0,160,1073,25,0,1548,128,211,0,186,2201,39,0,2765
2014,Singapore,Singapore : Dispersed in the country / territory,0,0,0,0,1,0,0,1,0,0,0,0,3,0,0,3
2014,Solomon Islands,Honiara : Capital territory,0,0,0,0,1,0,0,1,0,0,0,0,2,0,0,2
2014,Sierra Leone,Tobanda : Point,1,3,0,19,14,5,0,42,0,2,0,1,0,0,0,3
2014,Sierra Leone,Taiama : Point,0,3,0,4,12,2,0,21,2,7,0,4,13,1,0,27
2014,Sierra Leone,Largo : Point,1,4,0,4,20,4,0,33,1,2,0,14,22,0,0,39
2014,Sierra Leone,Jimmi Bago,4,7,0,10,9,0,0,30,6,9,0,11,7,0,0,33
2014,Sierra Leone,Jembe : Point,12,8,0,14,10,4,0,48,15,11,0,12,23,12,0,73
2014,Sierra Leone,Gondama : Point,10,18,0,12,27,3,0,70,12,15,0,15,23,4,0,69
2014,Sierra Leone,Gerihun : Point,2,9,0,19,37,1,0,68,1,15,0,20,47,5,0,88
2014,Sierra Leone,Freetown : Point,8,29,0,41,72,6,0,156,5,14,0,32,45,5,0,101
2014,Sierra Leone,Bo : District,3,3,0,10,30,4,0,50,6,20,0,35,20,6,0,87
2014,Sierra Leone,Kenema : District,10,30,0,56,72,5,0,173,1,40,0,0,76,8,0,125
2014,Sierra Leone,Bandajuma : Point,3,2,0,15,19,0,0,39,3,4,0,2,2,1,0,12
2014,El Salvador,El Salvador : Dispersed in the country / territory,0,0,0,4,9,0,0,13,0,0,0,4,17,1,0,22
2014,Somalia,Hargeisa : District,724,1044,0,477,2209,27,0,4481,690,1034,0,482,2177,66,0,4449
2014,Somalia,Bossaso : District,187,370,0,159,636,22,0,1374,189,336,0,161,702,38,0,1426
2014,Somalia,Mudug : Gobolka - Region,15,33,0,6,40,0,0,94,30,31,0,6,32,3,0,102
2014,Somalia,Banaadir : Gobolka - Region,8,13,0,1,4,0,0,26,8,7,0,1,26,0,0,42
2014,Serbia and Kosovo (S/RES/1244 (1999)),Vojvodina : Autonomous province,0,542,0,1180,8942,5887,0,16551,0,606,0,1266,10038,3430,0,15340
2014,Serbia and Kosovo (S/RES/1244 (1999)),Serbia : Dispersed in the country / territory,294,337,0,320,798,43,0,1792,294,337,0,320,809,43,0,1803
2014,Serbia and Kosovo (S/RES/1244 (1999)),Kosovo (S/RES/1244 (1999)) : Dispersed in the country / territory,1048,1154,0,1199,3577,1320,0,8298,1117,1158,0,1225,4706,1281,0,9487
2014,Serbia and Kosovo (S/RES/1244 (1999)),Central and Southern Serbia : Regional grouping,7,1941,0,3066,17580,6907,0,29501,8,2050,0,3167,18524,5534,0,29283
2014,Serbia and Kosovo (S/RES/1244 (1999)),Belgrade : Capital city,32,5621,0,8316,48320,18970,0,81259,19,6002,0,8923,49193,14088,0,78225
2014,South Sudan,Yusuf Batil,4232,5030,0,2509,7868,753,0,20392,4462,5033,0,2725,6688,940,0,19848
2014,South Sudan,Yida : Point,8326,9878,0,5762,13996,687,0,38649,8636,9653,0,5062,7337,495,0,31183
2014,South Sudan,Yei : County,119,213,0,124,303,4,0,763,124,189,0,161,858,3,0,1335
2014,South Sudan,Tambura : County,78,142,0,38,216,6,0,480,97,123,0,42,125,2,0,389
2014,South Sudan,Renk,3,21,0,6,34,2,0,66,11,23,0,3,62,1,0,100
2014,South Sudan,Pochalla : County,191,347,0,230,563,28,0,1359,204,408,0,181,175,12,0,980
2014,South Sudan,Naandi : Point,19,42,0,16,57,8,0,142,23,40,0,19,53,7,0,142
2014,South Sudan,Morobo : County,24,31,0,22,50,4,0,131,22,36,0,16,25,3,0,102
2014,South Sudan,Maridi : County,22,61,0,18,70,0,0,171,33,52,0,29,109,1,0,224
2014,South Sudan,Malakal : County,8,12,0,3,18,1,0,42,4,13,0,3,50,0,0,70
2014,South Sudan,Makpandu : Point,292,398,0,180,792,62,0,1724,278,348,0,202,766,63,0,1657
2014,South Sudan,Lelo,67,146,0,78,193,8,0,492,70,129,0,69,217,4,0,489
2014,South Sudan,Lasu : Point,796,1022,0,558,1694,176,0,4246,767,953,0,641,1260,90,0,3711
2014,South Sudan,Kodok,112,207,0,68,236,20,0,643,110,192,0,52,177,25,0,556
2014,South Sudan,Kaya,2505,2692,0,1438,4410,383,0,11428,2551,2651,0,1374,3391,523,0,10490
2014,South Sudan,Juba : County,228,373,0,136,852,12,0,1601,260,320,0,143,3551,72,0,4346
2014,South Sudan,Gorom : Point,179,251,0,113,476,21,0,1040,210,276,0,119,629,5,0,1239
2014,South Sudan,Gendrassa,1931,2222,0,1095,3524,254,0,9026,2159,2121,0,1131,3174,364,0,8949
2014,South Sudan,Ezo : County,278,362,0,184,1004,86,0,1914,311,358,0,176,635,85,0,1565
2014,South Sudan,Doro : Point,5816,6177,0,3164,9610,593,0,25360,6326,6320,0,3523,8009,549,0,24727
2014,South Sudan,Andari : Point,24,30,0,16,86,5,0,161,18,43,0,14,60,9,0,144
2014,South Sudan,Ajuong Thok,1287,1153,0,799,2403,92,0,5734,1360,1350,0,1754,4716,101,0,9281
2014,South Sudan,Source Yubu : Point,94,139,0,58,290,15,0,596,102,146,0,57,152,14,0,471
2014,Suriname,Suriname,0,0,0,0,0,0,0,0,0,0,0,0,2,0,0,2
2014,Slovenia,Slovenia : Dispersed in the country / territory,2,10,0,8,51,0,0,71,4,17,0,26,143,0,0,190
2014,Slovenia,Ljubljana : Obcine - Municipality,0,0,0,0,22,0,0,22,0,0,0,5,42,0,0,47
2014,Swaziland,Malindza : Point,33,43,0,25,94,1,0,196,30,45,0,46,133,2,0,256
2014,Swaziland,Swaziland : Dispersed in the country / territory,11,15,0,13,92,1,0,132,6,19,0,13,166,4,0,208
2014,Sint Maarten (Dutch part),Sint Maarten (Dutch part) : Dispersed in the country / territory,0,0,0,0,3,0,0,3,0,0,0,1,4,0,0,5
2014,Syrian Arab Rep.,Tartous : Mohafazah - Governorate,18,59,0,114,42,4,0,237,16,55,0,101,38,5,0,215
2014,Syrian Arab Rep.,Syrian Arab Republic : Dispersed in the country / territory,38,83,0,153,54,5,0,333,30,112,0,111,53,7,0,313
2014,Syrian Arab Rep.,Raqqa : Mohafazah - Governorate,8,17,0,19,13,1,0,58,8,16,0,15,10,0,0,49
2014,Syrian Arab Rep.,Lattakia : Mohafazah - Governorate,13,45,0,81,44,5,0,188,20,59,0,99,37,2,0,217
2014,Syrian Arab Rep.,Idleb : Mohafazah - Governorate,1,10,0,24,22,1,0,58,8,17,0,20,21,1,0,67
2014,Syrian Arab Rep.,Homs : Mohafazah - Governorate,28,80,0,112,138,8,0,366,32,90,0,105,143,22,0,392
2014,Syrian Arab Rep.,Hassakeh : Mohafazah - Governorate,315,834,0,1122,353,31,0,2655,280,834,0,559,227,26,0,1926
2014,Syrian Arab Rep.,Hama : Mohafazah - Governorate,6,9,0,16,29,3,0,63,5,16,0,20,15,3,0,59
2014,Syrian Arab Rep.,Dayr Az-Zor : Mohafazah - Governorate,29,96,0,117,58,3,0,303,38,99,0,82,48,3,0,270
2014,Syrian Arab Rep.,Dara : Mohafazah - Governorate,19,59,0,64,60,5,0,207,17,66,0,54,51,5,0,193
2014,Syrian Arab Rep.,Damascus : Mohafazah - Governorate,775,2442,0,4351,1966,181,0,9715,750,2485,0,4113,1926,236,0,9510
2014,Syrian Arab Rep.,As-Suweida : Mohafazah - Governorate,2,5,0,13,1,0,0,21,0,7,0,8,2,0,0,17
2014,Syrian Arab Rep.,Aleppo : Mohafazah - Governorate,55,114,0,180,234,20,0,603,66,138,0,181,204,33,0,622
2014,Syrian Arab Rep.,Al Qunaytirah : Mohafazah - Governorate,0,2,0,0,1,0,0,3,2,2,0,0,1,0,0,5
2014,Turks and Caicos Islands,Turks and Caicos Islands : Dispersed in the country / territory,0,0,0,0,2,0,0,2,0,0,0,0,6,0,0,6
2014,Chad,Treguine : Point,2154,2357,0,1587,4870,563,0,11531,2118,2420,0,1709,3585,438,0,10270
2014,Chad,Touloum : Point,2388,3117,0,3672,7144,652,0,16973,2415,3062,0,3268,3564,401,0,12710
2014,Chad,Oure Cassoni : Point,2422,4227,0,4624,9665,774,0,21712,2378,4233,0,3847,3944,352,0,14754
2014,Chad,Ngouboua : Point,308,395,0,142,571,20,0,1436,300,343,0,111,357,35,0,1146
2014,Chad,N'Djamena : Region,325,380,0,316,947,33,0,2001,322,396,0,319,1442,70,0,2549
2014,Chad,Moyo : Point,1173,1656,0,661,2321,211,0,6022,1144,1516,0,683,1343,144,0,4830
2014,Chad,Moissala : Point,125,151,0,42,210,4,0,532,127,158,0,57,144,3,0,489
2014,Chad,Mile : Point,2120,2781,0,1988,5069,452,0,12410,2178,2646,0,1776,2418,295,0,9313
2014,Chad,Kounoungou : Point,1717,2665,0,2412,5349,440,0,12583,1624,2552,0,2248,2634,319,0,9377
2014,Chad,Kerfi,149,130,0,60,220,23,0,582,129,156,0,63,242,21,0,611
2014,Chad,Iridimi : Point,1876,2545,0,2761,5353,496,0,13031,1908,2432,0,2463,2755,319,0,9877
2014,Chad,Goz Amer : Point,3131,3828,0,2212,6960,786,0,16917,3048,3886,0,2402,4566,658,0,14560
2014,Chad,Gondje : Point,721,1639,0,1365,2668,125,0,6518,738,1539,0,1412,1860,71,0,5620
2014,Chad,Gaga : Point,2164,3255,0,2037,5392,334,0,13182,2150,3165,0,2147,3629,318,0,11409
2014,Chad,Farchana : Point,2419,3020,0,2393,6443,711,0,14986,2510,2980,0,2463,4133,476,0,12562
2014,Chad,Dosseye : Point,1833,3240,0,1823,4368,268,0,11532,1874,3098,0,1819,2955,244,0,9990
2014,Chad,Doholo : Point,198,204,0,113,321,23,0,859,189,231,0,77,275,16,0,788
2014,Chad,Djabal : Point,1958,2323,0,1643,4805,483,0,11212,2015,2337,0,1742,3150,353,0,9597
2014,Chad,Dembo : Point,295,314,0,90,467,26,0,1192,319,298,0,89,324,15,0,1045
2014,Chad,Bredjing : Point,3630,4380,0,3212,9581,1127,0,21930,3664,4476,0,3310,6957,809,0,19216
2014,Chad,Belome : Point,2260,3290,0,2118,6042,490,0,14200,2327,3150,0,2202,4321,321,0,12321
2014,Chad,Bekourou : Point,207,263,0,108,387,14,0,979,222,292,0,104,268,15,0,901
2014,Chad,Amboko : Point,689,1435,0,1489,2625,141,0,6379,673,1351,0,1417,1871,128,0,5440
2014,Chad,Am Nabak : Point,2458,2966,0,2606,6274,581,0,14885,2513,2881,0,2163,2703,408,0,10668
2014,Chad,Abgadam : Point,2298,3808,0,1412,4880,420,0,12818,2286,3441,0,1023,1765,238,0,8753
2014,Togo,Tandjoare : Prefecture,1255,1433,0,626,2209,306,0,5829,1205,1517,0,485,295,48,0,3550
2014,Togo,Sotouboua : Prefecture,679,899,0,265,1374,146,0,3363,667,1001,0,448,937,141,0,3194
2014,Togo,Lome : Commune,132,148,0,140,684,20,0,1124,142,168,0,117,947,32,0,1406
2014,Togo,Dankpen : Prefecture,169,252,0,120,397,63,0,1001,178,273,0,139,276,39,0,905
2014,Togo,Avepozo,113,112,0,53,419,6,0,703,99,117,0,62,542,6,0,826
2014,Togo,Site Tandjouare: Prefecture,70,83,0,27,159,20,0,359,67,89,0,32,38,5,0,231
2014,Thailand,Umpium : Point,806,1262,0,1111,4380,425,0,7984,874,1355,0,1117,4425,366,0,8137
2014,Thailand,Tham Hin : Point,465,715,0,518,1933,208,0,3839,478,709,0,486,1715,188,0,3576
2014,Thailand,Nu Po : Point,716,1210,0,997,3537,337,0,6797,756,1193,0,929,3388,314,0,6580
2014,Thailand,Mai Nai Soi : Point,639,1099,0,848,3120,374,0,6080,640,1185,0,804,3446,367,0,6442
2014,Thailand,Mae La Oon : Point,824,1073,0,900,2988,330,0,6115,871,1087,0,959,3002,334,0,6253
2014,Thailand,Mae La : Point,2345,3982,0,3563,12417,1369,0,23676,2496,4191,0,3782,11678,1199,0,23346
2014,Thailand,Ban Don Yang : Point,235,405,0,318,1077,102,0,2137,253,418,0,320,979,109,0,2079
2014,Thailand,Thailand : Dispersed in the country / territory,12,26,0,31,103,2,0,174,6,18,0,58,385,3,0,470
2014,Thailand,Mae Ra Ma Luang : Point,907,1257,0,1137,3427,357,0,7085,885,1358,0,1108,3113,387,0,6851
2014,Thailand,Bangkok : Metropolitan administration,469,569,0,387,2239,113,0,3777,474,643,0,406,3184,114,0,4821
2014,Thailand,Ban Mae Surin : Point,150,185,0,152,607,77,0,1171,130,200,0,183,596,65,0,1174
2014,Tajikistan,"Dushanbe, capital city",0,1,0,0,2,0,0,3,1,0,0,2,0,0,0,3
2014,Tajikistan,Dushanbe : Capital city,9,50,0,53,81,2,0,195,9,32,0,52,83,2,0,178
2014,Turkmenistan,Mary : Region,0,0,0,0,0,0,0,0,0,0,0,0,1,0,0,1
2014,Turkmenistan,Turkmenbashi : District,0,0,0,0,1,3,0,4,0,0,0,0,1,0,0,1
2014,Turkmenistan,Turkmenabat : District,0,0,0,1,8,0,0,9,0,0,0,0,8,0,0,8
2014,Turkmenistan,Ashgabat : Capital city,0,0,0,0,3,2,0,5,0,0,0,0,7,0,0,7
2014,Timor-Leste,Dili : District,0,0,0,0,1,0,0,1,1,0,0,0,4,0,0,5
2014,Trinidad and Tobago,Port of Spain : Municipality,0,4,0,4,32,1,0,41,6,3,0,5,115,0,0,129
2014,Tunisia,Nabeul,0,0,0,1,0,1,0,2,0,1,0,1,2,0,0,4
2014,Tunisia,Kasserine,1,3,0,1,8,2,0,15,1,5,0,3,10,0,0,19
2014,Tunisia,Kairouan,1,1,0,1,1,0,0,4,0,1,0,0,0,0,0,1
2014,Tunisia,Tunis : Wilayah - Governorate,29,29,0,15,159,7,0,239,20,47,0,20,247,6,0,340
2014,Tunisia,Sousse : Wilayah - Governorate,7,12,0,4,29,1,0,53,8,15,0,7,39,2,0,71
2014,Tunisia,Sfax : Wilayah - Governorate,0,4,0,2,11,0,0,17,1,3,0,1,5,0,0,10
2014,Tunisia,Monastir : Mutamadiyah - Delegation,0,0,0,0,0,0,0,0,0,0,0,0,1,0,0,1
2014,Tunisia,Medenine : Wilayah - Governorate,7,12,0,14,44,1,0,78,17,18,0,26,214,5,0,280
2014,Tunisia,Bizerte : Wilayah - Governorate,0,0,0,0,1,0,0,1,0,0,0,0,0,0,0,0
2014,Turkey,Zonguldak,72,94,0,52,304,9,0,531,74,103,0,73,571,14,0,835
2014,Turkey,Yozgat Camp,2,6,0,5,12,0,0,25,2,6,0,6,4,0,0,18
2014,Turkey,Yozgat,74,109,0,79,351,31,0,644,73,90,0,117,357,31,0,668
2014,Turkey,Yalova,147,192,0,133,877,65,0,1414,151,198,0,157,1371,56,0,1933
2014,Turkey,Van,51,57,0,33,240,4,0,385,43,64,0,104,454,7,0,672
2014,Turkey,Usak,60,95,0,48,271,8,0,482,66,104,0,69,401,11,0,651
2014,Turkey,Urfa,13,6,0,19,38,0,0,76,10,26,0,16,42,1,0,95
2014,Turkey,Trabzon,61,89,0,59,244,6,0,459,71,85,0,69,487,3,0,715
2014,Turkey,Tokat,98,141,0,108,483,34,0,864,94,156,0,132,628,31,0,1041
2014,Turkey,Tekirdag,1,4,0,2,11,0,0,18,2,5,0,3,18,1,0,29
2014,Turkey,Sivas,110,180,0,141,538,9,0,978,109,185,0,186,940,19,0,1439
2014,Turkey,Sirnak,64,82,0,70,209,14,0,439,52,70,0,76,187,19,0,404
2014,Turkey,Sinop,80,98,0,56,326,14,0,574,78,116,0,84,620,5,0,903
2014,Turkey,Siirt,31,47,0,38,130,7,0,253,37,48,0,50,143,5,0,283
2014,Turkey,Sanliurfa,6,23,0,11,35,2,0,77,11,16,0,10,44,2,0,83
2014,Turkey,Samsun,404,461,0,279,1395,74,0,2613,424,495,0,399,2677,69,0,4064
2014,Turkey,Sakarya,98,146,0,115,495,36,0,890,102,157,0,127,746,37,0,1169
2014,Turkey,Osmaniye,2,1,0,0,3,0,0,6,0,1,0,0,1,0,0,2
2014,Turkey,Ordu,16,17,0,19,71,2,0,125,9,27,0,20,100,3,0,159
2014,Turkey,Nigde,235,306,0,262,1181,84,0,2068,268,357,0,276,1797,63,0,2761
2014,Turkey,Nevsehir,118,135,0,99,633,16,0,1001,127,151,0,135,1080,20,0,1513
2014,Turkey,Mus : Province,2,1,0,0,3,0,0,6,0,0,0,0,4,0,0,4
2014,Turkey,Mugla,0,0,0,0,1,0,0,1,0,0,0,0,1,0,0,1
2014,Turkey,Mersin,86,164,0,114,532,33,0,929,95,169,0,136,626,44,0,1070
2014,Turkey,Mardin,129,187,0,146,406,40,0,908,128,187,0,167,425,24,0,931
2014,Turkey,Manisa,71,125,0,92,429,20,0,737,102,142,0,125,1015,18,0,1402
2014,Turkey,Malatya,49,89,0,63,262,6,0,469,62,103,0,86,410,13,0,674
2014,Turkey,Kutahya,123,132,0,94,483,13,0,845,129,162,0,123,737,25,0,1176
2014,Turkey,Konya,176,236,0,175,821,29,0,1437,216,272,0,239,1284,32,0,2043
2014,Turkey,Kocaeli,0,0,0,0,1,0,0,1,0,0,0,1,5,0,0,6
2014,Turkey,Kirsehir,115,186,0,139,612,72,0,1124,159,217,0,154,791,56,0,1377
2014,Turkey,Kirklareli,1,3,0,5,17,2,0,28,3,7,0,4,21,1,0,36
2014,Turkey,Kirikkale,152,220,0,132,606,28,0,1138,142,170,0,155,986,31,0,1484
2014,Turkey,Kilis,5,11,0,3,18,1,0,38,5,11,0,5,21,2,0,44
2014,Turkey,Kayseri,157,221,0,164,1011,54,0,1607,152,278,0,184,1450,44,0,2108
2014,Turkey,Kastamonu,101,136,0,79,450,26,0,792,104,155,0,125,895,22,0,1301
2014,Turkey,Kars,25,46,0,34,115,4,0,224,14,59,0,31,168,1,0,273
2014,Turkey,Karaman,64,91,0,56,288,9,0,508,69,107,0,95,497,14,0,782
2014,Turkey,Karabuk,107,146,0,72,405,22,0,752,107,140,0,120,783,21,0,1171
2014,Turkey,Kahramanmaras,20,46,0,27,124,3,0,220,20,42,0,32,132,3,0,229
2014,Turkey,Izmit,0,0,0,0,0,0,0,0,0,0,0,0,1,1,0,2
2014,Turkey,Izmir,21,42,0,28,148,4,0,243,21,45,0,38,260,6,0,370
2014,Turkey,Istanbul,637,866,0,685,3393,179,0,5760,709,1018,0,905,5126,195,0,7953
2014,Turkey,Isparta,130,209,0,142,800,30,0,1311,171,224,0,158,1191,36,0,1780
2014,Turkey,Iskenderun,0,0,0,0,1,0,0,1,0,0,0,1,0,0,0,1
2014,Turkey,Igdir,0,1,0,1,2,0,0,4,0,0,0,1,2,0,0,3
2014,Turkey,Hatay,35,55,0,42,147,7,0,286,46,52,0,50,169,6,0,323
2014,Turkey,Hakkari,0,1,0,0,2,0,0,3,0,0,0,1,2,0,0,3
2014,Turkey,Gumushane,9,12,0,8,51,0,0,80,5,15,0,20,144,2,0,186
2014,Turkey,Giresun,41,38,0,31,143,2,0,255,39,47,0,61,216,3,0,366
2014,Turkey,Gaziantep,111,177,0,121,499,30,0,938,124,181,0,125,682,29,0,1141
2014,Turkey,Eskisehir,205,282,0,183,1130,50,0,1850,258,338,0,232,1640,53,0,2521
2014,Turkey,Erzurum,22,64,0,56,202,5,0,349,22,66,0,51,266,12,0,417
2014,Turkey,Erzincan,58,80,0,68,203,4,0,413,42,89,0,67,422,4,0,624
2014,Turkey,Elazig,13,13,0,11,71,2,0,110,7,24,0,19,116,0,0,166
2014,Turkey,Edirne,4,2,0,3,14,0,0,23,8,5,0,3,35,0,0,51
2014,Turkey,Duzce,173,178,0,107,670,37,0,1165,165,206,0,161,1134,39,0,1705
2014,Turkey,Diyarbakir,117,193,0,179,415,39,0,943,176,213,0,207,379,23,0,998
2014,Turkey,Denizli,178,269,0,215,1430,31,0,2123,210,300,0,253,2747,39,0,3549
2014,Turkey,Corum,164,201,0,110,550,35,0,1060,169,225,0,152,762,31,0,1339
2014,Turkey,Cankiri,245,330,0,191,1026,70,0,1862,283,397,0,278,1868,76,0,2902
2014,Turkey,Canakkale,99,125,0,96,819,15,0,1154,126,161,0,128,2265,15,0,2695
2014,Turkey,Bursa,5,4,0,14,31,2,0,56,9,11,0,9,29,1,0,59
2014,Turkey,Burdur,33,69,0,67,393,9,0,571,42,71,0,136,606,12,0,867
2014,Turkey,Bolu,253,299,0,193,1024,54,0,1823,320,311,0,258,1803,50,0,2742
2014,Turkey,Bilecik,104,136,0,88,470,36,0,834,98,156,0,100,1033,26,0,1413
2014,Turkey,Bayburt,13,20,0,13,51,1,0,98,7,19,0,19,88,1,0,134
2014,Turkey,Batman,80,123,0,81,286,10,0,580,64,137,0,109,347,7,0,664
2014,Turkey,Balikesir,204,286,0,167,1077,34,0,1768,227,334,0,258,2223,48,0,3090
2014,Turkey,Aydin,0,0,0,0,0,0,0,0,0,0,0,0,1,0,0,1
2014,Turkey,Artvin,1,0,0,0,3,0,0,4,0,2,0,0,13,0,0,15
2014,Turkey,Ardahan,1,4,0,7,12,1,0,25,1,4,0,5,21,0,0,31
2014,Turkey,Antalya,0,1,0,1,8,0,0,10,3,2,0,3,9,1,0,18
2014,Turkey,Ankara,49,81,0,61,356,25,0,572,41,87,0,92,513,26,0,759
2014,Turkey,Amasya,180,283,0,189,806,53,0,1511,194,268,0,261,1224,53,0,2000
2014,Turkey,Aksaray,130,213,0,146,564,40,0,1093,147,217,0,177,752,34,0,1327
2014,Turkey,Agri,20,28,0,36,113,4,0,201,15,48,0,113,255,6,0,437
2014,Turkey,Adiyaman,2,0,0,0,14,0,0,16,8,3,0,4,14,1,0,30
2014,Turkey,Adapazari,1,0,0,0,1,0,0,2,0,0,0,0,2,0,0,2
2014,Turkey,Adana,57,123,0,101,482,24,0,787,69,143,0,125,673,22,0,1032
2014,Turkey,Turkey : Dispersed in the country / territory,28,29,0,125,68,5,0,255,19,35,0,1356,157,3,0,1570
2014,Turkey,Afyonkarahisar : Province,135,193,0,155,650,61,0,1194,151,205,0,177,769,59,0,1361
2014,United Rep. of Tanzania,Ulyankulu : Point,3040,6743,0,4120,10449,881,0,25233,2884,6433,0,4407,9661,672,0,24057
2014,United Rep. of Tanzania,Nyarugusu : Point,4328,5935,0,4766,12690,970,0,28689,4572,6968,0,5694,12012,916,0,30162
2014,United Rep. of Tanzania,Mishamo : Point,3562,6667,0,5109,11820,1090,0,28248,3505,6721,0,4349,11390,1167,0,27132
2014,United Rep. of Tanzania,Kigoma : Region,1742,2103,0,2009,4554,367,0,10775,1730,2279,0,1993,5028,422,0,11452
2014,United Rep. of Tanzania,Katumba : Point,3622,7867,0,6290,14935,1351,0,34065,3725,7748,0,5617,13858,1403,0,32351
2014,United Rep. of Tanzania,Dar es Salaam : Region,3,6,0,2,5,1,0,17,2,4,0,1,19,0,0,26
2014,United Rep. of Tanzania,Chogo : Point,6,7,0,13,47,0,0,73,5,8,0,11,52,1,0,77
2014,Uganda,Rwamanja : Point,6417,6223,0,3344,9673,393,0,26050,6271,6230,0,3535,10367,363,0,26766
2014,Uganda,Rhino Camp : Point,1630,2698,0,1872,3170,233,0,9603,1763,2844,0,2344,2188,80,0,9219
2014,Uganda,Oruchinga : Point,564,675,0,362,1055,69,0,2725,549,640,0,346,913,63,0,2511
2014,Uganda,Nakivale : Point,6574,8714,0,5799,14366,667,0,36120,6514,8886,0,5823,14297,650,0,36170
2014,Uganda,Kyangwali : Point,4169,4956,0,3080,7693,535,0,20433,4106,5081,0,3112,7262,486,0,20047
2014,Uganda,Kyaka II,2689,2962,0,2358,3356,181,0,11546,2651,2994,0,2286,3124,167,0,11222
2014,Uganda,Koboko,433,806,0,362,868,74,0,2543,434,857,0,388,478,40,0,2197
2014,Uganda,Kiryandongo : District,2990,4425,0,3211,6785,501,0,17912,3157,4529,0,3601,5199,239,0,16725
2014,Uganda,Kampala : City,3297,6482,0,6520,16894,450,0,33643,3580,6569,0,7040,20799,388,0,38376
2014,Uganda,Adjumani : District,7799,13588,0,8304,20369,2098,0,52158,8237,14136,0,8967,12796,886,0,45022
2014,Uganda,Uganda : Dispersed in the country / territory,0,0,0,0,1,0,0,1,0,0,0,0,0,0,0,0
2014,Uruguay,Montevideo : Department,4,14,0,19,72,9,0,118,4,15,0,17,160,14,0,210
2014,Uzbekistan,Termez : District,0,0,0,0,1,0,0,1,0,0,0,0,7,0,0,7
2014,Uzbekistan,Tashkent : City,1,5,0,2,36,6,0,50,2,4,0,6,48,7,0,67
2014,Venezuela (Bolivarian Republic of),Zulia : Point,2,2,0,5,25,0,0,34,3,3,0,1,38,2,0,47
2014,Venezuela (Bolivarian Republic of),Venezuela : Dispersed in the country / territory,99,272,0,395,1549,42,0,2357,149,336,0,480,1629,101,0,2695
2014,Venezuela (Bolivarian Republic of),Tachira : Point,4,2,0,1,13,0,0,20,2,2,0,2,22,1,0,29
2014,Venezuela (Bolivarian Republic of),Caracas : Point,8,5,0,6,66,2,0,87,6,6,0,12,128,2,0,154
2014,Venezuela (Bolivarian Republic of),Apure : Point,2,1,0,3,13,2,0,21,3,2,0,6,21,2,0,34
2014,Vanuatu,Port Vila : Point,0,0,0,0,1,0,0,1,0,0,0,0,0,0,0,0
2014,Yemen,Rada' : District,29,18,0,17,56,5,0,125,25,33,0,32,62,5,0,157
2014,Yemen,Mukalla : Point,226,737,0,345,1953,107,0,3368,229,667,0,362,4526,154,0,5938
2014,Yemen,Al Kharaz : Point,1037,1754,0,1300,4121,124,0,8336,1234,1845,0,1350,3574,161,0,8164
2014,Yemen,Yemen : Dispersed in the country / territory,3085,8101,0,6189,36422,1600,0,55397,3550,8146,0,6710,62789,1415,0,82610
2014,Yemen,Taizz: Muhafazah - Governorate,65,153,0,148,622,42,0,1030,81,141,0,124,343,30,0,719
2014,Yemen,Shabwah: Muhafazah - Governorate,15,28,0,29,151,6,0,229,12,22,0,22,171,2,0,229
2014,Yemen,Sana’a: Muhafazah – Governorate,4356,9254,0,5770,22929,1340,0,43649,4670,10368,0,6375,26233,1446,0,49092
2014,Yemen,"S,adah : Muhafazah - Governorate",4344,14839,0,9536,22398,1231,0,52348,4064,16128,0,12143,20776,1543,0,54654
2014,Yemen,Hajjah : Muhafazah - Governorate,2746,13185,0,8201,18182,1017,0,43331,2737,13888,0,10087,17273,1287,0,45272
2014,Yemen,Dhamar: Muhafazah – Governorate,18,19,0,18,78,2,0,135,17,16,0,16,47,4,0,100
2014,Yemen,Dhamar : Muhafazah - Governorate,125,443,0,306,591,37,0,1502,128,454,0,314,607,38,0,1541
2014,Yemen,Amran : Muhafazah - Governorate,2565,10880,0,6890,16285,919,0,37539,2514,10832,0,7308,12402,953,0,34009
2014,Yemen,Al-Bayda: Muhafazah – Governorate,8,34,0,33,86,7,0,168,14,23,0,23,92,2,0,154
2014,Yemen,Al-Bayda : Muhafazah - Governorate,222,785,0,542,1047,66,0,2662,229,811,0,560,1082,69,0,2751
2014,Yemen,Al Maharah: Muhafazah – Governorate,54,176,0,83,468,26,0,807,55,160,0,86,1084,37,0,1422
2014,Yemen,Al Jawf : Muhafazah - Governorate,838,3593,0,2264,5503,302,0,12500,889,3879,0,2613,4477,342,0,12200
2014,Yemen,Al Hudaydah: Muhafazah - Governorate,20,40,0,41,109,24,0,234,19,55,0,55,104,19,0,252
2014,Yemen,Aden: Muhafazah – Governorate,787,1621,0,1622,11214,365,0,15609,873,1613,0,2356,29316,325,0,34483
2014,Yemen,Abyan: Muhafazah – Governorate,2558,5726,0,4609,21925,2587,0,37405,2933,6078,0,5086,19713,2286,0,36096
2014,Zambia,Meheba : Point,1055,2154,0,1335,3452,260,0,8256,1143,2129,0,1303,4007,397,0,8979
2014,Zambia,Mayukwayukwa : Point,831,1209,0,799,2337,139,0,5315,821,1215,0,773,2561,285,0,5655
2014,Zambia,Lusaka : District,314,821,0,586,2152,167,0,4040,331,799,0,694,3550,193,0,5567
2014,Zambia,Zambia : Dispersed in the country / territory,637,1444,0,979,2712,400,0,6172,602,1314,0,1018,2786,512,0,6232
2014,Zimbabwe,Tongogara : Point,576,722,0,483,1300,38,0,3119,617,818,0,714,2016,26,0,4191
2014,Zimbabwe,Harare : City,62,102,0,72,273,5,0,514,61,97,0,79,394,9,0,640
2015,Aruba,Aruba : Dispersed in the country / territory,0,0,0,0,0,0,0,0,0,0,0,0,2,0,0,2
2015,Afghanistan,Badakhshan,28,24,0,16,28,0,0,96,11,13,0,3,35,0,0,62
2015,Afghanistan,Badakhshan : Wilayat - Province,1970,2437,0,1490,3234,388,0,9519,1552,2043,0,1587,3218,523,0,8923
2015,Afghanistan,Badghis : Wilayat - Province,5341,5282,0,6620,11257,1771,0,30271,5273,4746,0,7577,10998,2002,0,30596
2015,Afghanistan,Badghis : Wllayat - Province,9,9,0,6,12,0,0,36,7,7,0,6,12,1,0,33
2015,Afghanistan,Baghlan : Wilayat - Province,2341,2220,0,1771,3146,336,0,9814,1687,2298,0,2033,3016,450,0,9484
2015,Afghanistan,Baghlan : Wllayat - Province,596,565,0,427,996,48,0,2632,564,615,0,428,837,109,0,2553
2015,Afghanistan,Balkh : Wilayat - Province,2167,3392,0,3522,5762,1477,0,16320,2213,3286,0,3388,5575,1774,0,16236
2015,Afghanistan,Bamyan : Wilayat - Province,2,9,0,9,184,9,0,213,4,9,0,15,197,16,0,241
2015,Afghanistan,Bamyan: Wilayat - Province,5,13,0,14,154,8,0,194,8,15,0,15,162,14,0,214
2015,Afghanistan,Daykundi : Wilayat - Province,11,11,0,15,96,2,0,135,15,20,0,20,171,4,0,230
2015,Afghanistan,Farah : Wilayat - Province,3717,4437,0,6549,7882,713,0,23298,2404,4003,0,6046,8033,1101,0,21587
2015,Afghanistan,Faryab : Wilayat - Province,5615,7110,0,7896,14358,4011,0,38990,5725,6895,0,7699,13653,3838,0,37810
2015,Afghanistan,Ghazni : Wilayat - Province,3833,4811,0,4426,10648,886,0,24604,4911,7079,0,5678,13515,1383,0,32566
2015,Afghanistan,Ghor : Wilayat - Province,4524,5075,0,3444,8183,771,0,21997,4061,5126,0,3902,8207,832,0,22128
2015,Afghanistan,Helmand : Wilayat - Province,556,789,0,589,937,116,0,2987,448,631,0,531,921,124,0,2655
2015,Afghanistan,Herat : Wilayat - Province,2378,2856,0,1759,6445,296,0,13734,2114,3144,0,2491,6044,325,0,14118
2015,Afghanistan,Hilmand : Wilayat - Province,13372,13544,0,12109,32178,3864,0,75067,15594,14447,0,10914,31263,3428,0,75646
2015,Afghanistan,Hirat : Wilayat - Province,9637,12540,0,6392,22271,1215,0,52055,7802,13365,0,10321,19235,952,0,51675
2015,Afghanistan,Jawzjan : Wilayat - Province,1707,2091,0,2120,3265,441,0,9624,1542,1788,0,1926,2909,537,0,8702
2015,Afghanistan,Kabul : Wilayat - Province,10286,12422,0,10198,24328,1992,0,59226,11253,14786,0,11514,25489,2799,0,65841
2015,Afghanistan,Kandahar : Wilayat - Province,7596,6757,0,5096,11366,1492,0,32307,7970,6998,0,5289,12199,1731,0,34187
2015,Afghanistan,Kapisa : Wilayat - Province,984,1151,0,964,2400,187,0,5686,1167,1463,0,1176,2827,225,0,6858
2015,Afghanistan,Khost : Wilayat - Province,23513,16290,0,23076,28820,4501,0,96200,20808,17596,0,25084,26628,5363,0,95479
2015,Afghanistan,Kunar : Wilayat - Province,5541,6262,0,3531,9768,431,0,25533,5394,6647,0,3935,9651,581,0,26208
2015,Afghanistan,Kunduz : Wilayat - Province,9107,8533,0,6088,16163,1685,0,41576,8802,9114,0,7147,15179,1748,0,41990
2015,Afghanistan,Laghman : Wilayat - Province,1853,2026,0,1365,2970,76,0,8290,1833,2030,0,1388,2833,163,0,8247
2015,Afghanistan,Logar : Wilayat - Province,2413,2745,0,2446,5630,305,0,13539,2770,3551,0,2784,5546,504,0,15155
2015,Afghanistan,Nangarhar : Wilayat - Province,22126,22600,0,15802,37416,1189,0,99133,22640,24976,0,17823,35171,1749,0,102359
2015,Afghanistan,Nimroz,14,34,0,31,24,0,0,103,17,17,0,17,44,0,0,95
2015,Afghanistan,Nimroz : Wilayat - Province,231,252,0,193,380,41,0,1097,265,242,0,204,380,50,0,1141
2015,Afghanistan,Nuristan : Wilayat - Province,803,784,0,338,1376,4,0,3305,638,960,0,581,1682,11,0,3872
2015,Afghanistan,Paktia : Wilayat - Province,657,704,0,686,1473,85,0,3605,658,777,0,611,1083,150,0,3279
2015,Afghanistan,Paktika : Wilayat - Province,3844,6045,0,6028,17742,1462,0,35121,2540,5211,0,5472,17150,1969,0,32342
2015,Afghanistan,Paktya : Wilayat - Province,2603,2579,0,2412,4071,423,0,12088,2744,2964,0,2088,3720,449,0,11965
2015,Afghanistan,Panjsher : Wilayat - Province,5,14,0,12,17,2,0,50,7,8,0,8,12,3,0,38
2015,Afghanistan,Panjshir : Wilayat - Province,178,231,0,184,477,53,0,1123,236,286,0,221,564,67,0,1374
2015,Afghanistan,Parwan : Wilayat - Province,1191,1284,0,1269,2757,195,0,6696,1381,1791,0,1411,3243,321,0,8147
2015,Afghanistan,Samangan : Wilayat - Province,217,259,0,255,632,108,0,1471,207,234,0,239,658,128,0,1466
2015,Afghanistan,Sar-e Pul : Wilayat - Province,165,167,0,103,302,13,0,750,180,161,0,122,190,31,0,684
2015,Afghanistan,Sari Pul : Wilayat - Province,1624,1910,0,1848,4122,991,0,10495,1690,1859,0,1744,3640,1035,0,9968
2015,Afghanistan,Takhar : Wilayat - Province,12183,9403,0,6912,15568,1661,0,45727,10528,9903,0,6798,15651,2386,0,45266
2015,Afghanistan,Urozgan : Wilayat - Province,1,1,0,1,2,0,0,5,1,1,0,1,2,0,0,5
2015,Afghanistan,Uruzgan : Wilayat - Province,3122,2473,0,1859,4305,642,0,12401,3323,2685,0,1986,4642,681,0,13317
2015,Afghanistan,Uruzghon : Wilayat - Province,3,4,0,2,9,0,0,18,6,4,0,3,10,1,0,24
2015,Afghanistan,Wardak : Wilayat - Province,2326,3088,0,3158,7697,369,0,16638,3232,4651,0,3789,9824,704,0,22200
2015,Afghanistan,Zabul : Wilayat - Province,1584,1318,0,983,2297,329,0,6511,1786,1445,0,1079,2463,353,0,7126
2015,Angola,Angola : Dispersed in the country / territory,0,0,0,0,0,0,0,0,0,0,0,0,0,0,0,0
2015,Anguilla,"The Valley, Anguilla",0,0,0,0,0,0,0,0,0,0,0,0,1,0,0,1
2015,Albania,Albania : Dispersed in the country/territory,0,0,0,0,3724,0,0,3724,1,0,0,0,3721,0,0,3722
2015,Albania,Babrru Centre,1,0,0,1,35,1,0,38,0,2,0,2,40,6,0,50
2015,Albania,Fier,0,0,0,0,0,0,0,0,0,0,0,0,1,0,0,1
2015,Albania,Mamurras : Bashki - Municipality,0,1,0,0,1,0,0,2,0,2,0,0,0,0,0,2
2015,Albania,Peshkopi : Bashki - Municipality,0,0,0,0,0,1,0,1,0,0,0,0,0,0,0,0
2015,Albania,Tirana Urban : Point,6,5,0,2,361,57,0,431,6,4,0,4,342,49,0,405
2015,United Arab Emirates,Abu Dhabi : Emirate,36,85,0,53,326,43,0,543,27,78,0,69,321,38,0,533
2015,United Arab Emirates,"Abu Dhabi, Emirates",0,2,0,1,2,0,0,5,0,0,0,1,2,0,0,3
2015,Argentina,Argentina : Dispersed in the country / territory,15,69,0,83,1042,310,0,1519,20,83,0,111,1964,587,0,2765
2015,Armenia,Aragatsotn : Marz - Province,0,0,0,0,39,18,0,57,0,0,0,0,32,10,0,42
2015,Armenia,Ararat : Marz - Province,0,0,0,0,33,33,0,66,0,0,0,0,42,37,0,79
2015,Armenia,Armavir : Marz - Province,0,0,0,0,48,37,0,85,0,0,0,0,47,17,0,64
2015,Armenia,Gergharkunik : Marz - Province,0,0,0,0,35,12,0,47,0,0,0,0,37,12,0,49
2015,Armenia,Kotayk : Marz - Province,0,0,0,0,85,55,0,140,0,0,0,0,88,35,0,123
2015,Armenia,Lori : Marz - Province,0,0,0,0,43,14,0,57,0,0,0,0,38,10,0,48
2015,Armenia,Shirak : Marz - Province,0,0,0,0,15,3,0,18,0,0,0,0,12,3,0,15
2015,Armenia,Syunik : Marz - Province,0,0,0,0,55,18,0,73,0,0,0,0,48,6,0,54
2015,Armenia,Tavush : Marz - Province,0,0,0,0,4,20,0,24,0,0,0,0,0,2,0,2
2015,Armenia,Vayots Dzor : Marz - Province,0,0,0,0,4,0,0,4,0,0,0,0,1,0,0,1
2015,Armenia,Yerevan : City,60,94,0,92,697,211,0,1154,68,95,0,109,764,149,0,1185
2015,Antigua and Barbuda,St. John,0,0,0,0,0,0,0,0,0,0,0,0,15,0,0,15
2015,Australia,Australia : Dispersed in the country / territory,0,0,0,0,0,0,0,0,0,0,0,0,0,0,0,0
2015,Austria,Austria : Dispersed in the country / territory,0,0,0,0,0,0,0,0,0,0,0,0,0,0,0,0
2015,Azerbaijan,Absheron : Rayon,0,0,0,0,0,0,0,0,0,0,0,0,0,0,0,0
2015,Azerbaijan,Aghdam : Rayon,0,0,0,0,0,0,0,0,0,0,0,0,0,0,0,0
2015,Azerbaijan,Aghdash : Rayon,0,0,0,0,0,0,0,0,0,0,0,0,0,0,0,0
2015,Azerbaijan,Aghjabedi : Rayon,0,0,0,0,0,0,0,0,0,0,0,0,0,0,0,0
2015,Azerbaijan,Aghstafa : Rayon,0,0,0,0,0,0,0,0,0,0,0,0,0,0,0,0
2015,Azerbaijan,Aghsu : Rayon,0,0,0,0,0,0,0,0,0,0,0,0,0,0,0,0
2015,Azerbaijan,Astara : Rayon,0,0,0,0,0,0,0,0,0,0,0,0,0,0,0,0
2015,Azerbaijan,Azerbaijan : Dispersed in the country/territory,0,0,0,0,0,0,0,0,0,0,0,0,0,0,0,0
2015,Azerbaijan,Baku : Municipality,57,90,0,82,301,26,0,556,74,91,0,80,510,27,0,782
2015,Azerbaijan,Balakan : Rayon,0,0,0,0,0,0,0,0,0,0,0,0,0,0,0,0
2015,Azerbaijan,Barda : Rayon,0,0,0,0,0,0,0,0,0,0,0,0,0,0,0,0
2015,Azerbaijan,Beylagan : Rayon,0,0,0,0,0,0,0,0,0,0,0,0,0,0,0,0
2015,Azerbaijan,Bilasuvar : Rayon,0,0,0,0,0,0,0,0,0,0,0,0,0,0,0,0
2015,Azerbaijan,Dashkasan : Rayon,0,0,0,0,0,0,0,0,0,0,0,0,0,0,0,0
2015,Azerbaijan,Fuzuli : Rayon,0,0,0,0,0,0,0,0,0,0,0,0,0,0,0,0
2015,Azerbaijan,Gabala : Point,0,0,0,0,0,0,0,0,0,0,0,0,0,0,0,0
2015,Azerbaijan,Gadabay : Rayon,0,0,0,0,0,0,0,0,0,0,0,0,0,0,0,0
2015,Azerbaijan,Gakh : Point,0,0,0,0,0,0,0,0,0,0,0,0,0,0,0,0
2015,Azerbaijan,Ganja : Municipality,0,0,0,0,0,0,0,0,0,0,0,0,0,0,0,0
2015,Azerbaijan,Gazakh : Point,0,0,0,0,0,0,0,0,0,0,0,0,0,0,0,0
2015,Azerbaijan,Gobustan : Rayon,0,0,0,0,0,0,0,0,0,0,0,0,0,0,0,0
2015,Azerbaijan,Goranboy : Rayon,0,0,0,0,0,0,0,0,0,0,0,0,0,0,0,0
2015,Azerbaijan,Goychay : Rayon,0,0,0,0,0,0,0,0,0,0,0,0,0,0,0,0
2015,Azerbaijan,Goygol : Rayon,0,0,0,0,0,0,0,0,0,0,0,0,0,0,0,0
2015,Azerbaijan,Guba : Point,0,0,0,0,0,0,0,0,0,0,0,0,0,0,0,0
2015,Azerbaijan,Gusar : Point,0,0,0,0,0,0,0,0,0,0,0,0,0,0,0,0
2015,Azerbaijan,Hajigabul : Rayon,0,0,0,0,0,0,0,0,0,0,0,0,0,0,0,0
2015,Azerbaijan,Imishli : Rayon,0,0,0,0,0,0,0,0,0,0,0,0,0,0,0,0
2015,Azerbaijan,Ismayilli : Rayon,0,0,0,0,0,0,0,0,0,0,0,0,0,0,0,0
2015,Azerbaijan,Jalilabad : Rayon,0,0,0,0,0,0,0,0,0,0,0,0,0,0,0,0
2015,Azerbaijan,Khachmaz : Rayon,0,0,0,0,0,0,0,0,0,0,0,0,0,0,0,0
2015,Azerbaijan,Khizi : Rayon,0,0,0,0,0,0,0,0,0,0,0,0,0,0,0,0
2015,Azerbaijan,Kurdamir : Rayon,0,0,0,0,0,0,0,0,0,0,0,0,0,0,0,0
2015,Azerbaijan,Lachin (Takhta Korpu) : Point,0,0,0,0,0,0,0,0,0,0,0,0,0,0,0,0
2015,Azerbaijan,Lankaran : Municipality,0,0,0,0,0,0,0,0,0,0,0,0,0,0,0,0
2015,Azerbaijan,Masalli : Rayon,0,0,0,0,0,0,0,0,0,0,0,0,0,0,0,0
2015,Azerbaijan,Mingechavir : Municipality,0,0,0,0,0,0,0,0,0,0,0,0,0,0,0,0
2015,Azerbaijan,Naftalan : Municipality,0,0,0,0,0,0,0,0,0,0,0,0,0,0,0,0
2015,Azerbaijan,Nakhchivan : Autonomous republic,0,0,0,0,0,0,0,0,0,0,0,0,0,0,0,0
2015,Azerbaijan,Neftchala : Rayon,0,0,0,0,0,0,0,0,0,0,0,0,0,0,0,0
2015,Azerbaijan,Oghuz : Rayon,0,0,0,0,0,0,0,0,0,0,0,0,0,0,0,0
2015,Azerbaijan,Saatli : Rayon,0,0,0,0,0,0,0,0,0,0,0,0,0,0,0,0
2015,Azerbaijan,Sabirabad : Rayon,0,0,0,0,0,0,0,0,0,0,0,0,0,0,0,0
2015,Azerbaijan,Salyan : Rayon,0,0,0,0,0,0,0,0,0,0,0,0,0,0,0,0
2015,Azerbaijan,Samukh : Rayon,0,0,0,0,0,0,0,0,0,0,0,0,0,0,0,0
2015,Azerbaijan,Shabran : Rayon,0,0,0,0,0,0,0,0,0,0,0,0,0,0,0,0
2015,Azerbaijan,Shaki : Municipality,0,0,0,0,0,0,0,0,0,0,0,0,0,0,0,0
2015,Azerbaijan,Shamakhi : Rayon,0,0,0,0,0,0,0,0,0,0,0,0,0,0,0,0
2015,Azerbaijan,Shamkir : Rayon,0,0,0,0,0,0,0,0,0,0,0,0,0,0,0,0
2015,Azerbaijan,Shirvan : Municipality,0,0,0,0,0,0,0,0,0,0,0,0,0,0,0,0
2015,Azerbaijan,Siyazan : Rayon,0,0,0,0,0,0,0,0,0,0,0,0,0,0,0,0
2015,Azerbaijan,Sumgayit : Municipality,0,0,0,0,0,0,0,0,0,0,0,0,0,0,0,0
2015,Azerbaijan,Tartar : Rayon,0,0,0,0,0,0,0,0,0,0,0,0,0,0,0,0
2015,Azerbaijan,Tovuz : Rayon,0,0,0,0,0,0,0,0,0,0,0,0,0,0,0,0
2015,Azerbaijan,Ujar : Rayon,0,0,0,0,0,0,0,0,0,0,0,0,0,0,0,0
2015,Azerbaijan,Yevlakh : Municipality,0,0,0,0,0,0,0,0,0,0,0,0,0,0,0,0
2015,Azerbaijan,Zagatala : Rayon,0,0,0,0,0,0,0,0,0,0,0,0,0,0,0,0
2015,Azerbaijan,Zardab : Rayon,0,0,0,0,0,0,0,0,0,0,0,0,0,0,0,0
2015,Burundi,Bujumbura: Town,1334,2385,0,1962,6102,344,0,12127,1365,2308,0,1985,5677,270,0,11605
2015,Burundi,Butare : Point,4,0,0,1,7,1,0,13,1,8,0,3,15,1,0,28
2015,Burundi,Bwagiriza : Point,750,1180,0,702,1877,103,0,4612,797,1266,0,686,1506,89,0,4344
2015,Burundi,Kavumu: Point,979,1290,0,728,1882,61,0,4940,974,1348,0,716,1361,57,0,4456
2015,Burundi,Kinama: Point,727,900,0,546,2055,99,0,4327,710,976,0,595,1729,64,0,4074
2015,Burundi,Musasa : Point,536,898,0,519,1309,62,0,3324,569,881,0,571,1031,37,0,3089
2015,Burundi,Burundi : Dispersed in the country / territory,1877,2450,0,2307,7025,1057,0,14716,1947,2545,0,2148,5561,540,0,12741
2015,Belgium,Belgium : Dispersed in the country / territory,0,0,0,0,0,0,0,0,0,0,0,0,0,0,0,0
2015,Benin,Benin : Dispersed in the country / territory,27,40,0,41,214,8,0,330,29,41,0,49,253,6,0,378
2015,Burkina Faso,Bobo-Dioulasso : Department,71,159,0,109,266,21,0,626,76,130,0,66,179,16,0,467
2015,Burkina Faso,Dori,0,1,0,1,0,0,0,2,0,1,0,0,0,0,0,1
2015,Burkina Faso,Goudebo : Point,723,1340,0,684,2380,198,0,5325,737,1358,0,704,1961,257,0,5017
2015,Burkina Faso,Mentao : Point,880,1765,0,863,3105,288,0,6901,939,1799,0,917,2427,326,0,6408
2015,Burkina Faso,Ouagadougou : Point,45,87,0,57,293,18,0,500,34,94,0,95,405,19,0,647
2015,Burkina Faso,Burkina Faso : Dispersed in the country / territory,502,1152,0,676,1784,97,0,4211,498,1284,0,761,1377,135,0,4055
2015,Bangladesh,Bandarban : Zila - District,0,2,0,1,7,1,0,11,0,0,0,2,4,1,0,7
2015,Bangladesh,Bangladesh : Dispersed in the country / territory,0,0,0,0,0,0,0,0,0,0,0,0,0,0,0,0
2015,Bangladesh,Chittagong : Zila - District,0,0,0,0,2,0,0,2,0,0,0,0,3,0,0,3
2015,Bangladesh,Cox's Bazar : Zila - District,0,2,0,2,9,0,0,13,0,1,0,2,9,2,0,14
2015,Bangladesh,Dhaka : Zila - District,1,3,0,1,4,0,0,9,1,1,0,2,8,2,0,14
2015,Bangladesh,Kutupalong : Point,788,1534,0,1156,3173,150,0,6801,897,1568,0,1147,2519,170,0,6301
2015,Bangladesh,Nayapara : Point,1181,2197,0,1759,4756,236,0,10129,1266,2200,0,1729,3206,247,0,8648
2015,Bangladesh,Rangamati : Zila - District,0,0,0,2,0,0,0,2,0,1,0,0,2,1,0,4
2015,Bulgaria,Bulgaria : Dispersed in the country / territory,0,0,0,0,0,0,0,0,0,0,0,0,0,0,0,0
2015,Bahrain,Bahrain : Dispersed in the country / territory,16,27,0,14,104,4,0,165,26,27,0,9,122,11,0,195
2015,Bahamas,Bahamas : Dispersed in the country / territory,0,1,0,0,6,0,0,7,0,0,0,0,14,3,0,17
2015,Bahamas,Carmichael Detention Center,0,0,0,0,1,0,0,1,0,0,0,0,4,0,0,4
2015,Bosnia and Herzegovina,Brcko : District,0,0,0,0,0,0,0,0,0,0,0,0,0,0,0,0
2015,Bosnia and Herzegovina,Bosnia and Herzegovina : Dispersed in the country / territory,14,3,0,2,6,0,0,25,15,6,0,5,9,0,0,35
2015,Bosnia and Herzegovina,Federation of Bosnia and Herzegovina : Entity,4,11,0,7,45,2,0,69,2,9,0,11,48,1,0,71
2015,Bosnia and Herzegovina,Republika Srpska : Entity,80,174,0,324,2352,432,0,3362,62,188,0,348,2359,360,0,3317
2015,Belarus,Belarus : Dispersed in the country / territory,0,0,0,0,0,0,0,0,0,0,0,0,0,0,0,0
2015,Belarus,Brest : Oblast - Region,0,0,0,0,1,0,0,1,0,0,0,0,0,0,0,0
2015,Belarus,Brest Oblast - Region,0,1,0,0,2,0,0,3,0,0,0,0,8,1,0,9
2015,Belarus,Gomel : Oblast - Region,6,7,0,9,22,5,0,49,5,5,0,3,70,0,0,83
2015,Belarus,Grodno : Oblast - Region,0,0,0,0,3,0,0,3,0,0,0,0,15,0,0,15
2015,Belarus,Horad Minsk: City,9,27,0,28,67,7,0,138,19,25,0,18,218,2,0,282
2015,Belarus,Minsk : Oblast - Region,2,2,0,4,31,2,0,41,1,5,0,5,37,1,0,49
2015,Belarus,Mogilev : Oblast - Region,0,0,0,2,16,0,0,18,1,1,0,0,22,0,0,24
2015,Belarus,Vitebsk : Oblast - Region,3,5,0,1,13,2,0,24,1,5,0,1,43,1,0,51
2015,Belize,Belize : Dispersed in the country / territory,22,50,0,57,192,10,0,331,32,36,0,46,261,9,0,384
2015,Bolivia (Plurinational State of),Bolivia (Plurinational State of),0,0,0,0,0,0,0,0,0,0,0,0,1,0,0,1
2015,Bolivia (Plurinational State of),Cochabamba : Department,2,2,0,11,12,0,0,27,2,3,0,7,28,0,0,40
2015,Bolivia (Plurinational State of),El Beni : Department,1,0,0,3,2,0,0,6,0,1,0,1,1,0,0,3
2015,Bolivia (Plurinational State of),La Paz : Department,0,3,0,35,202,7,0,247,4,5,0,35,298,9,0,351
2015,Bolivia (Plurinational State of),Palos Blanco : Point,0,1,0,0,2,0,0,3,0,0,0,0,3,0,0,3
2015,Bolivia (Plurinational State of),Sucre : Point,0,0,0,0,0,0,0,0,0,0,0,0,1,0,0,1
2015,Bolivia (Plurinational State of),Tarija : Department,0,0,0,0,1,0,0,1,0,0,0,0,1,0,0,1
2015,Bolivia (Plurinational State of),Yapacani : Point,0,2,0,1,4,0,0,7,0,1,0,0,5,0,0,6
2015,Bolivia (Plurinational State of),Santa Cruz : Department,1,4,0,6,19,1,0,31,2,3,0,10,31,1,0,47
2015,Brazil,Brazil : Dispersed in the country / territory,0,1005,0,365,5410,119,0,6899,0,935,0,451,27343,162,0,28891
2015,Brunei Darussalam,Brunei Darussalam : Dispersed in the country / territory,0,0,0,0,0,0,0,0,0,0,0,0,0,0,0,0
2015,Botswana,Dukwi : Point,129,166,0,128,378,13,0,814,154,188,0,107,962,40,0,1451
2015,Central African Rep.,Bambari: Pladama-Ouaka,214,264,0,110,397,30,0,1015,286,283,0,123,205,21,0,918
2015,Central African Rep.,Bamingui-Bangoran : Prefecture,0,0,0,0,0,0,0,0,0,0,0,0,0,0,0,0
2015,Central African Rep.,Bangui : Commune,122,232,0,170,543,20,0,1087,125,227,0,185,603,30,0,1170
2015,Central African Rep.,Basse Kotto,0,0,0,0,0,0,0,0,0,0,0,0,0,0,0,0
2015,Central African Rep.,Batalimo,9,19,0,11,27,5,0,71,18,10,0,6,39,2,0,75
2015,Central African Rep.,Haut-Mbomou : Prefecture,0,0,0,0,0,0,0,0,0,0,0,0,0,0,0,0
2015,Central African Rep.,Haute-Kotto : Prefecture,0,0,0,0,0,0,0,0,0,0,0,0,0,0,0,0
2015,Central African Rep.,Kemo,0,0,0,0,0,0,0,0,0,0,0,0,0,0,0,0
2015,Central African Rep.,Lobaye,0,0,0,0,0,0,0,0,0,0,0,0,0,0,0,0
2015,Central African Rep.,Mambere Kadei,0,0,0,0,0,0,0,0,0,0,0,0,0,0,0,0
2015,Central African Rep.,Mboki,8,15,0,11,50,4,0,88,7,23,0,17,51,7,0,105
2015,Central African Rep.,Mbomou : Prefecture,0,0,0,0,0,0,0,0,0,0,0,0,0,0,0,0
2015,Central African Rep.,Nana Mambere,0,0,0,0,0,0,0,0,0,0,0,0,0,0,0,0
2015,Central African Rep.,Nana-Gribizi : Economic prefecture,0,0,0,0,0,0,0,0,0,0,0,0,0,0,0,0
2015,Central African Rep.,Obo,20,40,0,21,108,22,0,211,14,58,0,26,76,15,0,189
2015,Central African Rep.,Ombella M'Poko : Prefecture,0,0,0,0,0,0,0,0,0,0,0,0,0,0,0,0
2015,Central African Rep.,Ouaka,0,0,0,0,0,0,0,0,0,0,0,0,0,0,0,0
2015,Central African Rep.,Ouham : Prefecture,0,0,0,0,0,0,0,0,0,0,0,0,0,0,0,0
2015,Central African Rep.,Ouham-Pende : Prefecture,0,0,0,0,0,0,0,0,0,0,0,0,0,0,0,0
2015,Central African Rep.,Rafai,3,0,0,0,13,0,0,16,1,0,0,0,32,1,0,34
2015,Central African Rep.,Sangha Mbaere,0,0,0,0,0,0,0,0,0,0,0,0,0,0,0,0
2015,Central African Rep.,Vakaga : Prefecture,0,0,0,0,0,0,0,0,0,0,0,0,0,0,0,0
2015,Central African Rep.,Zemio : Sous-prefecture,232,249,0,136,676,74,0,1367,291,276,0,129,560,62,0,1318
2015,Canada,Canada : Dispersed in the country / territory,886,897,0,603,5301,358,0,8045,946,914,0,665,7666,257,0,10448
2015,Switzerland,Switzerland : Dispersed in the country / territory,2352,2872,0,2088,13271,965,0,21548,2435,3131,0,4451,26838,652,0,37507
2015,Chile,Chile : Dispersed in the country / territory,12,21,0,30,1327,5,0,1395,21,29,0,41,1423,4,0,1518
2015,China,Anhui: Province,0,0,0,0,0,0,0,0,0,0,0,0,1,0,0,1
2015,China,Beijing : Municipality,0,2,0,1,37,0,0,40,1,1,0,1,65,0,0,68
2015,China,China : Dispersed in the country / territory,0,0,0,0,2,0,0,2,0,0,0,0,1,0,0,1
2015,China,Fujian : Province,0,0,0,0,3,0,0,3,0,0,0,0,3,0,0,3
2015,China,Guangdong : Province,13,9,0,4,67,0,0,93,8,10,0,5,122,0,0,145
2015,China,Guangxi : Autonomous Region,0,0,0,0,0,0,0,0,0,0,0,0,2,0,0,2
2015,China,Guizhou: Province,0,0,0,0,0,0,0,0,0,0,0,0,1,0,0,1
2015,China,Hainan : Province,0,0,0,0,0,0,0,0,0,0,0,0,1,0,0,1
2015,China,Hebei : Province,2,2,0,2,58,1,0,65,3,2,0,1,168,1,0,175
2015,China,Heilongjiang: Province,0,0,0,0,0,0,0,0,0,0,0,0,1,0,0,1
2015,China,Henan : Province,0,0,0,0,1,0,0,1,1,0,0,0,1,0,0,2
2015,China,Hubei : Province,6,4,0,1,21,0,0,32,4,1,0,1,30,0,0,36
2015,China,Hunan : Province,0,0,0,0,2,0,0,2,0,1,0,0,5,0,0,6
2015,China,Ji Lin : Province,0,0,0,0,1,0,0,1,0,0,0,0,1,0,0,1
2015,China,Jiangsu : Province,10,3,0,2,11,0,0,26,0,6,0,3,18,0,0,27
2015,China,Jiangxi : Province,0,0,0,0,0,0,0,0,0,0,0,0,0,0,0,0
2015,China,Jiangxi: Province,0,0,0,0,0,0,0,0,0,0,0,0,1,0,0,1
2015,China,Liaoning : Province,0,0,0,0,0,0,0,0,0,0,0,0,5,0,0,5
2015,China,Neimenggu : Province,0,0,0,0,1,0,0,1,0,0,0,0,1,0,0,1
2015,China,Shaanxi : Province,0,0,0,0,0,0,0,0,0,0,0,0,1,0,0,1
2015,China,Shan Dong : Province,0,1,0,1,2,0,0,4,0,1,0,0,2,0,0,3
2015,China,Shanghai : Municipality,0,0,0,0,0,0,0,0,0,0,0,0,1,0,0,1
2015,China,Shanxi : Province,0,0,0,0,1,0,0,1,0,0,0,0,5,0,0,5
2015,China,Tianjin : Municipality,0,0,0,0,1,0,0,1,1,0,0,0,0,0,0,1
2015,China,Xinjiang,0,0,0,0,0,0,0,0,0,0,0,0,1,0,0,1
2015,China,Yunnan : Province,0,0,0,0,0,0,0,0,0,0,0,0,0,0,0,0
2015,China,Zhejiang : Province,2,1,0,1,19,0,0,23,2,6,0,2,39,2,0,51
2015,Côte d'Ivoire,Abidjan : Departement,35,116,0,69,437,28,0,685,33,130,0,99,685,33,0,980
2015,Côte d'Ivoire,C??te d'Ivoire : Dispersed in the country / territory,0,0,0,0,0,0,0,0,0,0,0,0,0,0,0,0
2015,Côte d'Ivoire,C?â??te d'Ivoire : Dispersed in the country / territory,0,0,0,0,0,0,0,0,0,0,0,0,0,0,0,0
2015,Côte d'Ivoire,Guiglo : Departement,6,10,0,20,45,5,0,86,10,21,0,16,26,2,0,75
2015,Côte d'Ivoire,Tabou : Departement,48,98,0,60,255,6,0,467,33,74,0,69,211,6,0,393
2015,Cameroon,Adinkol : Point,53,99,0,62,114,10,0,338,48,94,0,64,78,14,0,298
2015,Cameroon,Alhamdou,49,129,0,60,158,7,0,403,54,131,0,60,100,9,0,354
2015,Cameroon,Babongo : Point,2,2,0,0,10,0,0,14,1,7,0,7,2,2,0,19
2015,Cameroon,Bafouck : Point,53,122,0,98,216,13,0,502,50,117,0,67,189,22,0,445
2015,Cameroon,Bagodo : Point,17,94,0,75,165,7,0,358,12,91,0,87,118,18,0,326
2015,Cameroon,Bakombo,3,5,0,6,6,1,0,21,2,8,0,8,9,0,0,27
2015,Cameroon,Batouri,10,32,0,22,54,4,0,122,19,23,0,16,97,5,0,160
2015,Cameroon,Bazzama : Point,56,146,0,118,192,12,0,524,48,121,0,100,126,14,0,409
2015,Cameroon,Bedobo : Point,45,125,0,106,261,13,0,550,39,119,0,75,180,17,0,430
2015,Cameroon,Beke Chantier,26,42,0,28,76,0,0,172,21,70,0,28,60,9,0,188
2015,Cameroon,Betare Oya : Point,147,143,0,84,383,8,0,765,161,143,0,80,304,6,0,694
2015,Cameroon,Bigoro,27,60,0,57,80,4,0,228,29,67,0,53,57,10,0,216
2015,Cameroon,Boforo,44,95,0,75,132,7,0,353,42,129,0,72,71,10,0,324
2015,Cameroon,Bombe Pana,43,106,0,66,171,9,0,395,47,104,0,78,147,14,0,390
2015,Cameroon,Borgop : Point,1420,1896,0,938,2580,200,0,7034,1475,1824,0,739,1797,206,0,6041
2015,Cameroon,Boubara : Point,49,145,0,125,311,25,0,655,40,134,0,118,241,31,0,564
2015,Cameroon,Boulembe : Point,66,199,0,169,177,12,0,623,76,191,0,134,136,14,0,551
2015,Cameroon,Bouli : Point,38,99,0,76,180,13,0,406,35,92,0,63,130,11,0,331
2015,Cameroon,Colomine,66,135,0,131,71,4,0,407,66,133,0,93,68,4,0,364
2015,Cameroon,Dakere Babongo : Point,69,120,0,79,152,10,0,430,53,110,0,72,100,11,0,346
2015,Cameroon,Damissa,46,116,0,53,169,9,0,393,57,115,0,65,134,14,0,385
2015,Cameroon,Dang Patou : Point,41,88,0,67,175,9,0,380,28,81,0,66,110,10,0,295
2015,Cameroon,Digou Adamou : Point,2,6,0,7,9,1,0,25,0,8,0,8,10,3,0,29
2015,Cameroon,Dir : Point,5,32,0,17,53,1,0,108,4,29,0,24,30,6,0,93
2015,Cameroon,Djalingo : Point,21,41,0,40,75,10,0,187,11,50,0,47,59,5,0,172
2015,Cameroon,Djaoro Mone,40,90,0,62,117,9,0,318,25,96,0,43,64,6,0,234
2015,Cameroon,Djohong : Point,19,68,0,50,114,6,0,257,16,62,0,41,99,11,0,229
2015,Cameroon,Douala : Point,680,917,0,630,2351,69,0,4647,678,864,0,624,2668,45,0,4879
2015,Cameroon,Fada : Point,33,72,0,67,123,4,0,299,40,93,0,48,91,14,0,286
2015,Cameroon,Gado Badzere : Point,2443,3469,0,1596,5305,293,0,13106,2557,3296,0,1365,3718,369,0,11305
2015,Cameroon,Gandinang : Point,0,1,0,1,6,1,0,9,2,3,0,1,3,0,0,9
2015,Cameroon,Garga Libona : Point,129,249,0,193,323,23,0,917,113,273,0,185,206,24,0,801
2015,Cameroon,Garga Sarali : Point,117,176,0,150,260,19,0,722,102,215,0,134,209,22,0,682
2015,Cameroon,Gargapela : Point,54,161,0,123,238,22,0,598,75,161,0,109,138,18,0,501
2015,Cameroon,Garoua-Boulai : Point,1621,2890,0,2117,4757,332,0,11717,1574,2840,0,1854,2880,373,0,9521
2015,Cameroon,Gbabio,14,24,0,13,31,0,0,82,28,27,0,8,20,1,0,84
2015,Cameroon,Gbakim : Point,15,43,0,51,111,2,0,222,18,37,0,43,103,6,0,207
2015,Cameroon,Gbiti : Point,829,1908,0,1270,3564,165,0,7736,782,1865,0,1188,2776,295,0,6906
2015,Cameroon,Gomana,14,32,0,35,48,2,0,131,20,51,0,22,26,3,0,122
2015,Cameroon,Goro,50,132,0,101,158,12,0,453,45,124,0,72,116,19,0,376
2015,Cameroon,Goundjel : Point,0,4,0,4,11,0,0,19,0,1,0,3,13,0,0,17
2015,Cameroon,Guiwa Yangamo : Point,95,242,0,200,208,17,0,762,109,264,0,216,136,23,0,748
2015,Cameroon,Kambele,26,56,0,32,72,10,0,196,23,53,0,23,74,7,0,180
2015,Cameroon,Kenzou : Point,739,1438,0,1014,2763,140,0,6094,707,1432,0,972,2193,211,0,5515
2015,Cameroon,Kette : Point,246,529,0,461,1076,48,0,2360,224,646,0,358,728,94,0,2050
2015,Cameroon,Kombo Laka : Point,45,152,0,111,267,20,0,595,48,189,0,96,227,32,0,592
2015,Cameroon,Kouba : Point,22,73,0,60,117,9,0,281,23,62,0,46,67,17,0,215
2015,Cameroon,Kounde,14,13,0,6,21,2,0,56,10,8,0,7,7,1,0,33
2015,Cameroon,Lokoti : Point,94,192,0,131,283,16,0,716,87,172,0,135,222,22,0,638
2015,Cameroon,Lolo,968,1458,0,921,2650,174,0,6171,933,1440,0,837,2443,251,0,5904
2015,Cameroon,Mandjou : Point,642,1414,0,1194,1391,109,0,4750,677,1353,0,1011,915,103,0,4059
2015,Cameroon,Mbarang : Point,61,133,0,123,172,16,0,505,70,146,0,82,118,17,0,433
2015,Cameroon,Mbewe : Point,6,27,0,20,39,10,0,102,11,24,0,9,30,5,0,79
2015,Cameroon,Mbile : Point,814,1496,0,885,2712,162,0,6069,873,1461,0,889,2438,232,0,5893
2015,Cameroon,Mbomba,4,16,0,7,11,2,0,40,5,13,0,7,9,3,0,37
2015,Cameroon,Mbondo : Point,19,94,0,67,138,11,0,329,24,91,0,59,118,14,0,306
2015,Cameroon,Mbonga : Point,30,76,0,56,129,4,0,295,27,88,0,67,97,15,0,294
2015,Cameroon,Mborguene : Point,20,79,0,72,145,7,0,323,22,82,0,77,138,11,0,330
2015,Cameroon,Mboula : Point,15,68,0,65,132,8,0,288,15,90,0,48,94,19,0,266
2015,Cameroon,Mboumama : Point,76,214,0,141,391,18,0,840,68,219,0,133,277,36,0,733
2015,Cameroon,Meidougou : Point,270,615,0,488,1000,68,0,2441,264,672,0,480,649,81,0,2146
2015,Cameroon,Meiganga : Point,406,877,0,712,1033,62,0,3090,420,856,0,581,671,83,0,2611
2015,Cameroon,Mikila : Point,48,127,0,96,162,8,0,441,65,129,0,70,114,12,0,390
2015,Cameroon,Mimbang : Point,0,7,0,5,21,0,0,33,1,4,0,9,23,2,0,39
2015,Cameroon,Minawao,5411,7033,0,3569,10779,1068,0,27860,5478,7135,0,3511,7448,949,0,24521
2015,Cameroon,Mobe : Point,42,98,0,83,100,5,0,328,48,100,0,62,72,9,0,291
2015,Cameroon,Moinam,13,15,0,15,35,1,0,79,7,27,0,5,25,6,0,70
2015,Cameroon,Nabemo : Point,39,104,0,88,201,10,0,442,55,130,0,98,147,17,0,447
2015,Cameroon,Nandoungue : Point,87,201,0,162,290,30,0,770,97,183,0,151,204,31,0,666
2015,Cameroon,Nd??l??l??,6,8,0,7,12,0,0,33,6,10,0,8,12,1,0,37
2015,Cameroon,Ndanga Gandima : Point,105,224,0,153,247,18,0,747,101,182,0,147,170,29,0,629
2015,Cameroon,Ndokayo : Point,742,1300,0,792,1764,127,0,4725,686,1267,0,716,1221,142,0,4032
2015,Cameroon,Ngam,599,893,0,508,1050,58,0,3108,637,866,0,322,743,69,0,2637
2015,Cameroon,Ngaoui : Point,449,1392,0,1141,2380,169,0,5531,477,1500,0,1081,1461,200,0,4719
2015,Cameroon,Ngarisingo,79,143,0,98,217,12,0,549,76,141,0,73,230,35,0,555
2015,Cameroon,Nguindi : Point,21,62,0,59,127,4,0,273,20,70,0,36,76,11,0,213
2015,Cameroon,Ngunbela : Point,12,20,0,20,12,1,0,65,13,20,0,15,16,1,0,65
2015,Cameroon,Nyabi : Point,130,389,0,343,899,49,0,1810,141,351,0,307,586,68,0,1453
2015,Cameroon,Nyambaka,12,35,0,19,40,2,0,108,13,40,0,27,18,6,0,104
2015,Cameroon,Ouro-Adde : Point,69,204,0,146,306,24,0,749,74,224,0,147,206,18,0,669
2015,Cameroon,Samba : Point,15,57,0,74,129,8,0,283,20,48,0,63,80,14,0,225
2015,Cameroon,Sandaye : Point,8,34,0,18,50,2,0,112,13,25,0,24,41,4,0,107
2015,Cameroon,Tapare : Point,13,36,0,33,59,6,0,147,16,45,0,31,38,8,0,138
2015,Cameroon,Timangolo : Point,596,1050,0,684,1803,103,0,4236,594,1068,0,643,1556,156,0,4017
2015,Cameroon,Toktoyo : Point,164,446,0,286,782,43,0,1721,161,458,0,307,529,82,0,1537
2015,Cameroon,Tongo Gandima : Point,186,449,0,314,545,48,0,1542,214,486,0,268,367,74,0,1409
2015,Cameroon,Woumbou : Point,106,264,0,158,277,13,0,818,119,214,0,147,188,16,0,684
2015,Cameroon,Yamba : Point,168,412,0,294,505,50,0,1429,172,380,0,238,376,34,0,1200
2015,Cameroon,Yaounde : Point,871,1283,0,1045,3023,99,0,6321,860,1185,0,944,4170,87,0,7246
2015,Cameroon,Yokosire : Point,85,211,0,194,272,21,0,783,89,206,0,171,177,29,0,672
2015,Cameroon,Zamboi,34,57,0,21,67,4,0,183,39,67,0,19,41,8,0,174
2015,Cameroon,Zembe Borongo : Point,200,475,0,364,606,46,0,1691,208,488,0,309,371,62,0,1438
2015,Cameroon,Cameroon : Dispersed in the country / territory,2177,4187,0,2390,6346,426,0,15526,2257,4149,0,2369,4823,479,0,14077
2015,Dem. Rep. of the Congo,Ariwara : Point,66,111,0,54,138,10,0,379,57,93,0,34,110,16,0,310
2015,Dem. Rep. of the Congo,Aru : Point,0,4,0,1,4,0,0,9,2,4,0,2,6,2,0,16
2015,Dem. Rep. of the Congo,Bas-Congo : Province,802,578,0,258,1384,75,0,3097,704,641,0,253,1190,48,0,2836
2015,Dem. Rep. of the Congo,Bas-Uele : District,1248,1348,0,612,2312,128,0,5648,1220,1326,0,660,1962,104,0,5272
2015,Dem. Rep. of the Congo,BILI(camp),1246,1063,0,391,1899,123,0,4722,1249,1172,0,578,2059,98,0,5156
2015,Dem. Rep. of the Congo,Bondo : Point,1084,1032,0,458,2108,125,0,4807,1030,1019,0,438,1245,123,0,3855
2015,Dem. Rep. of the Congo,Bosobolo,1293,1290,0,441,2581,142,0,5747,1165,1123,0,243,1201,54,0,3786
2015,Dem. Rep. of the Congo,Boyabu,2416,2732,0,1233,4349,242,0,10972,2405,2547,0,1294,2971,89,0,9306
2015,Dem. Rep. of the Congo,Bukavu : Point,97,129,0,56,229,8,0,519,94,112,0,81,146,11,0,444
2015,Dem. Rep. of the Congo,Buta : Point,2,3,0,5,7,0,0,17,4,4,0,2,6,1,0,17
2015,Dem. Rep. of the Congo,Dilolo : Point,58,70,0,46,78,7,0,259,54,86,0,62,69,5,0,276
2015,Dem. Rep. of the Congo,Doruma : Point,34,24,0,13,54,6,0,131,22,26,0,14,46,9,0,117
2015,Dem. Rep. of the Congo,Dungu : Point,8,3,0,0,14,0,0,25,3,4,0,1,17,4,0,29
2015,Dem. Rep. of the Congo,Equateur : Province,37,36,0,18,52,0,0,143,40,56,0,26,90,1,0,213
2015,Dem. Rep. of the Congo,Fizi : Point,333,353,0,145,711,38,0,1580,313,373,0,152,845,76,0,1759
2015,Dem. Rep. of the Congo,Goma : Point,76,140,0,97,222,6,0,541,73,103,0,98,205,4,0,483
2015,Dem. Rep. of the Congo,Haut-Uele : District,1139,1169,0,525,2155,122,0,5110,1098,1151,0,540,1594,110,0,4493
2015,Dem. Rep. of the Congo,Idjwi: Territoire,112,122,0,64,229,23,0,550,114,153,0,61,78,23,0,429
2015,Dem. Rep. of the Congo,Ingbokolo : Point,52,73,0,30,177,20,0,352,44,49,0,25,64,10,0,192
2015,Dem. Rep. of the Congo,Inke,2155,2752,0,1154,3836,222,0,10119,2186,2763,0,1642,3338,117,0,10046
2015,Dem. Rep. of the Congo,Isiro : Point,4,3,0,7,14,1,0,29,2,5,0,5,18,0,0,30
2015,Dem. Rep. of the Congo,Ituri : District,23475,25384,0,11518,43511,2397,0,106285,22980,24949,0,12402,36958,1942,0,99231
2015,Dem. Rep. of the Congo,Kahemba : Point,21,31,0,6,38,0,0,96,25,28,0,6,40,0,0,99
2015,Dem. Rep. of the Congo,Kalehe : Point,1004,1247,0,714,1503,49,0,4517,862,1216,0,681,1325,69,0,4153
2015,Dem. Rep. of the Congo,Kalemie : Point,66,76,0,27,117,3,0,289,48,67,0,32,149,1,0,297
2015,Dem. Rep. of the Congo,Katanga : Province,42865,46222,0,20955,79406,4345,0,193793,41859,45386,0,22540,67063,3627,0,180475
2015,Dem. Rep. of the Congo,Katshia : Point,24,28,0,51,50,4,0,157,25,34,0,47,35,13,0,154
2015,Dem. Rep. of the Congo,Kimaza : Point,12,16,0,17,48,2,0,95,17,17,0,14,92,11,0,151
2015,Dem. Rep. of the Congo,Kinshasa : Province,96,137,0,104,327,24,0,688,70,137,0,121,475,32,0,835
2015,Dem. Rep. of the Congo,Kipushi,3,11,0,8,20,5,0,47,7,15,0,4,18,6,0,50
2015,Dem. Rep. of the Congo,Kolwezi,6,9,0,3,11,0,0,29,4,7,0,3,17,0,0,31
2015,Dem. Rep. of the Congo,Likasi : City,5,9,0,2,9,1,0,26,3,4,0,3,11,1,0,22
2015,Dem. Rep. of the Congo,Lubero : Point,838,1008,0,694,1233,71,0,3844,731,1041,0,752,1156,87,0,3767
2015,Dem. Rep. of the Congo,Lubumbashi : Point,122,211,0,292,266,31,0,922,150,244,0,292,312,17,0,1015
2015,Dem. Rep. of the Congo,Lukolo,25,16,0,6,54,1,0,102,31,15,0,6,101,3,0,156
2015,Dem. Rep. of the Congo,Lusenda (camp),1553,1480,0,586,2873,121,0,6613,1607,1479,0,606,2686,73,0,6451
2015,Dem. Rep. of the Congo,Lusuku : Point,6,12,0,32,14,0,0,64,17,13,0,27,28,2,0,87
2015,Dem. Rep. of the Congo,Maniema : Province,30567,33034,0,14981,56599,3106,0,138287,29855,32425,0,16147,48129,2554,0,129110
2015,Dem. Rep. of the Congo,Manono : Territoire,24,31,0,6,40,0,0,101,28,28,0,6,43,0,0,105
2015,Dem. Rep. of the Congo,Masisi : Point,9338,11235,0,7731,13741,805,0,42850,8145,11610,0,8378,12882,971,0,41986
2015,Dem. Rep. of the Congo,Mbanza Ngungu,27,26,0,14,56,0,0,123,27,33,0,16,114,9,0,199
2015,Dem. Rep. of the Congo,Mboti,89,43,0,30,109,6,0,277,87,57,0,39,176,11,0,370
2015,Dem. Rep. of the Congo,Mobayi Mbongo,260,195,0,70,344,15,0,884,265,207,0,97,318,19,0,906
2015,Dem. Rep. of the Congo,Mole,2158,2606,0,1272,4103,144,0,10283,2144,2395,0,1382,4208,78,0,10207
2015,Dem. Rep. of the Congo,Mwene Ditu : Point,41,42,0,70,59,2,0,214,26,33,0,77,67,6,0,209
2015,Dem. Rep. of the Congo,Mwenga : Territoire,2825,3509,0,2010,4228,138,0,12710,2426,3423,0,1916,3729,195,0,11689
2015,Dem. Rep. of the Congo,Nord Ubangi,1206,1307,0,518,1982,116,0,5129,1131,1322,0,572,2290,101,0,5416
2015,Dem. Rep. of the Congo,Nord-Kivu : Province,115821,125176,0,56747,214408,11777,0,523929,113143,122861,0,61178,182280,9666,0,489128
2015,Dem. Rep. of the Congo,Rutshuru : Point,7413,8827,0,6064,11309,719,0,34332,6525,9082,0,6530,10520,802,0,33459
2015,Dem. Rep. of the Congo,Sud Ubangi,646,697,0,240,1298,63,0,2944,594,737,0,259,964,41,0,2595
2015,Dem. Rep. of the Congo,Sud-Kivu : Province,48760,52398,0,23724,90089,4950,0,219921,47521,51466,0,25553,76568,4046,0,205154
2015,Dem. Rep. of the Congo,Tshabobo : Point,20,35,0,66,52,2,0,175,32,36,0,61,47,12,0,188
2015,Dem. Rep. of the Congo,Tshopo : District,572,618,0,280,1058,58,0,2586,558,606,0,302,900,48,0,2414
2015,Dem. Rep. of the Congo,Uvira : Point,594,765,0,431,976,45,0,2811,516,742,0,402,832,59,0,2551
2015,Dem. Rep. of the Congo,Walikale : Point,4897,5892,0,4054,7205,422,0,22470,4270,6088,0,4394,6755,509,0,22016
2015,Dem. Rep. of the Congo,Bas-Uele : Territoire - District,74,71,0,42,193,24,0,404,81,70,0,48,188,14,0,401
2015,Dem. Rep. of the Congo,Haut-Uele : Territoire - District,249,241,0,156,352,75,0,1073,258,234,0,141,331,45,0,1009
2015,Congo,Betou : Point,2199,2108,0,1191,4420,207,0,10125,2157,2062,0,1182,4026,163,0,9590
2015,Congo,Bouenza,0,0,0,1,2,1,0,4,1,0,0,2,7,1,0,11
2015,Congo,Brazzaville : Capital,887,1157,0,866,3123,77,0,6110,1002,1157,0,793,5064,71,0,8087
2015,Congo,Dolisie: Point,0,0,0,0,0,0,0,0,0,0,0,2,6,0,0,8
2015,Congo,Impfondo : Point,670,1019,0,682,2044,172,0,4587,693,1093,0,637,2095,127,0,4645
2015,Congo,Komi : Point,4,4,0,3,11,2,0,24,0,4,0,3,18,2,0,27
2015,Congo,Kondi Mbaka : Point,9,13,0,6,24,11,0,63,6,13,0,12,62,9,0,102
2015,Congo,Loukolela : Point,171,318,0,193,526,19,0,1227,160,328,0,211,642,36,0,1377
2015,Congo,Malolo : Point,11,33,0,11,52,10,0,117,15,23,0,18,39,8,0,103
2015,Congo,Ngo : Point,35,56,0,47,57,1,0,196,47,59,0,35,193,5,0,339
2015,Congo,Okoyo : District,2,0,0,0,0,0,0,2,1,1,0,0,0,0,0,2
2015,Congo,Oyo : Point,35,59,0,48,72,4,0,218,37,56,0,53,164,13,0,323
2015,Congo,Pointe Noire : Point,162,154,0,91,469,12,0,888,158,133,0,80,1145,23,0,1539
2015,Congo,Pool : Departement,84,113,0,78,173,5,0,453,90,143,0,80,359,3,0,675
2015,Congo,Sangha : Departement,85,113,0,85,279,4,0,566,84,90,0,85,479,4,0,742
2015,Congo,Tchiamba-Nza : Point,0,0,0,0,0,0,0,0,0,0,0,0,1,0,0,1
2015,Colombia,Arauca,1,1,0,1,2,0,0,5,2,1,0,0,2,0,0,5
2015,Colombia,Barcelona : Point,0,0,0,0,0,0,0,0,0,0,0,0,1,0,0,1
2015,Colombia,Barranquilla,1,2,0,0,4,1,0,8,0,1,0,0,2,0,0,3
2015,Colombia,Bogota : Capital district,3,3,0,4,37,10,0,57,5,4,0,7,132,13,0,161
2015,Colombia,Buenaventura : Point,0,0,0,0,0,0,0,0,0,0,0,0,2,0,0,2
2015,Colombia,C??cuta : Point,3,1,0,0,9,0,0,13,2,1,0,4,13,1,0,21
2015,Colombia,Cali : Point,0,0,0,1,1,0,0,2,0,0,0,0,3,1,0,4
2015,Colombia,Cartagena : Point,0,2,0,0,4,1,0,7,0,1,0,0,14,0,0,15
2015,Colombia,Cartago,0,0,0,2,1,0,0,3,1,1,0,0,0,0,0,2
2015,Colombia,Colombia : Dispersed in the country / territory,1,2,0,2,4,0,0,9,0,2,0,0,3,0,0,5
2015,Colombia,Duitama : Point,0,0,0,0,1,0,0,1,0,0,0,0,0,0,0,0
2015,Colombia,Ibagu?? : Point,0,0,0,0,1,0,0,1,0,0,0,0,1,0,0,1
2015,Colombia,Maicao : Point,0,0,0,0,1,0,0,1,1,0,0,0,0,0,0,1
2015,Colombia,Medell?¡n : Point,0,0,0,0,2,1,0,3,0,1,0,1,8,0,0,10
2015,Colombia,Pasto,1,0,0,0,1,0,0,2,0,0,0,0,1,0,0,1
2015,Colombia,Pereira : Municipality,0,0,0,0,1,0,0,1,0,0,0,0,1,0,0,1
2015,Colombia,San Andres Islas : Department,0,0,0,0,2,0,0,2,0,0,0,0,2,1,0,3
2015,Colombia,Tulu?í : Point,0,0,0,0,0,0,0,0,0,0,0,0,1,0,0,1
2015,Colombia,Tumaco : Municipality,0,1,0,0,1,0,0,2,0,2,0,0,0,0,0,2
2015,Colombia,Villavicencio,0,0,0,0,1,0,0,1,0,0,0,0,1,0,0,1
2015,Cabo Verde,Cabo Verde : Dispersed in the country/territory,0,0,0,0,0,0,0,0,0,0,0,0,0,0,0,0
2015,Costa Rica,Costa Rica : Dispersed in the country / territory,0,0,0,0,0,0,0,0,0,0,0,0,0,0,0,0
2015,Cuba,Artemisa : Provincia,0,0,0,0,0,0,0,0,0,0,0,0,1,0,0,1
2015,Cuba,Camaguey : Provincia,0,0,0,0,2,0,0,2,0,0,0,1,8,0,0,9
2015,Cuba,Ciego de Avila : Provincia,0,0,0,0,0,0,0,0,0,0,0,0,7,0,0,7
2015,Cuba,Cienfuegos : Provincia,0,0,0,0,1,0,0,1,0,0,0,0,28,0,0,28
2015,Cuba,Granma : Provincia,0,0,0,0,0,0,0,0,0,0,0,0,7,0,0,7
2015,Cuba,Guant?â?ínamo : Provincia,0,0,0,0,0,0,0,0,0,0,0,0,1,0,0,1
2015,Cuba,Guant?ínamo : Provincia,0,0,0,0,0,0,0,0,0,0,0,0,20,0,0,20
2015,Cuba,Holguin : Provincia,0,0,0,0,0,0,0,0,0,0,0,0,16,0,0,16
2015,Cuba,La Habana : Provincia,2,0,0,4,29,2,0,37,3,6,0,4,100,2,0,115
2015,Cuba,Las Tunas : Provincia,0,0,0,0,0,0,0,0,0,0,0,0,9,0,0,9
2015,Cuba,Matanzas : Provincia,0,0,0,1,2,0,0,3,0,1,0,0,9,0,0,10
2015,Cuba,Mayabeque : Provincia,0,0,0,0,0,0,0,0,0,0,0,0,2,0,0,2
2015,Cuba,Pinar del Rio : Provincia,0,2,0,1,5,0,0,8,0,0,0,0,18,0,0,18
2015,Cuba,Sancti Spiritus : Provincia,0,0,0,0,0,0,0,0,0,0,0,0,8,0,0,8
2015,Cuba,Santiago de Cuba : Provincia,0,0,0,0,2,0,0,2,0,0,0,0,4,0,0,4
2015,Cuba,Villa Clara : Provincia,0,0,0,0,0,0,0,0,1,1,0,0,1,0,0,3
2015,Cuba,Villaclara : Provincia,0,0,0,0,0,0,0,0,0,0,0,0,17,0,0,17
2015,Curaçao,Curacao : Dispersed in the country / territory,0,3,0,6,30,1,0,40,3,5,0,0,28,2,0,38
2015,Cayman Islands,Cayman Islands : Dispersed in the country / territory,0,0,0,0,2,0,0,2,0,0,0,0,1,0,0,1
2015,Cyprus,Cyprus : Dispersed in the country / territory,0,0,0,0,0,0,0,0,0,0,0,0,0,0,0,0
2015,Czech Rep.,Czech Republic : Dispersed in the country / territory,0,0,0,0,0,0,0,0,0,0,0,0,0,0,0,0
2015,Germany,Germany : Dispersed in the country / territory,29420,35537,0,23279,160564,14944,0,263744,31938,40921,0,40101,383919,15224,0,512103
2015,Djibouti,Ali-Addeh : Point,773,1065,0,725,2747,181,0,5491,798,1088,0,763,2516,190,0,5355
2015,Djibouti,Djibouti : Point,150,211,0,152,628,9,0,1150,142,232,0,148,937,20,0,1479
2015,Djibouti,Hol-Hol : Point,145,245,0,169,467,18,0,1044,144,264,0,185,487,31,0,1111
2015,Djibouti,Obock : Pont,342,469,0,367,1367,178,0,2723,321,479,0,407,2304,142,0,3653
2015,Denmark,Denmark : Dispersed in the country / territory,0,0,0,0,0,0,0,0,0,0,0,0,0,0,0,0
2015,Dominican Rep.,Dominican Republic : Dispersed in the country / territory,32,102,0,107,421,28,0,690,23,114,0,88,406,52,0,683
2015,Algeria,Algiers : Wilaya - Province,14,10,0,4,38,0,0,66,13,10,0,5,83,0,0,111
2015,Algeria,Tindouf : Wilaya - Province,0,0,0,0,0,0,0,0,0,0,0,0,0,0,0,0
2015,Algeria,Algeria : Dispersed in the country / territory,414,416,0,245,1134,39,0,2248,461,458,0,361,3012,53,0,4345
2015,Ecuador,Ecuador : Dispersed in the country / territory,118,3689,0,10440,10677,646,0,25570,131,3761,0,10486,16295,983,0,31656
2015,Egypt,6th October : Muhafazah - Governorate,1841,3062,0,1986,9142,781,0,16812,1985,3360,0,2148,10214,817,0,18524
2015,Egypt,Al Sharqia : Muhafazah - Governorate,444,742,0,388,1804,129,0,3507,470,736,0,418,1964,124,0,3712
2015,Egypt,Alexandria : Muhafazah - Governorate,1383,2377,0,1494,6564,568,0,12386,1456,2454,0,1554,6386,605,0,12455
2015,Egypt,Aswan : Muhafazah - Governorate,1,4,0,1,12,0,0,18,2,1,0,2,19,2,0,26
2015,Egypt,Asyut : Muhafazah - Governorate,14,29,0,19,61,2,0,125,17,19,0,21,63,3,0,123
2015,Egypt,Beni Suef : Muhafazah - Governorate,14,18,0,12,31,3,0,78,13,14,0,12,40,2,0,81
2015,Egypt,Cairo : Muhafazah - Governorate,2416,4047,0,3250,15428,770,0,25911,2516,4293,0,3328,15435,711,0,26283
2015,Egypt,Dakahliya : Muhafazah - Governorate,215,364,0,204,940,55,0,1778,216,406,0,230,982,71,0,1905
2015,Egypt,Damietta : Muhafazah - Governorate,576,937,0,626,2584,213,0,4936,643,1011,0,678,2556,192,0,5080
2015,Egypt,El-Beheira : Muhafazah - Governorate,42,73,0,39,166,11,0,331,38,77,0,32,168,13,0,328
2015,Egypt,Fayoum : Muhafazah - Governorate,12,36,0,15,80,4,0,147,13,28,0,27,77,4,0,149
2015,Egypt,Gharbeya : Muhafazah - Governorate,42,87,0,43,257,23,0,452,47,92,0,69,246,25,0,479
2015,Egypt,Giza : Muhafazah - Governorate,850,1220,0,1022,5360,307,0,8759,888,1314,0,1189,5939,285,0,9615
2015,Egypt,Helwan : Muhafazah - Governorate,243,356,0,334,2136,37,0,3106,255,388,0,288,1554,38,0,2523
2015,Egypt,Ismailia : Muhafazah - Governorate,50,91,0,58,258,12,0,469,65,101,0,52,281,18,0,517
2015,Egypt,Kalyobiya : Muhafazah - Governorate,762,1330,0,728,3316,238,0,6374,835,1333,0,779,3596,234,0,6777
2015,Egypt,Luxor : Muhafazah - Governorate,3,2,0,2,18,3,0,28,5,2,0,1,17,0,0,25
2015,Egypt,Matrouh : Muhafazah - Governorate,60,78,0,50,213,10,0,411,70,88,0,41,223,14,0,436
2015,Egypt,Menia : Muhafazah - Governorate,11,14,0,11,38,1,0,75,6,21,0,9,64,0,0,100
2015,Egypt,Monofiya : Muhafazah - Governorate,120,196,0,136,506,38,0,996,118,259,0,157,506,44,0,1084
2015,Egypt,New Valley : Muhafazah - Governorate,1,2,0,0,2,0,0,5,0,2,0,1,4,1,0,8
2015,Egypt,North Sinai : Muhafazah - Governorate,6,6,0,2,11,0,0,25,1,4,0,3,8,1,0,17
2015,Egypt,Port-Said : Muhafazah - Governorate,36,71,0,54,213,17,0,391,44,79,0,40,214,22,0,399
2015,Egypt,Qena : Muhafazah - Governorate,2,6,0,6,15,2,0,31,5,4,0,7,26,1,0,43
2015,Egypt,Red Sea : Muhafazah - Governorate,48,99,0,56,235,17,0,455,49,84,0,42,282,24,0,481
2015,Egypt,Sohag : Muhafazah - Governorate,2,10,0,13,45,4,0,74,10,11,0,11,46,3,0,81
2015,Egypt,South Sinai : Muhafazah - Governorate,1,5,0,2,13,1,0,22,1,1,0,0,33,1,0,36
2015,Egypt,Suez : Muhafazah - Governorate,10,16,0,5,43,1,0,75,6,17,0,19,71,2,0,115
2015,Egypt,Egypt : Dispersed in the country / territory,6320,8049,0,4990,13355,863,0,33577,7016,5103,0,10054,14757,586,0,37516
2015,Egypt,Kafr El Shiekh : Muhafazah - Governorate,13,46,0,25,104,8,0,196,22,46,0,31,89,13,0,201
2015,Eritrea,Asmara : Point,2,1,0,1,6,0,0,10,1,3,0,2,8,0,0,14
2015,Eritrea,Emkulu : Point,216,298,0,167,472,19,0,1172,246,291,0,216,535,31,0,1319
2015,Eritrea,Gash Barka : Zoba - Region,4,4,0,2,4,0,0,14,2,4,0,5,15,1,0,27
2015,Spain,Spain : Dispersed in the country / territory,0,0,0,0,0,0,0,0,0,0,0,0,0,0,0,0
2015,Estonia,Estonia : Dispersed in the country / territory,5,0,0,12,35,8,0,60,12,0,0,16,130,2,0,160
2015,Ethiopia,Burbiey,0,0,0,0,0,0,0,0,0,0,0,0,0,0,0,0
2015,Ethiopia,Dalool,640,1222,0,719,1728,75,0,4384,671,1270,0,711,773,104,0,3529
2015,Ethiopia,Erebti,37,117,0,58,152,8,0,372,41,126,0,73,120,14,0,374
2015,Ethiopia,Fugnido : Point,6510,9031,0,4714,13831,884,0,34970,6752,9385,0,5412,6516,227,0,28292
2015,Ethiopia,Hilaweyn : Point,4100,7621,0,3215,7553,400,0,22889,4216,7440,0,3460,4001,444,0,19561
2015,Ethiopia,Hitsats,290,389,0,334,2990,7,0,4010,295,432,0,1122,6180,19,0,8048
2015,Ethiopia,Jewi,5939,7956,0,3426,10096,484,0,27901,6090,8117,0,3829,2101,142,0,20279
2015,Ethiopia,Jijiga,0,0,0,0,0,0,0,0,0,0,0,0,0,0,0,0
2015,Ethiopia,Kebribeyah : Point,1303,1682,0,1305,3014,227,0,7531,1314,1713,0,1373,2749,276,0,7425
2015,Ethiopia,Kobe Camp : Point,2944,7368,0,3623,7670,602,0,22207,2973,7331,0,4032,5046,642,0,20024
2015,Ethiopia,Kule Camp,5467,6708,0,2900,10664,642,0,26381,5559,6792,0,3442,5681,279,0,21753
2015,Ethiopia,Mai-Ayni : Point,615,832,0,530,2503,24,0,4504,667,880,0,1207,3396,75,0,6225
2015,Ethiopia,Matar,0,0,0,0,0,0,0,0,0,0,0,0,0,0,0,0
2015,Ethiopia,Melkadida : Point,3369,6628,0,4633,8958,480,0,24068,3475,6844,0,4887,5112,512,0,20830
2015,Ethiopia,Nyingnyang,0,0,0,0,0,0,0,0,0,0,0,0,0,0,0,0
2015,Ethiopia,Okugo:Point,642,1000,0,530,1958,174,0,4304,716,1073,0,556,979,56,0,3380
2015,Ethiopia,Outside of camp **,426,1276,0,1346,16742,93,0,19883,569,1313,0,2829,56326,158,0,61195
2015,Ethiopia,Pagak:Point,0,0,0,0,0,0,0,0,0,0,0,0,0,0,0,0
2015,Ethiopia,Pamdong:Point,0,0,0,0,0,0,0,0,0,0,0,0,0,0,0,0
2015,Ethiopia,Pugnido2,1744,2591,0,886,3519,197,0,8937,1771,2617,0,1236,1171,65,0,6860
2015,Ethiopia,Sheder : Point,881,1587,0,1080,2882,157,0,6587,866,1608,0,1178,1831,77,0,5560
2015,Ethiopia,Sherkole : Point,1069,1323,0,748,2040,88,0,5268,1158,1435,0,916,2503,95,0,6107
2015,Ethiopia,Shimelba (Shire/Shiraro) : Point,298,486,0,314,1157,186,0,2441,295,503,0,308,1786,179,0,3071
2015,Ethiopia,Tierkidi:Point,6238,8286,0,3820,11455,586,0,30385,6261,8578,0,4174,3703,203,0,22919
2015,Ethiopia,Tigray,7,19,0,18,90,25,0,159,13,12,0,19,182,16,0,242
2015,Ethiopia,Tongo Camp : Point,1261,1347,0,718,2134,175,0,5635,1342,1433,0,828,2174,179,0,5956
2015,Ethiopia,Tsore: Point,818,1007,0,618,1625,80,0,4148,853,1162,0,1313,2174,90,0,5592
2015,Ethiopia,Ad-Damazin Transit Centre : Point,86,371,0,144,614,55,0,1270,96,362,0,181,581,91,0,1311
2015,Ethiopia,Adiharush : Point,346,452,0,451,2143,12,0,3404,338,507,0,780,4110,37,0,5772
2015,Ethiopia,Akula Community,203,181,0,97,380,17,0,878,178,242,0,91,188,12,0,711
2015,Ethiopia,Asaita : Point,784,1143,0,638,2242,185,0,4992,874,1305,0,827,2056,228,0,5290
2015,Ethiopia,Awbarre : Point,890,1654,0,1508,2993,148,0,7193,847,1684,0,1422,2150,110,0,6213
2015,Ethiopia,Ayne-Deeb,372,698,0,480,1150,63,0,2763,333,673,0,334,284,84,0,1708
2015,Ethiopia,Bambasi Camp : Point,1841,1802,0,817,2923,273,0,7656,1879,1851,0,1009,2651,267,0,7657
2015,Ethiopia,Berhale : Point,680,1534,0,645,1542,55,0,4456,758,1534,0,704,1024,96,0,4116
2015,Ethiopia,Bokolmanyo : Point,3150,6970,0,3720,8185,470,0,22495,3266,7078,0,4106,4982,500,0,19932
2015,Ethiopia,Border Areas,0,0,0,0,0,0,0,0,0,0,0,0,0,0,0,0
2015,Ethiopia,Borena : Awrajja - Zone,299,377,0,304,763,132,0,1875,318,404,0,291,543,116,0,1672
2015,Ethiopia,Buramino : Point,2681,7719,0,2972,7401,417,0,21190,2769,7634,0,3206,3713,408,0,17730
2015,Ethiopia,Addis Ababa : Astedader akabibi - Chartered city,316,478,0,397,2185,119,0,3495,328,553,0,434,2865,215,0,4395
2015,Finland,Finland,0,0,0,0,0,0,0,0,0,0,0,0,0,0,0,0
2015,Finland,Finland : Dispersed in the country / territory,0,0,0,0,0,0,0,0,0,0,0,0,0,0,0,0
2015,Fiji,Lotoka,0,0,0,0,0,0,0,0,0,0,0,0,1,0,0,1
2015,Fiji,Nadi,0,1,0,1,1,0,0,3,1,0,0,0,1,0,0,2
2015,Fiji,Suva : Point,0,0,0,0,6,0,0,6,0,0,0,1,7,0,0,8
2015,France,France : Dispersed in the country / territory,0,0,0,0,0,0,0,0,0,0,0,0,0,0,0,0
2015,Micronesia (Federated States of),Yap,0,0,0,0,0,0,0,0,0,0,0,0,14,0,0,14
2015,Gabon,Akieni : Point,2,1,0,2,2,0,0,7,1,2,0,2,4,0,0,9
2015,Gabon,Bitam : Point,0,0,0,0,0,0,0,0,0,0,0,1,1,0,0,2
2015,Gabon,Bongoville : Point,0,0,0,0,3,0,0,3,1,0,0,0,1,0,0,2
2015,Gabon,Booue : Point,0,0,0,0,1,0,0,1,0,0,0,0,0,0,0,0
2015,Gabon,Franceville : Point,46,73,0,31,186,1,0,337,36,74,0,42,295,12,0,459
2015,Gabon,Gamba : Point,0,0,0,0,1,0,0,1,0,0,0,0,0,0,0,0
2015,Gabon,Koulamoutou : Point,9,22,0,12,41,0,0,84,13,21,0,9,73,2,0,118
2015,Gabon,Lambarene : Point,0,0,0,0,0,1,0,1,0,0,0,0,1,1,0,2
2015,Gabon,Lastoursville : Point,0,2,0,0,1,0,0,3,0,0,0,0,6,0,0,6
2015,Gabon,Leconi,0,0,0,0,0,0,0,0,0,0,0,0,3,1,0,4
2015,Gabon,Libreville : Point,41,82,0,74,351,9,0,557,53,85,0,88,550,47,0,823
2015,Gabon,Makokou : Point,1,1,0,0,1,0,0,3,0,2,0,1,1,0,0,4
2015,Gabon,Medouneu,0,0,0,0,0,0,0,0,0,0,0,0,1,0,0,1
2015,Gabon,Mitzic : Point,0,0,0,0,0,0,0,0,0,0,0,0,3,0,0,3
2015,Gabon,Moanda : Point,16,25,0,12,49,0,0,102,11,17,0,18,92,1,0,139
2015,Gabon,Mouila : Point,0,2,0,2,4,0,0,8,0,0,0,2,8,0,0,10
2015,Gabon,Mounana : Point,1,0,0,1,8,0,0,10,0,0,0,4,9,1,0,14
2015,Gabon,Ndjole : Point,0,0,0,0,0,0,0,0,0,0,0,0,1,1,0,2
2015,Gabon,Ngwoni : Point,0,1,0,0,1,0,0,2,0,0,0,0,3,0,0,3
2015,Gabon,Ntoum : Point,0,1,0,1,3,0,0,5,0,2,0,0,5,0,0,7
2015,Gabon,Okondja : Point,1,0,0,0,2,0,0,3,0,0,0,1,11,1,0,13
2015,Gabon,Oyem : Point,0,0,0,0,1,0,0,1,0,0,0,0,5,0,0,5
2015,Gabon,Pana/Dienga : Point,0,0,0,0,0,0,0,0,0,0,0,0,2,0,0,2
2015,Gabon,Port-Gentil : Point,5,3,0,3,23,2,0,36,7,4,0,1,60,8,0,80
2015,Gabon,Tchibanga : Point,0,0,0,1,4,0,0,5,0,2,0,0,5,0,0,7
2015,United Kingdom,United Kingdom of Great Britain and Northern Ireland : Dispersed in the country / territory,0,0,0,0,0,0,0,0,0,0,0,0,0,0,0,0
2015,Georgia,Abkhazia : Autonomous republic,27,49,0,25,196,43,0,340,21,48,0,31,200,39,0,339
2015,Georgia,Batumi,0,1,0,1,3,0,0,5,0,2,0,0,2,0,0,4
2015,Georgia,Kutaisi,0,0,0,0,1,0,0,1,0,0,0,0,0,0,0,0
2015,Georgia,Tbilisi : City,1,2,0,0,17,0,0,20,2,1,0,8,170,0,0,181
2015,Georgia,Vale : Point,0,0,0,0,2,0,0,2,0,0,0,0,1,0,0,1
2015,Georgia,Georgia : Dispersed in the country / territory,11457,12838,0,11992,78607,29754,0,144648,11982,13789,0,13273,68297,18872,0,126213
2015,Ghana,Accra : District,52,152,0,242,369,27,0,842,61,187,0,511,693,46,0,1498
2015,Ghana,Ampain : Point,276,466,0,462,1439,78,0,2721,307,467,0,459,1107,31,0,2371
2015,Ghana,Asanti Region,1,0,0,4,13,2,0,20,3,6,0,12,29,1,0,51
2015,Ghana,Brong Ahafo,0,0,0,1,2,0,0,3,0,5,0,2,5,0,0,12
2015,Ghana,Buduburam : Point,59,191,0,204,1019,40,0,1513,75,175,0,232,865,23,0,1370
2015,Ghana,Central Region and its environs,81,96,0,55,190,13,0,435,101,98,0,74,202,8,0,483
2015,Ghana,Egyeikroum : Point,112,169,0,152,544,21,0,998,141,173,0,167,554,15,0,1050
2015,Ghana,Fetentaa : Point,172,150,0,114,562,14,0,1012,163,121,0,106,587,8,0,985
2015,Ghana,Fetentaa environs,7,12,0,5,47,0,0,71,8,9,0,3,47,1,0,68
2015,Ghana,Krisan : Point,43,51,0,62,138,8,0,302,40,62,0,74,359,10,0,545
2015,Ghana,Northen Region,0,2,0,0,1,0,0,3,0,0,0,1,1,0,0,2
2015,Ghana,Volta : Region,162,236,0,159,608,59,0,1224,145,324,0,82,902,72,0,1525
2015,Ghana,Western region environa,5,8,0,9,41,4,0,67,5,7,0,14,59,7,0,92
2015,Guinea,Beyla : Prefecture,8,35,0,20,75,5,0,143,7,33,0,16,34,4,0,94
2015,Guinea,Conakry : Special zone,45,124,0,125,631,9,0,934,58,125,0,137,865,24,0,1209
2015,Guinea,Gbonodou,29,49,0,48,169,11,0,306,19,72,0,67,156,30,0,344
2015,Guinea,Kissidougou,5,5,0,6,17,3,0,36,2,8,0,4,12,1,0,27
2015,Guinea,Kouankan : Point,369,561,0,600,1367,82,0,2979,320,516,0,559,1291,54,0,2740
2015,Guinea,Kountaya : Point,3,8,0,6,32,2,0,51,6,11,0,4,26,4,0,51
2015,Guinea,Nzerekore : Prefecture,2,2,0,4,52,5,0,65,1,2,0,5,45,5,0,58
2015,Gambia,Gambia : Dispersed in the country / territory,475,843,0,593,1903,229,0,4043,430,869,0,595,1643,274,0,3811
2015,Guinea-Bissau,Asselem,0,0,0,0,0,0,0,0,0,0,0,0,0,0,0,0
2015,Guinea-Bissau,Bissau : Autonomous sector,0,0,0,0,0,0,0,0,0,0,0,0,0,0,0,0
2015,Greece,Greece : Dispersed in the country / territory,0,0,0,0,0,0,0,0,0,0,0,0,0,0,0,0
2015,Grenada,St. George's,0,0,0,0,0,0,0,0,0,0,0,0,1,0,0,1
2015,Guatemala,Guatemala : Dispersed in the country / territory,2,9,0,16,90,11,0,128,4,7,0,10,194,8,0,223
2015,Guyana,Guyana : Dispersed in the country / territory,0,1,0,2,5,0,0,8,0,0,0,0,4,0,0,4
2015,"China, Hong Kong SAR","Hong Kong SAR, China : Dispersed in the country / territory",44,35,0,20,947,8,0,1054,52,43,0,17,1274,9,0,1395
2015,Honduras,Ceiba : Municipio,0,0,0,0,0,0,0,0,0,0,0,0,2,0,0,2
2015,Honduras,Comayagua : Departamento,0,0,0,0,1,0,0,1,0,0,0,0,0,0,0,0
2015,Honduras,Islas de la Bahia : Departamento,0,0,0,0,2,0,0,2,0,0,0,0,0,0,0,0
2015,Honduras,Tegucigalpa : Municipio,0,1,0,0,2,0,0,3,0,1,0,0,14,0,0,15
2015,Honduras,Honduras : Dispersed in the country / territory,10000,12700,0,13702,50005,4300,0,90707,11100,15901,0,12500,45308,3600,0,88409
2015,Croatia,Bjelovar : Point,0,0,0,0,0,0,0,0,0,0,0,0,1,0,0,1
2015,Croatia,Croatia : Dispersed in the country / territory,0,0,0,0,0,0,0,0,0,0,0,0,0,0,0,0
2015,Croatia,Kutina,0,1,0,0,4,0,0,5,0,1,0,2,45,0,0,48
2015,Croatia,Kutina : Point,0,0,0,0,0,0,0,0,0,0,0,0,1,0,0,1
2015,Croatia,Mala Gorica,0,0,0,0,0,0,0,0,0,0,0,0,0,0,0,0
2015,Croatia,Rijeka : Point,0,0,0,0,0,0,0,0,0,0,0,0,2,0,0,2
2015,Croatia,Vinkovci : Point,0,0,0,0,1,0,0,1,0,0,0,0,0,0,0,0
2015,Croatia,Zagreb,8,10,0,10,15,0,0,43,4,6,0,13,97,0,0,120
2015,Haiti,Haiti : Dispersed in the country / territory,0,317,0,109,40,1,0,467,0,353,0,123,34,0,0,510
2015,Haiti,Port au Prince : Point,0,0,0,0,4,0,0,4,0,0,0,0,8,0,0,8
2015,Hungary,B??k??scsaba,0,0,0,0,0,0,0,0,0,0,0,0,0,0,0,0
2015,Hungary,Bicske,0,0,0,0,0,0,0,0,0,0,0,0,0,0,0,0
2015,Hungary,Kiskunhalas,0,0,0,0,0,0,0,0,0,0,0,0,0,0,0,0
2015,Hungary,Nagyfa,0,0,0,0,0,0,0,0,0,0,0,0,0,0,0,0
2015,Hungary,Nyirbator,0,0,0,0,0,0,0,0,0,0,0,0,0,0,0,0
2015,Hungary,Unknown,0,0,0,0,0,0,0,0,0,0,0,0,0,0,0,0
2015,Hungary,Vamosszabadi,0,0,0,0,0,0,0,0,0,0,0,0,0,0,0,0
2015,Indonesia,Bali,3,7,0,5,21,0,0,36,2,6,0,9,73,0,0,90
2015,Indonesia,Banten,16,26,0,17,84,5,0,148,19,28,0,29,256,7,0,339
2015,Indonesia,Indonesia: other locations (dispersed in territory),13,9,0,2,11,0,0,35,6,5,0,1,48,0,0,60
2015,Indonesia,Irian Jaya Tengah,0,0,0,0,0,0,0,0,0,0,0,0,4,0,0,4
2015,Indonesia,Jakarta,69,102,0,70,484,15,0,740,88,133,0,261,1347,14,0,1843
2015,Indonesia,Jawa Barat : Provinsi - Province,58,106,0,76,368,22,0,630,82,115,0,158,1512,20,0,1887
2015,Indonesia,Jawa Tengah,10,5,0,5,35,2,0,57,4,7,0,13,41,1,0,66
2015,Indonesia,Jawa Timur,0,1,0,2,1,0,0,4,0,2,0,8,443,0,0,453
2015,Indonesia,Kalimantan Barat,0,0,0,0,0,0,0,0,0,0,0,7,193,0,0,200
2015,Indonesia,Kalimantan Timur,0,0,0,0,0,0,0,0,0,0,0,5,247,0,0,252
2015,Indonesia,Kepulauan Riau,11,10,0,3,63,0,0,87,17,24,0,45,531,1,0,618
2015,Indonesia,Lampung,0,0,0,0,0,0,0,0,0,0,0,0,2,0,0,2
2015,Indonesia,Nanggroe Aceh Darussalam,9,16,0,29,57,0,0,111,17,28,0,54,134,0,0,233
2015,Indonesia,Nusa Tenggara Timur,4,13,0,7,37,0,0,61,6,12,0,35,334,1,0,388
2015,Indonesia,Riau,33,48,0,23,128,5,0,237,36,56,0,64,645,5,0,806
2015,Indonesia,Sulawesi Selatan,83,90,0,43,337,11,0,564,98,88,0,133,1114,5,0,1438
2015,Indonesia,Sulawesi Tenggara,0,0,0,0,1,0,0,1,0,0,0,0,1,0,0,1
2015,Indonesia,Sulawesi Utara,0,0,0,0,0,0,0,0,0,0,0,19,197,2,0,218
2015,Indonesia,Sumatera Barat : Provinsi - Province,0,0,0,0,0,0,0,0,0,0,0,0,1,0,0,1
2015,Indonesia,Sumatera Utara,106,122,0,68,420,12,0,728,88,116,0,99,839,15,0,1157
2015,Indonesia,Yogyakarta,0,0,0,0,0,0,0,0,0,0,0,0,53,0,0,53
2015,India,Delhi : Union territory,1402,2517,0,1796,10021,701,0,16437,1510,2602,0,2071,10286,652,0,17121
2015,India,India : Dispersed in the country / territory,0,0,0,0,0,0,0,0,0,0,0,0,0,0,0,0
2015,India,Tamil Nadu : State,0,0,0,0,0,0,0,0,0,0,0,0,0,0,0,0
2015,Ireland,Ireland : Dispersed in the country / territory,159,274,0,260,2861,138,0,3692,173,282,0,277,6233,207,0,7172
2015,Iran (Islamic Rep. of),Abazar : Point,1,7,0,10,35,6,0,59,5,8,0,12,50,4,0,79
2015,Iran (Islamic Rep. of),Ansar,2,5,0,5,12,2,0,26,1,3,0,6,8,2,0,20
2015,Iran (Islamic Rep. of),Bani Najjar : Point,132,125,0,172,624,17,0,1070,142,128,0,171,608,32,0,1081
2015,Iran (Islamic Rep. of),Bezileh : Point,1,1,0,2,13,1,0,18,1,2,0,4,11,1,0,19
2015,Iran (Islamic Rep. of),Dalaki : Point,30,11,0,13,29,3,0,86,28,9,0,14,22,0,0,73
2015,Iran (Islamic Rep. of),Dilzeh : Point,2,3,0,10,15,2,0,32,4,3,0,5,15,1,0,28
2015,Iran (Islamic Rep. of),Islamic Republic of Iran : Dispersed in the country / territory,0,0,0,0,0,0,0,0,0,0,0,0,0,0,0,0
2015,Iran (Islamic Rep. of),Mohajerin : Point,221,246,0,321,904,84,0,1776,201,290,0,284,860,107,0,1742
2015,Iran (Islamic Rep. of),Sultanieh : Point,1,0,0,1,4,3,0,9,1,0,0,1,3,2,0,7
2015,Iran (Islamic Rep. of),Varmahang : Point,1,1,0,2,2,0,0,6,0,0,0,0,3,0,0,3
2015,Iran (Islamic Rep. of),Ziveh : Point,6,18,0,29,97,8,0,158,7,19,0,20,82,12,0,140
2015,Iran (Islamic Rep. of),Ardakan : Shahrestan - County,159,242,0,301,631,38,0,1371,192,262,0,284,707,62,0,1507
2015,Iran (Islamic Rep. of),Bardsir : Shahrestan - County,252,251,0,295,602,35,0,1435,248,265,0,299,608,27,0,1447
2015,Iran (Islamic Rep. of),Jahrom : Shahrestan - County,8,13,0,15,50,7,0,93,6,9,0,15,54,4,0,88
2015,Iran (Islamic Rep. of),Kerman : Shahrestan - County,1,0,0,1,1,0,0,3,1,1,0,1,3,0,0,6
2015,Iran (Islamic Rep. of),Khorasan : Ostan - Province,0,0,0,0,0,0,0,0,0,0,0,0,2,0,0,2
2015,Iran (Islamic Rep. of),Khuzestan : Ostan - Province,0,1,0,0,3,0,0,4,1,0,0,0,3,0,0,4
2015,Iran (Islamic Rep. of),Meybod : Shahrestan - County,74,68,0,84,351,20,0,597,70,68,0,105,352,20,0,615
2015,Iran (Islamic Rep. of),Rafsanjan : Shahrestan - County,342,570,0,592,642,210,0,2356,383,530,0,680,592,282,0,2467
2015,Iran (Islamic Rep. of),Sarvestan : Shahrestan - County,52,72,0,53,133,14,0,324,40,54,0,61,142,30,0,327
2015,Iran (Islamic Rep. of),Saveh : Shahrestan - County,363,580,0,449,860,34,0,2286,453,530,0,554,814,128,0,2479
2015,Iran (Islamic Rep. of),Sonqor : Shahrestan - County,1,3,0,2,8,2,0,16,1,4,0,4,5,1,0,15
2015,Iran (Islamic Rep. of),Taft : Shahrestan - County,51,47,0,122,218,31,0,469,41,83,0,97,270,24,0,515
2015,Iran (Islamic Rep. of),Tehran : Shahrestan - County,2,3,0,4,13,1,0,23,4,4,0,5,14,0,0,27
2015,Iran (Islamic Rep. of),Torbat e jam : Shahrestan - County,131,252,0,291,1152,98,0,1924,124,254,0,320,1162,152,0,2012
2015,Iraq,Anbar : Muhafazah - Province,332,655,0,348,1083,125,0,2543,331,628,0,378,772,87,0,2196
2015,Iraq,Babylon : Muhafazah - Province,1,3,0,2,9,1,0,16,1,6,0,3,17,2,0,29
2015,Iraq,Baghdad : Muhafazah - Province,221,504,0,426,2651,514,0,4316,265,563,0,414,2894,611,0,4747
2015,Iraq,Basrah : Muhafazah - Province,4,23,0,28,66,13,0,134,5,21,0,28,72,9,0,135
2015,Iraq,Diyala : Muhafazah - Province,2,18,0,13,76,8,0,117,6,22,0,12,70,8,0,118
2015,Iraq,Duhok : Muhafazah - Province,7272,8385,0,4934,22920,1269,0,44780,7534,8780,0,5752,30392,1141,0,53599
2015,Iraq,Erbil : Muhafazah - Province,8372,8951,0,6302,31055,2029,0,56709,8625,9422,0,7879,47096,1778,0,74800
2015,Iraq,Kerbala : Muhafazah - Province,6,15,0,8,78,6,0,113,7,15,0,7,48,7,0,84
2015,Iraq,Kirkuk : Muhafazah - Province,65,74,0,33,172,10,0,354,84,81,0,55,257,13,0,490
2015,Iraq,Missan : Muhafazah - Province,0,0,0,0,0,0,0,0,0,0,0,0,0,1,0,1
2015,Iraq,Muthanna : Muhafazah - Province,1,2,0,0,1,0,0,4,0,0,0,0,1,0,0,1
2015,Iraq,Najaf : Muhafazah - Province,7,18,0,4,65,6,0,100,11,15,0,9,152,4,0,191
2015,Iraq,Ninewa : Muhafazah - Province,116,216,0,161,731,83,0,1307,102,243,0,166,674,74,0,1259
2015,Iraq,Qadissiya : Muhafazah - Province,0,4,0,7,8,1,0,20,2,4,0,2,9,1,0,18
2015,Iraq,Salah al-Din : Muhafazah - Province,7,9,0,5,14,4,0,39,1,6,0,11,30,4,0,52
2015,Iraq,Sulaymaniyah : Muhafazah - Province,2384,2556,0,1642,8275,532,0,15389,2501,2756,0,2063,12909,498,0,20727
2015,Iraq,Thi-Qar : Muhafazah - Province,0,0,0,0,4,1,0,5,0,1,0,1,1,0,0,3
2015,Iraq,Wassit : Muhafazah - Province,0,1,0,0,10,1,0,12,1,0,0,0,6,1,0,8
2015,Iraq,Iraq : Dispersed in the country / territory,36,59,0,43,198,15,0,351,31,70,0,40,230,12,0,383
2015,Iceland,Iceland : Dispersed in the country / territory,0,0,0,0,0,0,0,0,0,0,0,0,0,0,0,0
2015,Israel,Israel : Dispersed in the country / territory,0,0,0,0,0,0,0,0,0,0,0,0,0,0,0,0
2015,Italy,Italy : Dispersed in the country / territory,0,0,0,0,0,0,0,0,0,0,0,0,0,0,0,0
2015,Jamaica,Jamaica : Dispersed in the country / territory,0,0,0,0,5,0,0,5,1,0,0,1,10,0,0,12
2015,Jordan,Ajlun : Governorate,525,833,0,532,1616,169,0,3675,592,893,0,538,1191,117,0,3331
2015,Jordan,Amman : Governorate,13563,20032,0,11957,55493,6478,0,107523,14289,21202,0,12972,60071,5240,0,113774
2015,Jordan,Aqabah : Governorate,207,256,0,170,749,63,0,1445,248,306,0,171,814,51,0,1590
2015,Jordan,Balqa : Governorate,1505,2103,0,1303,5000,399,0,10310,1585,2218,0,1420,4604,314,0,10141
2015,Jordan,Irbid : Governorate,8368,12914,0,8076,28385,2976,0,60719,8634,13686,0,8270,22834,2056,0,55480
2015,Jordan,Jarash : Governorate,657,968,0,621,2079,218,0,4543,666,997,0,619,1724,140,0,4146
2015,Jordan,Karak : Governorate,680,929,0,518,1993,189,0,4309,712,1013,0,587,1923,151,0,4386
2015,Jordan,Maan : Governorate,503,680,0,406,1557,111,0,3257,494,714,0,437,1616,83,0,3344
2015,Jordan,Madaba : Governorate,849,1147,0,689,2594,204,0,5483,900,1196,0,756,2484,151,0,5487
2015,Jordan,Mafraq : Governorate,8612,13236,0,8428,27346,2404,0,60026,9234,13766,0,8848,21900,1608,0,55356
2015,Jordan,Mafraq : Zataari Camp,6915,8729,0,5650,16950,1276,0,39520,7350,9278,0,5921,14781,931,0,38261
2015,Jordan,Tafilah : Governorate,118,179,0,90,374,26,0,787,156,189,0,95,380,24,0,844
2015,Jordan,Zarqa : Emirates Jordanian Camp (EJC),569,927,0,453,1227,72,0,3248,611,867,0,451,1055,45,0,3029
2015,Jordan,Zarqa : Governorate,3509,5426,0,3477,12439,1115,0,25966,3751,5873,0,3597,10976,817,0,25014
2015,Jordan,Zarqa: Azraq Camp,2741,3099,0,1674,6387,353,0,14254,2862,3361,0,1903,5625,250,0,14001
2015,Jordan,Jordan : Dispersed in the country / territory,268,536,0,370,1543,180,0,2897,301,609,0,405,1450,142,0,2907
2015,Japan,Japan : Dispersed in the country / territory,0,0,0,0,0,0,0,0,0,0,0,0,0,0,0,0
2015,Kazakhstan,Almaty : City,17,29,0,30,128,11,0,215,17,35,0,26,158,8,0,244
2015,Kazakhstan,Almaty : Oblast - Province,1,2,0,2,18,2,0,25,0,4,0,5,19,2,0,30
2015,Kazakhstan,Astana : City,0,0,0,0,0,0,0,0,0,0,0,0,2,0,0,2
2015,Kazakhstan,Kazakhstan : Dispersed in the country / territory,0,0,0,0,0,0,0,0,0,0,0,0,4,0,0,4
2015,Kazakhstan,Kostanai,0,1,0,0,1,0,0,2,0,0,0,0,1,0,0,1
2015,Kazakhstan,Petropavlovsk,0,0,0,0,0,0,0,0,0,0,0,0,1,0,0,1
2015,Kazakhstan,South Kazakhstan : Oblast - Province,9,13,0,8,49,0,0,79,16,18,0,5,153,6,0,198
2015,Kazakhstan,West Kazakhstan,0,0,0,0,1,0,0,1,0,0,0,0,0,0,0,0
2015,Kazakhstan,Zhambyl : Oblast - Province,0,0,0,0,1,0,0,1,0,0,0,0,1,1,0,2
2015,Kenya,Dagahaley : Point,6974,11520,0,7219,17030,1491,0,44234,6973,12128,0,8079,14409,1400,0,42989
2015,Kenya,Hagadera : Point,7743,12692,0,8378,22542,1870,0,53225,8298,13417,0,9288,20008,1762,0,52773
2015,Kenya,Ifo 2 : Point,4651,7255,0,3904,8033,683,0,24526,4876,8208,0,4981,7243,792,0,26100
2015,Kenya,Ifo : Point,6265,10172,0,6671,17434,1525,0,42067,6698,10647,0,7472,15680,1525,0,42022
2015,Kenya,Kakuma : Point,12214,20093,0,14328,36703,1873,0,85211,12524,22314,0,20001,43577,923,0,99339
2015,Kenya,Kambioos : Point,1771,2941,0,1542,3155,272,0,9681,1864,3305,0,2025,2886,283,0,10363
2015,Kenya,Kenya: Dispersed in the country / territory,0,0,0,0,0,0,0,0,0,0,0,0,0,0,0,0
2015,Kenya,Nairobi : Province,2177,4548,0,4218,19004,1028,0,30975,2398,4804,0,4044,18454,676,0,30376
2015,Kyrgyzstan,Bishkek : Shaar - City,19,32,0,35,116,3,0,205,18,40,0,28,208,1,0,295
2015,Kyrgyzstan,Kyrgyzstan : Dispersed in the country / territory,0,0,0,0,4194,1185,0,5379,0,0,0,0,2827,912,0,3739
2015,Kyrgyzstan,Osh : Oblast - Region,0,0,0,0,1,0,0,1,0,0,0,0,0,0,0,0
2015,Kyrgyzstan,Osh City : Shaar - City,0,1,0,2,2,0,0,5,3,1,0,0,2,0,0,6
2015,Cambodia,Phnom Penh : Autonomous municipality,7,21,0,8,45,3,0,84,8,13,0,46,147,3,0,217
2015,Rep. of Korea,Ansan,0,0,0,0,10,0,0,10,1,1,0,0,73,0,0,75
2015,Rep. of Korea,Busan: Gwangyeoksi - Metropolitan City,2,6,0,2,27,0,0,37,3,7,0,5,151,0,0,166
2015,Rep. of Korea,Changwon,1,0,0,0,6,0,0,7,2,0,0,0,47,0,0,49
2015,Rep. of Korea,Cheonan,0,0,0,0,5,0,0,5,0,0,0,0,3,0,0,3
2015,Rep. of Korea,Cheongju,0,1,0,0,3,0,0,4,0,0,0,0,11,0,0,11
2015,Rep. of Korea,Cheongju Detention,0,0,0,0,0,0,0,0,0,0,0,0,2,0,0,2
2015,Rep. of Korea,Chuncheon,0,0,0,0,1,0,0,1,0,0,0,0,1,0,0,1
2015,Rep. of Korea,Daegu : Gwangyeoksi - Metropolitan city,4,1,0,0,42,1,0,48,2,0,0,0,445,1,0,448
2015,Rep. of Korea,Daejeon : Gwangyeoksi - Metropolitan city,2,2,0,0,14,1,0,19,0,0,0,2,39,1,0,42
2015,Rep. of Korea,Gimhae,0,0,0,0,0,0,0,0,0,0,0,0,2,0,0,2
2015,Rep. of Korea,Gunsan,0,0,0,0,0,0,0,0,0,0,0,0,2,0,0,2
2015,Rep. of Korea,Gwangju,4,4,0,0,38,0,0,46,6,3,0,2,471,0,0,482
2015,Rep. of Korea,Incheon Airport,34,18,0,11,86,2,0,151,23,20,0,26,91,1,0,161
2015,Rep. of Korea,Inchon - Yeongjongdo,0,1,0,2,6,0,0,9,2,6,0,1,4,0,0,13
2015,Rep. of Korea,Inchon: Gwangyeoksi - Metropolitan,2,4,0,0,40,0,0,46,8,3,0,3,198,0,0,212
2015,Rep. of Korea,Jeju - Do (Province),1,0,0,1,134,1,0,137,0,0,0,1,139,4,0,144
2015,Rep. of Korea,Jeonju,0,0,0,0,2,0,0,2,1,0,0,0,71,0,0,72
2015,Rep. of Korea,Mokpo,0,0,0,0,0,0,0,0,2,0,0,0,14,0,0,16
2015,Rep. of Korea,Pohang : Point,0,0,0,0,0,0,0,0,0,0,0,0,1,0,0,1
2015,Rep. of Korea,Republic of Korea : Dispersed in the country / territory,0,0,0,0,0,0,0,0,0,0,0,0,0,0,0,0
2015,Rep. of Korea,Sacheon,0,0,0,0,0,0,0,0,0,0,0,0,1,0,0,1
2015,Rep. of Korea,Suwon : Point,2,0,0,0,22,0,0,24,0,0,0,0,217,1,0,218
2015,Rep. of Korea,Ulsan,1,0,0,0,9,0,0,10,2,0,0,1,107,0,0,110
2015,Rep. of Korea,Whasung,0,0,0,0,3,1,0,4,0,0,0,0,13,1,0,14
2015,Rep. of Korea,Whasung Detention,0,0,0,0,1,0,0,1,0,0,0,0,5,0,0,5
2015,Rep. of Korea,Yangju : Point,1,0,0,1,21,0,0,23,5,2,0,1,206,1,0,215
2015,Rep. of Korea,Yeosu,0,0,0,0,0,0,0,0,0,0,0,0,5,0,0,5
2015,Rep. of Korea,Seoul : Teukbyeolsi - Capital metropolitan city,62,66,0,19,481,17,0,645,66,53,0,29,3040,18,0,3206
2015,Kuwait,kUWAIT,44,136,0,178,185,180,0,723,94,206,0,193,282,94,0,869
2015,Lebanon,Beirut : Mohafazah - Governorate,2246,2780,0,1399,7003,396,0,13824,2387,2995,0,1642,8643,369,0,16036
2015,Lebanon,Beqaa : Mohafazah - Governorate,33982,43250,0,26620,92147,5757,0,201756,35206,45463,0,25855,59687,4517,0,170728
2015,Lebanon,North : Mohafazah - Governorate,23526,28018,0,16478,62774,4170,0,134966,24160,29291,0,17107,53101,3202,0,126861
2015,Lebanon,South : Mohafazah - Governorate,12119,14004,0,7284,29856,1550,0,64813,12732,14730,0,7675,24554,1128,0,60819
2015,Lebanon,Mount Lebanon : Mohafazah - Governorate,24935,30463,0,15114,71768,4193,0,146473,26646,32422,0,16806,72627,3454,0,151955
2015,Liberia,Bahn Refugee Camp,477,764,0,398,1207,77,0,2923,488,803,0,409,851,62,0,2613
2015,Liberia,Grand Gedeh : County,253,564,0,265,1205,212,0,2499,245,529,0,303,900,113,0,2090
2015,Liberia,Little Wlebbo : Point,836,1245,0,592,1721,111,0,4505,762,1236,0,584,1097,63,0,3742
2015,Liberia,Maryland : County,66,224,0,103,336,39,0,768,61,204,0,118,330,19,0,732
2015,Liberia,Montserrado : County,25,49,0,52,200,1,0,327,27,47,0,49,281,11,0,415
2015,Liberia,Nimba : County,26,59,0,30,145,18,0,278,17,52,0,30,72,8,0,179
2015,Liberia,PTP : Point,1108,1734,0,792,3022,257,0,6913,1109,1752,0,992,2817,184,0,6854
2015,Liberia,River Ghee : County,95,294,0,126,339,37,0,891,101,319,0,146,212,14,0,792
2015,Libya,Ghadames : Point,0,0,0,0,0,0,0,0,0,0,0,0,0,0,0,0
2015,Libya,Kufra : Popularate,0,0,0,0,0,0,0,0,0,0,0,0,0,0,0,0
2015,Libya,Misrata : Popularate,0,0,0,0,0,0,0,0,0,0,0,0,0,0,0,0
2015,Libya,Nalut : Popularate,0,0,0,0,0,0,0,0,0,0,0,0,0,0,0,0
2015,Libya,Sabha : Popularate,0,0,0,0,0,0,0,0,0,0,0,0,0,0,0,0
2015,Libya,Sirte : Popularate,0,0,0,0,0,0,0,0,0,0,0,0,0,0,0,0
2015,Libya,Tewargha : Point,0,0,0,0,0,0,0,0,0,0,0,0,0,0,0,0
2015,Libya,Western Mountains : Popularate,0,0,0,0,0,0,0,0,0,0,0,0,0,0,0,0
2015,Libya,Libya : Dispersed in the country / territory,1019,2638,0,1526,9346,521,0,15050,1045,2846,0,1910,15131,802,0,21734
2015,Saint Lucia,Saint Lucia : Dispersed in the country / territory,0,0,0,0,0,0,0,0,0,0,0,0,2,0,0,2
2015,Liechtenstein,Liechtenstein : Dispersed in the country / territory,0,0,0,0,0,0,0,0,0,0,0,0,0,0,0,0
2015,Sri Lanka,Batticaloa : District,0,0,0,0,0,0,0,0,0,0,0,0,0,0,0,0
2015,Sri Lanka,Colombo : District,10,26,0,19,67,5,0,127,14,20,0,12,85,2,0,133
2015,Sri Lanka,Gampaha : District,52,70,0,46,283,12,0,463,66,79,0,64,390,15,0,614
2015,Sri Lanka,Jaffna : District,6,7,0,4,41,5,0,63,6,9,0,6,36,4,0,61
2015,Sri Lanka,Kaluthara,3,2,0,0,7,0,0,12,5,3,0,4,24,0,0,36
2015,Sri Lanka,Kandy : District,0,0,0,0,1,0,0,1,1,0,0,1,1,0,0,3
2015,Sri Lanka,Kegalle,0,0,0,0,0,0,0,0,0,0,0,0,3,0,0,3
2015,Sri Lanka,Kilinochchi : District,2,1,0,0,17,2,0,22,0,4,0,1,16,0,0,21
2015,Sri Lanka,Mannar : District,3,11,0,3,36,8,0,61,4,12,0,4,35,6,0,61
2015,Sri Lanka,Mullaitivu : District,2,4,0,1,10,0,0,17,3,2,0,1,6,1,0,13
2015,Sri Lanka,Sri Lanka : Dispersed in the country / territory,1,0,0,2,10,1,0,14,1,0,0,0,13,0,0,14
2015,Sri Lanka,Trincomalee : District,9,7,0,3,28,3,0,50,1,11,0,2,28,3,0,45
2015,Sri Lanka,Vavuniya : District,2,2,0,3,24,2,0,33,3,5,0,4,26,2,0,40
2015,Lesotho,Lesotho : Dispersed in the country / territory,3,1,0,0,8,0,0,12,0,0,0,1,22,0,0,23
2015,Lithuania,Lithuania : Dispersed in the country / territory,0,0,0,0,0,0,0,0,0,0,0,0,0,0,0,0
2015,Lithuania,municipality,8,18,0,9,64,4,0,103,14,16,0,12,95,6,0,143
2015,Lithuania,RRC Rukla : Point,4,16,0,16,53,4,0,93,11,9,0,40,77,5,0,142
2015,Luxembourg,Luxembourg : Dispersed in the country / territory,0,0,0,0,0,0,0,0,0,0,0,0,0,0,0,0
2015,Latvia,Latvia : Dispersed in the country / territory,0,0,0,0,0,0,0,0,0,0,0,0,0,0,0,0
2015,"China, Macao SAR","Macao SAR, China : Dispersed in the country / territory",0,0,0,0,1,0,0,1,0,0,0,1,5,0,0,6
2015,Morocco,Morocco : Dispersed in the country / territory,372,349,0,228,1147,40,0,2136,335,389,0,377,2188,48,0,3337
2015,Monaco,Monaco : Dispersed in the country / territory,0,0,0,0,0,0,0,0,0,0,0,0,0,0,0,0
2015,Rep. of Moldova,Republic of Moldova : Dispersed in the country / territory,14,21,0,10,1115,228,0,1388,11,20,0,20,984,161,0,1196
2015,Madagascar,Madagascar : Dispersed in the country / territory,0,0,0,0,5,0,0,5,0,0,0,0,17,0,0,17
2015,Mexico,Mexico : Dispersed in the country / territory,0,0,0,0,0,0,0,0,0,0,0,0,0,0,0,0
2015,The former Yugoslav Republic of Macedonia,Berovo : Op?ítina - Municipality,0,0,0,0,1,0,0,1,0,0,0,0,0,0,0,0
2015,The former Yugoslav Republic of Macedonia,Kavadarci : Op?ítina - Municipality,0,0,0,0,3,0,0,3,0,0,0,0,0,0,0,0
2015,The former Yugoslav Republic of Macedonia,Kicevo : Op?ítina - Municipality,0,0,0,0,6,2,0,8,0,0,0,0,5,0,0,5
2015,The former Yugoslav Republic of Macedonia,Kocani : Op?ítina - Municipality,0,0,0,0,0,0,0,0,0,0,0,0,1,0,0,1
2015,The former Yugoslav Republic of Macedonia,Negotino,0,0,0,0,2,0,0,2,0,0,0,0,0,1,0,1
2015,The former Yugoslav Republic of Macedonia,Ohrid,0,0,0,0,0,0,0,0,0,0,0,1,0,0,0,1
2015,The former Yugoslav Republic of Macedonia,Prilep : Op?ítina - Municipality,1,0,0,0,1,0,0,2,0,0,0,1,6,0,0,7
2015,The former Yugoslav Republic of Macedonia,Probistip : Op?ítina - Municipality,0,0,0,0,0,1,0,1,0,0,0,0,0,0,0,0
2015,The former Yugoslav Republic of Macedonia,Veles,0,1,0,2,1,0,0,4,0,1,0,0,1,0,0,2
2015,The former Yugoslav Republic of Macedonia,Vizbegovo : Point,0,0,0,0,1,0,0,1,0,1,0,3,13,0,0,17
2015,The former Yugoslav Republic of Macedonia,Bitola : Op?ítina - Municipality,2,1,0,3,2,1,0,9,2,4,0,1,3,1,0,11
2015,The former Yugoslav Republic of Macedonia,Gostivar : Op?ítina - Municipality,0,4,0,3,14,2,0,23,0,2,0,2,5,1,0,10
2015,The former Yugoslav Republic of Macedonia,Kumanovo : Op?ítina - Municipality,1,7,0,3,24,4,0,39,0,7,0,3,9,1,0,20
2015,The former Yugoslav Republic of Macedonia,Skopje : City,24,85,0,65,315,39,0,528,54,85,0,96,298,21,0,554
2015,The former Yugoslav Republic of Macedonia,Stip : Op?ítina - Municipality,2,2,0,2,3,2,0,11,1,6,0,4,3,0,0,14
2015,The former Yugoslav Republic of Macedonia,Tetovo : Op?ítina - Municipality,0,9,0,7,33,17,0,66,1,6,0,8,18,2,0,35
2015,The former Yugoslav Republic of Macedonia,Valandovo : Op?ítina - Municipality,0,1,0,0,2,1,0,4,0,0,0,2,2,1,0,5
2015,Mali,Bamako : District,140,212,0,166,618,35,0,1171,110,228,0,165,559,19,0,1081
2015,Mali,Faragouana : Point,1,3,0,2,7,0,0,13,0,3,0,3,14,0,0,20
2015,Mali,Gao : Region,46,140,0,81,265,21,0,553,34,164,0,98,223,22,0,541
2015,Mali,Kayes : Region,1121,1712,0,1136,2457,169,0,6595,1170,1838,0,1088,2528,266,0,6890
2015,Mali,Kidal,20,45,0,42,245,23,0,375,25,46,0,34,244,13,0,362
2015,Mali,Koulikoro,0,0,0,0,0,0,0,0,0,0,0,0,0,0,0,0
2015,Mali,Mopti : Region,16,43,0,19,76,5,0,159,13,45,0,28,69,5,0,160
2015,Mali,Segou,0,0,0,0,0,0,0,0,0,0,0,0,0,0,0,0
2015,Mali,Sikasso : Region,21,58,0,44,127,4,0,254,22,57,0,35,123,2,0,239
2015,Mali,Tombouctou,67,187,0,98,358,38,0,748,67,154,0,98,251,26,0,596
2015,Malta,Community,0,0,0,0,0,0,0,0,0,0,0,0,0,0,0,0
2015,Malta,Dar Il-Liedna : Point,0,0,0,0,0,0,0,0,0,0,0,0,0,0,0,0
2015,Malta,Hal Far Open Centre : Point,0,0,0,0,0,0,0,0,0,0,0,0,0,0,0,0
2015,Malta,Hal Far Tent Village : Point,0,0,0,0,0,0,0,0,0,0,0,0,0,0,0,0
2015,Malta,Marsa Open Centre,0,0,0,0,0,0,0,0,0,0,0,0,0,0,0,0
2015,Malta,MEC Balzan : Point,0,0,0,0,0,0,0,0,0,0,0,0,0,0,0,0
2015,Malta,MEC Houses : Point,0,0,0,0,0,0,0,0,0,0,0,0,0,0,0,0
2015,Malta,Peace Lab,0,0,0,0,0,0,0,0,0,0,0,0,0,0,0,0
2015,Myanmar,"Kayah, Kayin and Mon states and Tanintharyi region : Regional grouping",0,0,0,0,0,0,0,0,0,0,0,0,0,0,0,0
2015,Myanmar,Rakhine : State,11879,11088,0,6295,30114,2138,0,61514,11626,11811,0,8858,24139,2094,0,58528
2015,Myanmar,Yangon,0,0,0,0,0,0,0,0,0,0,0,0,1,0,0,1
2015,Myanmar,Kachin and northern Shan states : Regional grouping,8626,7617,0,9539,21061,3867,0,50710,8173,7423,0,9072,17719,2950,0,45337
2015,Montenegro,Bar,0,0,0,0,0,0,0,0,0,0,0,0,1,0,0,1
2015,Montenegro,Bar : Op?ítina - Municipality,4,12,0,4,20,18,0,58,6,16,0,8,37,11,0,78
2015,Montenegro,Berane : Op?ítina - Municipality,20,28,0,15,48,15,0,126,22,32,0,19,61,6,0,140
2015,Montenegro,Budva : Op?ítina - Municipality,0,5,0,4,7,4,0,20,1,2,0,1,8,5,0,17
2015,Montenegro,Cetinje : Op?ítina - Municipality,0,0,0,0,1,0,0,1,0,0,0,0,1,0,0,1
2015,Montenegro,Kolasin : Op?ítina - Municipality,0,0,0,0,2,2,0,4,0,0,0,2,5,1,0,8
2015,Montenegro,Kotor : Op?ítina - Municipality,0,0,0,0,2,4,0,6,0,1,0,0,5,2,0,8
2015,Montenegro,Niksic : Op?ítina - Municipality,4,1,0,4,18,4,0,31,0,2,0,7,22,2,0,33
2015,Montenegro,Plav : Op?ítina - Municipality,0,0,0,0,5,1,0,6,0,0,0,1,8,1,0,10
2015,Montenegro,Pluzine : Op?ítina - Municipality,0,0,0,0,1,0,0,1,0,0,0,0,2,0,0,2
2015,Montenegro,Rozaj : Op?ítina - Municipality,0,2,0,0,7,2,0,11,0,4,0,2,7,2,0,15
2015,Montenegro,Savnik : Op?ítina - Municipality,0,0,0,0,0,1,0,1,0,0,0,0,0,0,0,0
2015,Montenegro,Tivat : Op?ítina - Municipality,1,0,0,4,8,4,0,17,0,1,0,5,7,2,0,15
2015,Montenegro,Ulcinj : Op?ítina - Municipality,0,1,0,2,6,2,0,11,1,3,0,6,11,2,0,23
2015,Montenegro,Andrijevica : Op?ítina - Municipality,0,0,0,1,16,5,0,22,0,0,0,1,15,1,0,17
2015,Montenegro,Bijelo Polje : Op?ítina - Municipality,0,0,0,0,4,1,0,5,0,1,0,0,2,0,0,3
2015,Montenegro,Danilovgrad : Op?ítina - Municipality,0,0,0,1,2,7,0,10,0,2,0,2,8,5,0,17
2015,Montenegro,Herceg Novi : Op?ítina - Municipality,2,1,0,1,8,10,0,22,2,4,0,9,13,5,0,33
2015,Montenegro,Mojkovac : Op?ítina - Municipality,0,0,0,0,2,0,0,2,0,0,0,0,1,0,0,1
2015,Montenegro,Montenegro : Dispersed in the country / territory,38,221,0,299,3611,1349,0,5518,38,239,0,329,3652,1145,0,5403
2015,Montenegro,Pljevlja : Op?ítina - Municipality,2,2,0,0,7,0,0,11,2,1,0,3,3,1,0,10
2015,Montenegro,Podgorica : Op?ítina - Municipality,27,87,0,80,181,31,0,406,46,94,0,102,208,39,0,489
2015,Mongolia,Ulaanbaatar : Capital city,0,0,0,0,4,0,0,4,1,0,0,0,10,0,0,11
2015,Mozambique,Cabo Delgado : Provincia,1,5,0,1,11,0,0,18,0,3,0,2,30,1,0,36
2015,Mozambique,Gaza : Provincia,0,2,0,4,8,0,0,14,0,5,0,3,17,0,0,25
2015,Mozambique,Inhambane : Provincia,0,2,0,1,11,0,0,14,0,1,0,4,24,0,0,29
2015,Mozambique,Manica : Provincia,1,3,0,1,22,0,0,27,1,5,0,1,92,1,0,100
2015,Mozambique,Maputo Provincia : Provincia,0,36,0,37,95,4,0,172,0,32,0,29,149,4,0,214
2015,Mozambique,Maratane : Point,781,996,0,677,2623,90,0,5167,781,1118,0,704,5422,54,0,8079
2015,Mozambique,Nampula : Provincia,114,195,0,108,561,14,0,992,112,227,0,150,1821,20,0,2330
2015,Mozambique,Niassa : Provincia,1,17,0,16,36,0,0,70,2,15,0,16,61,1,0,95
2015,Mozambique,Sofala : Provincia,0,4,0,2,12,1,0,19,0,2,0,2,25,1,0,30
2015,Mozambique,Tete : Provincia,16,41,0,44,105,2,0,208,14,49,0,34,186,5,0,288
2015,Mozambique,Zambezia : Provincia,5,7,0,2,30,0,0,44,3,7,0,9,86,0,0,105
2015,Mozambique,Maputo : Cidade capital - Capital City,16,171,0,135,566,21,0,909,25,180,0,145,1076,35,0,1461
2015,Mauritania,Mauritania : Dispersed in the country / territory,0,0,0,0,0,0,0,0,0,0,0,0,0,0,0,0
2015,Mauritania,Mbera : Point,4077,7227,0,3034,12069,1458,0,27865,4138,6982,0,2987,7129,1127,0,22363
2015,Mauritania,Nouakchott and Nouadhibou : Regional grouping,95,154,0,98,373,18,0,738,96,112,0,88,614,15,0,925
2015,Malawi,Dzaleka : Point,1871,2550,0,1789,4606,165,0,10981,1857,2683,0,1904,5942,122,0,12508
2015,Malaysia,Sabah,0,0,0,0,0,0,0,0,0,0,0,0,0,0,0,0
2015,Malaysia,Kuala Lumpur : Wilayah Persekutuan - Federal territory,7943,4491,0,2772,31616,756,0,47578,8376,5050,0,4302,88269,1006,0,107003
2015,Namibia,Osire : Point,153,242,0,165,536,14,0,1110,164,223,0,240,856,20,0,1503
2015,Namibia,Namibia : Dispersed in the country / territory,14,22,0,10,58,0,0,104,14,19,0,10,133,2,0,178
2015,Niger,Ayourou : Point,51,83,0,44,195,19,0,392,48,85,0,42,102,19,0,296
2015,Niger,Camp Abala : Point,1026,2262,0,1114,2968,226,0,7596,1050,2181,0,1071,1815,195,0,6312
2015,Niger,Diffa,0,0,0,0,0,0,0,0,0,0,0,0,0,0,0,0
2015,Niger,Goure,5,13,0,9,37,6,0,70,5,19,0,11,42,5,0,82
2015,Niger,Intikane,1015,2852,0,1099,3313,179,0,8458,1128,2949,0,999,2315,229,0,7620
2015,Niger,Mangaize : Point,655,1203,0,535,1655,130,0,4178,633,1246,0,617,1099,134,0,3729
2015,Niger,Niamey : Capital district,296,684,0,479,1379,175,0,3013,258,655,0,394,626,92,0,2025
2015,Niger,Tabareybarey : Point,674,1488,0,780,2280,177,0,5399,668,1413,0,713,1032,145,0,3971
2015,Niger,Tazalit,331,522,0,192,630,47,0,1722,401,510,0,194,482,56,0,1643
2015,Nigeria,Abuja FCT,2,2,0,0,6,0,0,10,3,2,0,2,19,0,0,26
2015,Nigeria,Admawa,0,0,0,0,0,0,0,0,0,0,0,0,0,0,0,0
2015,Nigeria,Amana : Point,0,3,0,3,3,2,0,11,0,0,0,0,1,0,0,1
2015,Nigeria,Benue : State,5,20,0,12,38,4,0,79,1,10,0,10,33,3,0,57
2015,Nigeria,IDPs in the North,0,0,0,0,0,0,0,0,0,0,0,0,0,0,0,0
2015,Nigeria,Ijebuode : Local government area,3,8,0,6,20,0,0,37,1,16,0,6,61,0,0,84
2015,Nigeria,Lagos : State,62,103,0,75,317,2,0,559,84,102,0,66,622,11,0,885
2015,Nigeria,Nigeria : Dispersed in the country / territory,1,1,0,1,4,0,0,7,0,1,0,2,22,0,0,25
2015,Nicaragua,Managua : Departamento,0,0,0,0,4,0,0,4,0,1,0,0,12,0,0,13
2015,Nicaragua,Nicaragua : Dispersed in the country / territory,17,24,0,19,130,18,0,208,18,20,0,46,140,13,0,237
2015,Netherlands,Netherlands : Dispersed in the country / territory,0,0,0,0,0,0,0,0,0,0,0,0,0,0,0,0
2015,Norway,Norway : Dispersed in the country / territory,0,0,0,0,0,0,0,0,0,0,0,0,0,0,0,0
2015,Nepal,Beldangi : Point,641,937,0,788,3939,455,0,6760,678,1008,0,832,4061,631,0,7210
2015,Nepal,Kathmandu : District,34,42,0,23,140,4,0,243,24,56,0,26,195,6,0,307
2015,Nepal,Kathmandu: District,0,0,0,0,1,0,0,1,0,0,0,1,4,0,0,5
2015,Nepal,Sanischare : Point,183,233,0,177,934,105,0,1632,197,211,0,185,998,144,0,1735
2015,Nepal,Nepal : Dispersed in the country / territory,0,0,0,1,7649,4,0,7654,1,1,0,0,7517,2,0,7521
2015,Nauru,Nauru,0,0,0,0,0,0,0,0,0,0,0,0,0,0,0,0
2015,New Zealand,New Zealand : Dispersed in the country / territory,0,0,0,0,0,0,0,0,0,0,0,0,0,0,0,0
2015,Oman,Oman : Dispersed in the country / territory,19,47,0,30,123,11,0,230,26,24,0,23,127,5,0,205
2015,Pakistan,Akora Khattak,960,4974,0,3365,7851,220,0,17370,1023,5121,0,3632,8647,759,0,19182
2015,Pakistan,Badaber : Point,754,3127,0,2416,5290,240,0,11827,901,3321,0,2505,6151,512,0,13390
2015,Pakistan,Baghicha : Point,59,310,0,206,479,38,0,1092,55,343,0,210,517,55,0,1180
2015,Pakistan,Balochistan : Province,10088,29685,0,23666,53969,3677,0,121085,10928,31242,0,26655,60832,7824,0,137481
2015,Pakistan,Barakai : Point,162,2871,0,2614,5943,273,0,11863,188,3110,0,2731,5906,584,0,12519
2015,Pakistan,Barari : Point,823,1574,0,1245,2803,159,0,6604,847,1513,0,1296,3063,249,0,6968
2015,Pakistan,Barawal : Point,1,31,0,30,47,2,0,111,1,33,0,23,91,7,0,155
2015,Pakistan,Basu Mera : Point,379,503,0,490,1211,48,0,2631,376,558,0,554,1209,123,0,2820
2015,Pakistan,Bizen Khel : Point,1,159,0,148,324,15,0,647,4,182,0,186,368,33,0,773
2015,Pakistan,Chagai,5,17,0,16,29,4,0,71,8,30,0,8,39,5,0,90
2015,Pakistan,Chakdara : Point,979,1492,0,1080,2336,130,0,6017,1000,1601,0,1044,2768,215,0,6628
2015,Pakistan,Chichana : Point,55,369,0,321,769,48,0,1562,63,414,0,311,1036,109,0,1933
2015,Pakistan,Dabara : Point,11,98,0,57,124,8,0,298,5,103,0,67,206,19,0,400
2015,Pakistan,Darsamand : Point,59,461,0,334,880,91,0,1825,59,507,0,402,1025,129,0,2122
2015,Pakistan,Gahzgai Minara : Point,62,176,0,157,299,22,0,716,67,197,0,225,374,49,0,912
2015,Pakistan,Gamkol : Point,611,3755,0,2979,6717,327,0,14389,656,3805,0,3146,8062,645,0,16314
2015,Pakistan,Gandaf : Point,164,1641,0,1169,2623,170,0,5767,168,1669,0,1300,2953,224,0,6314
2015,Pakistan,Gandhi Khan Khel : Point,104,524,0,504,982,59,0,2173,116,597,0,531,1123,131,0,2498
2015,Pakistan,Ghulam Banda : Point,392,1169,0,899,2107,94,0,4661,480,1202,0,1003,2354,225,0,5264
2015,Pakistan,Ichrian : Point,355,585,0,419,1009,62,0,2430,332,537,0,411,1096,107,0,2483
2015,Pakistan,Jalala : Point,745,2046,0,1419,3685,219,0,8114,830,2211,0,1581,3992,361,0,8975
2015,Pakistan,Kababian : Point,559,1344,0,994,2416,77,0,5390,659,1473,0,1059,3427,192,0,6810
2015,Pakistan,Kahi,44,593,0,471,1123,108,0,2339,43,652,0,499,1313,173,0,2680
2015,Pakistan,Kalkatak : Point,97,193,0,153,367,15,0,825,106,222,0,199,446,29,0,1002
2015,Pakistan,Karachi : District,26,60,0,56,186,8,0,336,31,48,0,63,148,8,0,298
2015,Pakistan,Kata Kanri : Point,148,857,0,674,1464,156,0,3299,147,908,0,705,1808,205,0,3773
2015,Pakistan,Khairabad : Point,264,1845,0,1301,2609,171,0,6190,323,1892,0,1365,2748,295,0,6623
2015,Pakistan,Khaki : Point,863,1715,0,1324,3098,215,0,7215,959,1746,0,1386,3324,325,0,7740
2015,Pakistan,Khazana : Point,305,791,0,603,1305,74,0,3078,349,774,0,651,1562,129,0,3465
2015,Pakistan,Khurasan : Point,125,398,0,322,936,67,0,1848,112,423,0,330,1010,97,0,1972
2015,Pakistan,Khyber Pakhtunkhwa : Province,157741,239693,0,134379,499771,42328,0,1073912,195051,316581,0,175051,516462,47952,0,1251097
2015,Pakistan,Koga : Point,20,1187,0,829,1961,78,0,4075,22,1199,0,923,1908,144,0,4196
2015,Pakistan,Kot Chandna : Point,367,1729,0,1418,3128,123,0,6765,359,1778,0,1419,3239,267,0,7062
2015,Pakistan,Kotwai : Point,290,635,0,565,1035,81,0,2606,344,643,0,606,939,168,0,2700
2015,Pakistan,Lakhti Banda : Point,381,726,0,542,1275,146,0,3070,459,755,0,568,1388,211,0,3381
2015,Pakistan,Lejay Karez : Point,21,71,0,53,115,7,0,267,17,65,0,51,179,26,0,338
2015,Pakistan,Malgagai : Point,268,683,0,549,989,114,0,2603,266,715,0,601,1401,189,0,3172
2015,Pakistan,Mera Kachori : Point,110,679,0,473,1105,70,0,2437,130,634,0,508,1170,109,0,2551
2015,Pakistan,Mohammad Kheil : Point,411,635,0,515,1098,31,0,2690,454,613,0,634,1194,134,0,3029
2015,Pakistan,Munda : Point,364,1236,0,1000,2183,97,0,4880,360,1262,0,1022,2070,229,0,4943
2015,Pakistan,Naguman : Point,207,368,0,342,666,30,0,1613,238,414,0,350,791,70,0,1863
2015,Pakistan,New Durrani : Point,371,463,0,232,973,93,0,2132,463,648,0,324,973,92,0,2500
2015,Pakistan,New Hajizai,0,0,0,0,0,0,0,0,0,0,0,0,0,0,0,0
2015,Pakistan,Oblan : Point,420,1298,0,993,2167,136,0,5014,421,1358,0,1032,2357,223,0,5391
2015,Pakistan,Old Shamshatoo,1065,5785,0,4563,11718,408,0,23539,1269,6152,0,5010,12763,1073,0,26267
2015,Pakistan,Padhana : Point,707,1117,0,1047,2223,114,0,5208,728,1119,0,1146,2364,242,0,5599
2015,Pakistan,Panian : Point,4080,6246,0,6061,13561,668,0,30616,4174,6718,0,6214,13246,1296,0,31648
2015,Pakistan,Posti : Point,4,27,0,14,28,3,0,76,12,30,0,16,31,9,0,98
2015,Pakistan,Punjab : Province,6917,17633,0,13976,33193,1927,0,73646,7596,18804,0,15539,41127,3638,0,86704
2015,Pakistan,Quetta : District,189,541,0,454,1490,100,0,2774,173,587,0,499,676,26,0,1961
2015,Pakistan,Saranan : Point,368,1651,0,1804,2663,186,0,6672,410,1731,0,1982,4203,532,0,8858
2015,Pakistan,Sindh : Province,2991,6643,0,5497,13439,618,0,29188,3167,7097,0,5706,16039,1442,0,33451
2015,Pakistan,Surkhab : Point,107,638,0,565,1140,55,0,2505,146,628,0,648,1500,205,0,3127
2015,Pakistan,Thall : Point,321,1406,0,1157,2620,271,0,5775,336,1504,0,1284,2746,418,0,6288
2015,Pakistan,Timer : Point,553,1265,0,917,2021,91,0,4847,612,1335,0,969,2066,178,0,5160
2015,Pakistan,Togh Sarai : Point,179,223,0,112,469,45,0,1028,223,312,0,156,469,44,0,1204
2015,Pakistan,Toor : Point,21,347,0,273,577,44,0,1262,26,389,0,271,822,82,0,1590
2015,Pakistan,Turkmen,0,0,0,0,0,0,0,0,0,0,0,0,0,0,0,0
2015,Pakistan,Utmanzai : Point,224,437,0,408,833,45,0,1947,234,511,0,421,894,106,0,2166
2015,Pakistan,Zafarabad : Point,33,400,0,360,658,33,0,1484,42,380,0,428,982,104,0,1936
2015,Pakistan,Zangal Patai : Point,4,25,0,9,35,0,0,73,8,21,0,17,39,3,0,88
2015,Pakistan,Zar Karez : Point,203,497,0,418,813,60,0,1991,231,495,0,477,917,117,0,2237
2015,Pakistan,Azad Kashmir : Pakistan administered area,137,334,0,289,801,57,0,1618,156,386,0,346,1110,115,0,2113
2015,Pakistan,Islamabad : Federal capital territory,1739,3820,0,3142,7995,465,0,17161,1982,4117,0,3473,9182,867,0,19621
2015,Panama,Panama : Dispersed in the country / territory,287,764,0,2114,4473,884,0,8522,283,835,0,2665,6949,1004,0,11736
2015,Peru,Peru : Dispersed in the country / territory,0,0,0,0,0,0,0,0,0,0,0,0,0,0,0,0
2015,Philippines,Agusan del Norte,0,0,0,0,0,0,0,0,0,0,0,0,0,0,0,0
2015,Philippines,Agusan Del Sur,0,0,0,0,0,0,0,0,0,0,0,0,0,0,0,0
2015,Philippines,BASILAN,0,0,0,0,0,0,0,0,0,0,0,0,0,0,0,0
2015,Philippines,Benguet,0,0,0,0,0,0,0,0,0,0,0,0,3,0,0,3
2015,Philippines,BUKIDNON,0,0,0,0,0,0,0,0,0,0,0,0,0,0,0,0
2015,Philippines,CALABARZON (Region IV-A ) : Region,0,1,0,1,8,0,0,10,1,0,0,0,19,1,0,21
2015,Philippines,Central Luzon (Region III) : Region,0,0,0,0,1,0,0,1,0,0,0,0,16,0,0,16
2015,Philippines,Compostela Valley,0,0,0,0,0,0,0,0,0,0,0,0,0,0,0,0
2015,Philippines,COTABATO CITY,0,0,0,0,0,0,0,0,0,0,0,0,2,0,0,2
2015,Philippines,Davao (Region XI) : Region,0,1,0,1,1,0,0,3,0,0,0,0,3,0,0,3
2015,Philippines,Davao del Sur,122,224,0,152,638,59,0,1195,112,242,0,148,599,87,0,1188
2015,Philippines,Davao Oriental,0,0,0,0,1,0,0,1,1,0,0,1,0,0,0,2
2015,Philippines,LANAO DEL NORTE,0,0,0,0,0,0,0,0,0,0,0,0,0,0,0,0
2015,Philippines,LANAO DEL SUR,0,0,0,0,0,0,0,0,0,0,0,0,0,0,0,0
2015,Philippines,MAGUINDANAO,0,0,0,0,0,0,0,0,0,0,0,0,0,0,0,0
2015,Philippines,MIMAROPA (Region IV-B) : Region,0,0,0,0,0,0,0,0,0,0,0,0,1,0,0,1
2015,Philippines,MISAMIS ORIENTAL,0,0,0,0,0,0,0,0,0,0,0,0,0,0,0,0
2015,Philippines,National Capital Region,0,2,0,3,20,2,0,27,4,0,0,2,101,6,0,113
2015,Philippines,National Capital Region (NCR) : Region,0,0,0,0,0,0,0,0,0,0,0,0,1,0,0,1
2015,Philippines,NORTH COTABATO,0,0,0,0,0,0,0,0,0,0,0,0,0,0,0,0
2015,Philippines,Philippines : Dispersed in the country / territory,0,3,0,0,3,0,0,6,0,1,0,3,50,9,0,63
2015,Philippines,Region 1,0,0,0,0,1,0,0,1,0,0,0,0,3,1,0,4
2015,Philippines,Region 12,0,0,0,0,0,0,0,0,0,0,0,0,0,0,0,0
2015,Philippines,Region 5,0,0,0,0,0,0,0,0,0,0,0,0,1,0,0,1
2015,Philippines,Region 6,0,0,0,0,0,0,0,0,0,0,0,0,2,0,0,2
2015,Philippines,Region 7,0,0,0,0,2,0,0,2,0,0,0,0,10,0,0,10
2015,Philippines,Sarangani Province,215,293,0,191,812,81,0,1592,233,328,0,179,711,91,0,1542
2015,Philippines,South Cotabato,111,158,0,95,445,46,0,855,110,149,0,103,361,31,0,754
2015,Philippines,Sultan Kudarat,0,0,0,1,3,0,0,4,0,0,0,0,2,0,0,2
2015,Philippines,SULU,0,0,0,0,0,0,0,0,0,0,0,0,0,0,0,0
2015,Philippines,SURIGAO DEL NORTE,0,0,0,0,0,0,0,0,0,0,0,0,0,0,0,0
2015,Philippines,SURIGAO DEL SUR,0,0,0,0,0,0,0,0,0,0,0,0,0,0,0,0
2015,Philippines,Zamboanga Peninsula (Region IX) : Region,0,0,0,0,0,0,0,0,0,0,0,0,1,0,0,1
2015,Philippines,ZAMBOANGA SIBUGAY,0,0,0,0,0,0,0,0,0,0,0,0,0,0,0,0
2015,Palau,Koror : State,0,0,0,0,0,0,0,0,0,0,0,0,0,0,0,0
2015,Papua New Guinea,Papua New Guinea : Dispersed in the country / territory,0,0,0,0,0,0,0,0,0,0,0,0,0,0,0,0
2015,Poland,Bezwola,15,19,0,6,29,2,0,71,9,21,0,8,25,1,0,64
2015,Poland,Bezwola II,11,18,0,5,25,0,0,59,7,12,0,6,27,0,0,52
2015,Poland,Biala Podlaska : Powiat - County,15,23,0,7,41,0,0,86,19,23,0,10,44,0,0,96
2015,Poland,Bialystok : Powiat - County,16,25,0,12,38,2,0,93,25,33,0,10,35,1,0,104
2015,Poland,Czerwony Bor : Point,16,21,0,6,34,3,0,80,16,11,0,8,33,0,0,68
2015,Poland,Debak : Point,11,2,0,1,21,0,0,35,8,14,0,5,29,0,0,56
2015,Poland,Grotniki : Point,7,10,0,5,23,0,0,45,16,19,0,2,29,0,0,66
2015,Poland,Grupa : Point,21,27,0,7,42,0,0,97,17,28,0,11,45,0,0,101
2015,Poland,Horbow : Point,22,17,0,4,34,0,0,77,15,23,0,4,31,0,0,73
2015,Poland,Linin : Point,14,12,0,9,34,1,0,70,18,30,0,12,61,2,0,123
2015,Poland,Lukow : Powiat - County,20,30,0,16,55,2,0,123,20,41,0,16,49,1,0,127
2015,Poland,Poland,0,0,0,0,0,0,0,0,0,0,0,0,0,0,0,0
2015,Poland,Warsaw : Powiat - County,0,0,0,0,0,0,0,0,0,0,0,0,0,0,0,0
2015,Portugal,Portugal : Dispersed in the country / territory,0,0,0,0,0,0,0,0,0,0,0,0,0,0,0,0
2015,Paraguay,Paraguay : Dispersed in the country / territory,3,11,0,8,49,5,0,76,3,8,0,8,110,4,0,133
2015,Qatar,Qatar : Dispersed in the country / territory,13,13,0,16,71,7,0,120,10,16,0,9,70,13,0,118
2015,Romania,Romania : Dispersed in the country / territory,112,124,0,82,486,38,0,842,148,126,0,120,1478,124,0,1996
2015,Russian Federation,Russian Federation : Dispersed in the country / territory,0,0,0,0,0,0,0,0,0,0,0,0,0,0,0,0
2015,Rwanda,Bugesera : Akarere - District,69,41,0,48,78,49,0,285,75,45,0,60,110,45,0,335
2015,Rwanda,Gatsibo : Akarere - District,971,1574,0,1392,3515,258,0,7710,1021,1525,0,1301,2262,193,0,6302
2015,Rwanda,Gihembe,968,1195,0,1218,3856,518,0,7755,952,1256,0,1159,2862,264,0,6493
2015,Rwanda,Gisagara : Akarere - District,770,995,0,930,2063,175,0,4933,796,967,0,781,831,103,0,3478
2015,Rwanda,Huye : Akarere - District,197,306,0,189,853,22,0,1567,208,333,0,201,512,9,0,1263
2015,Rwanda,Kigali : Point,1450,2195,0,1592,7326,270,0,12833,1475,2138,0,1529,6205,153,0,11500
2015,Rwanda,Kirehe : Akarere - District,3558,4435,0,3050,10488,705,0,22236,3783,4454,0,3287,10802,363,0,22689
2015,Rwanda,Kiziba : Point,1226,1681,0,1435,4504,492,0,9338,1196,1551,0,1417,3361,407,0,7932
2015,Rwanda,Nyamagabe : Akarere - District,1559,2164,0,1928,4432,341,0,10424,1649,2099,0,1823,2555,275,0,8401
2015,Rwanda,Nyanza : Akarere - District,42,30,0,21,59,10,0,162,33,44,0,36,150,9,0,272
2015,Rwanda,Rubavu : Akarere - District,603,405,0,126,1256,75,0,2465,523,363,0,122,381,35,0,1424
2015,Rwanda,Nyagatare (Cyangugu) : Akarere - District,205,152,0,53,396,17,0,823,190,178,0,50,120,14,0,552
2015,Saudi Arabia,Saudi Arabia : Dispersed in the country / territory,6,9,0,11,44,2,0,72,4,9,0,15,56,1,0,85
2015,Sudan,Abu Rakham area : Point,2,22,0,28,113,19,0,184,0,24,0,30,105,29,0,188
2015,Sudan,Abuda : Point,75,296,0,230,894,98,0,1593,66,291,0,257,739,133,0,1486
2015,Sudan,Adingrar,0,0,0,0,0,1,0,1,0,0,0,0,1,0,0,1
2015,Sudan,Aroma : Point,0,5,0,0,3,0,0,8,0,0,0,3,4,0,0,7
2015,Sudan,Asotriba : Point,3,0,0,0,3,0,0,6,1,3,0,0,5,1,0,10
2015,Sudan,Awad El Seid : Point,0,36,0,38,163,28,0,265,0,47,0,39,133,42,0,261
2015,Sudan,Basonda : Point,0,0,0,0,1,0,0,1,0,2,0,0,0,0,0,2
2015,Sudan,Blue Nile : Wilayat - State,0,0,0,0,0,0,0,0,0,0,0,0,0,0,0,0
2015,Sudan,Central Darfur : Wilayat - State,846,1084,0,711,1974,284,0,4899,923,1000,0,664,1253,169,0,4009
2015,Sudan,Daim : Point,0,0,0,0,0,0,0,0,0,0,0,0,1,0,0,1
2015,Sudan,Dehama : Point,0,0,0,0,0,0,0,0,0,0,0,0,1,1,0,2
2015,Sudan,Diam El-Nour : Point,5,23,0,20,126,8,0,182,9,25,0,20,220,16,0,290
2015,Sudan,Doka : Point,0,0,0,1,3,1,0,5,0,0,0,2,1,1,0,4
2015,Sudan,Dordeab : Point,0,1,0,2,5,0,0,8,0,1,0,0,1,0,0,2
2015,Sudan,Eastern Darfur,0,0,0,0,0,0,0,0,0,0,0,0,0,0,0,0
2015,Sudan,Eastern Darfur : Wilayat - State,0,0,0,0,0,0,0,0,0,0,0,0,0,0,0,0
2015,Sudan,FATH EL RAHMAN : Point,0,17,0,16,103,17,0,153,0,19,0,18,72,26,0,135
2015,Sudan,Fau 5 : Point,2,69,0,63,247,34,0,415,5,82,0,66,234,58,0,445
2015,Sudan,Fau Town : Point,0,0,0,1,1,0,0,2,0,2,0,1,0,0,0,3
2015,Sudan,Gadaref : Wilayat - State,12,328,0,233,1112,157,0,1842,18,380,0,264,1211,342,0,2215
2015,Sudan,Geref : Point,0,4,0,0,6,0,0,10,2,2,0,0,10,0,0,14
2015,Sudan,Girba : Point,147,571,0,414,1879,242,0,3253,156,639,0,400,1416,323,0,2934
2015,Sudan,GIRBA TOWN,0,3,0,2,8,3,0,16,1,5,0,2,13,2,0,23
2015,Sudan,Gulsa : Point,0,3,0,8,22,1,0,34,0,3,0,2,11,3,0,19
2015,Sudan,Hawata : Point,0,3,0,0,3,0,0,6,0,1,0,1,0,0,0,2
2015,Sudan,Kalakla : Point,0,0,0,0,0,0,0,0,0,0,0,1,2,0,0,3
2015,Sudan,Karkora : Point,0,5,0,2,14,4,0,25,0,4,0,3,11,2,0,20
2015,Sudan,Kassala : Wilayat - State,100,344,0,258,1305,124,0,2131,78,342,0,291,1575,159,0,2445
2015,Sudan,Khartoum : Wilayat - State,773,1658,0,1533,8307,392,0,12663,892,1645,0,1825,9363,619,0,14344
2015,Sudan,Khartoum North : Point,1,11,0,3,32,1,0,48,4,8,0,7,46,6,0,71
2015,Sudan,Kilo 26 : Point,154,719,0,561,2397,339,0,4170,164,820,0,540,1991,426,0,3941
2015,Sudan,KILO 7,0,18,0,18,82,16,0,134,0,30,0,21,71,18,0,140
2015,Sudan,Laffa : Point,0,1,0,0,5,2,0,8,0,1,0,0,0,0,0,1
2015,Sudan,Mafaza : Point,0,0,0,0,1,0,0,1,0,0,0,0,0,0,0,0
2015,Sudan,Marghania : Point,0,13,0,5,38,3,0,59,1,5,0,11,83,3,0,103
2015,Sudan,New Halfa : Point,8,14,0,5,85,0,0,112,6,20,0,6,822,11,0,865
2015,Sudan,North Kordofan : Wilayat - State,0,0,0,0,0,0,0,0,0,0,0,0,0,0,0,0
2015,Sudan,Northern Darfur : Wilayat - State,0,0,0,0,0,0,0,0,0,0,0,0,0,0,0,0
2015,Sudan,Port Sudan : District,75,125,0,111,471,41,0,823,70,162,0,101,775,84,0,1192
2015,Sudan,Safawa : Point,0,0,0,0,3,1,0,4,0,0,0,0,0,0,0,0
2015,Sudan,Salalab : Point,18,46,0,28,143,3,0,238,31,37,0,32,178,16,0,294
2015,Sudan,Salmin : Point,0,1,0,0,1,0,0,2,0,0,0,1,1,0,0,2
2015,Sudan,Shagarab 1 : Point,652,1606,0,1216,4410,347,0,8231,660,1765,0,1358,5086,487,0,9356
2015,Sudan,Shagarab 2 : Point,353,1084,0,884,2847,255,0,5423,331,1130,0,941,1976,386,0,4764
2015,Sudan,Shagarab 3 : Point,180,589,0,486,1779,206,0,3240,169,590,0,456,1199,297,0,2711
2015,Sudan,Showak,0,2,0,3,12,3,0,20,0,5,0,4,16,3,0,28
2015,Sudan,Sinkat : District,0,0,0,0,0,0,0,0,0,0,0,0,3,0,0,3
2015,Sudan,South Kordofan : Wilayat - State,0,0,0,0,0,0,0,0,0,0,0,0,0,0,0,0
2015,Sudan,Southern Darfur : Wilayat - State,86,177,0,93,252,27,0,635,88,169,0,97,250,16,0,620
2015,Sudan,Suwakin : Point,0,9,0,3,9,1,0,22,2,6,0,0,43,3,0,54
2015,Sudan,Tokar : District,1,0,0,0,1,0,0,2,0,0,0,0,1,0,0,1
2015,Sudan,Um Ali : Point,0,10,0,13,14,2,0,39,3,7,0,5,11,2,0,28
2015,Sudan,Um Gargur : Point,271,882,0,624,2717,344,0,4838,303,905,0,710,2565,486,0,4969
2015,Sudan,Um Gulja : Point,0,9,0,3,28,4,0,44,0,9,0,5,36,9,0,59
2015,Sudan,Um Rakuba : Point,0,0,0,4,2,0,0,6,0,1,0,1,7,3,0,12
2015,Sudan,Um Sagata,0,0,0,2,2,0,0,4,0,0,0,1,1,1,0,3
2015,Sudan,Wad El Hileau : Point,3,33,0,28,89,11,0,164,1,20,0,27,78,10,0,136
2015,Sudan,Wad Medani : Point,0,2,0,3,5,0,0,10,0,6,0,3,2,1,0,12
2015,Sudan,Wad Sherife : Point,613,1316,0,991,5250,815,0,8985,661,1398,0,1024,3359,739,0,7181
2015,Sudan,Wad Sherife village,8,45,0,68,288,36,0,445,10,69,0,62,152,18,0,311
2015,Sudan,West Kordofan : Wilayat - State,0,0,0,0,0,0,0,0,0,0,0,0,0,0,0,0
2015,Sudan,Western Darfur : Wilayat - State,0,2,0,0,6,0,0,8,1,3,0,0,28,0,0,32
2015,Sudan,White Nile : Wilayat - State,0,0,0,0,0,0,0,0,0,0,0,0,0,0,0,0
2015,Sudan,White Nile :Wilayat - State,10596,13246,0,11481,16533,1729,0,53585,10372,12984,0,9191,10249,1124,0,43920
2015,Senegal,Dakar : Point,146,188,0,168,1148,26,0,1676,151,228,0,198,2354,41,0,2972
2015,Senegal,Dakar/Thies : Point,6,17,0,16,29,1,0,69,10,25,0,20,58,3,0,116
2015,Senegal,Richard Toll : Point,1346,1626,0,755,2743,270,0,6740,1376,1525,0,724,2056,227,0,5908
2015,Senegal,Saint Louis,1,2,0,0,9,0,0,12,3,1,0,0,13,1,0,18
2015,Singapore,Singapore : Dispersed in the country / territory,0,0,0,0,1,0,0,1,0,0,0,0,0,0,0,0
2015,Solomon Islands,Honiara : Capital territory,0,0,0,0,1,0,0,1,0,0,0,0,2,0,0,2
2015,Sierra Leone,Bandajuma : Point,0,1,0,4,6,0,0,11,1,1,0,3,4,3,0,12
2015,Sierra Leone,Bo : District,1,3,0,5,16,3,0,28,2,5,0,4,5,2,0,18
2015,Sierra Leone,Freetown,0,0,0,0,1,0,0,1,0,0,0,0,0,0,0,0
2015,Sierra Leone,Freetown : Point,11,4,0,10,48,3,0,76,11,13,0,9,53,1,0,87
2015,Sierra Leone,Gerihun : Point,4,6,0,6,9,1,0,26,3,2,0,1,10,0,0,16
2015,Sierra Leone,Gondama : Point,10,19,0,24,48,2,0,103,2,12,0,21,33,2,0,70
2015,Sierra Leone,Jembe : Point,1,4,0,6,9,1,0,21,3,3,0,11,10,0,0,27
2015,Sierra Leone,Jimmi Bago,10,13,0,9,30,2,0,64,11,14,0,10,31,3,0,69
2015,Sierra Leone,Kenema : District,1,1,0,2,15,2,0,21,3,2,0,4,24,3,0,36
2015,Sierra Leone,Largo : Point,1,4,0,3,2,1,0,11,0,2,0,2,4,1,0,9
2015,Sierra Leone,Taiama : Point,5,3,0,5,13,2,0,28,2,3,0,4,8,1,0,18
2015,Sierra Leone,Tobanda : Point,1,3,0,2,7,1,0,14,2,3,0,1,4,1,0,11
2015,El Salvador,El Salvador : Dispersed in the country / territory,0,0,0,350,2000,150,0,2500,0,0,0,400,7000,200,0,7600
2015,El Salvador,San Salvador : Departamento - Department,1,1,0,0,10,0,0,12,0,1,0,0,35,0,0,36
2015,Somalia,Awdal : Gobolka - Region,922,860,0,553,1598,123,0,4056,860,922,0,553,1475,124,0,3934
2015,Somalia,Bakool : Gobolka - Region,2769,2583,0,1662,4800,370,0,12184,2584,2770,0,1662,4430,370,0,11816
2015,Somalia,Banaadir : Gobolka - Region,38899,36316,0,23354,67464,5193,0,171226,36297,38911,0,23363,62281,5200,0,166052
2015,Somalia,Bari : Gobolka - Region,5655,5275,0,3394,9801,755,0,24880,5277,5656,0,3394,9047,756,0,24130
2015,Somalia,Bay : Gobolka - Region,4595,4286,0,2758,7964,613,0,20216,4287,4595,0,2758,7350,614,0,19604
2015,Somalia,Bossaso : District,297,597,0,338,1137,69,0,2438,296,621,0,334,1340,91,0,2682
2015,Somalia,Galgaduud : Gobolka - Region,13820,12890,0,8294,23952,1846,0,60802,12895,13823,0,8294,22108,1846,0,58966
2015,Somalia,Gedo : Gobolka - Region,8854,8258,0,5313,15345,1183,0,38953,8261,8855,0,5313,14163,1183,0,37775
2015,Somalia,Hargeisa : District,779,1364,0,726,3092,111,0,6072,712,1415,0,744,3091,132,0,6094
2015,Somalia,Hiraan : Gobolka - Region,5908,5510,0,3546,10239,789,0,25992,5512,5909,0,3545,9450,789,0,25205
2015,Somalia,Juba Dhexe : Gobolka - Region,3115,2906,0,1870,5400,416,0,13707,2907,3116,0,1870,4984,416,0,13293
2015,Somalia,Juba Hoose : Gobolka - Region,3531,3293,0,2119,6120,472,0,15535,3295,3532,0,2119,5648,471,0,15065
2015,Somalia,Mudug : Gobolka - Region,8202,7693,0,4924,14237,1092,0,36148,7671,8245,0,4927,13129,1099,0,35071
2015,Somalia,Nugaal : Gobolka - Region,1096,1022,0,658,1899,145,0,4820,1022,1096,0,658,1753,146,0,4675
2015,Somalia,Puntland,2,0,0,0,1,0,0,3,0,0,0,0,0,0,0,0
2015,Somalia,Sanaag : Gobolka - Region,105,98,0,63,182,14,0,462,98,105,0,63,168,14,0,448
2015,Somalia,Shabelle Dhexe : Gobolka - Region,5996,5592,0,3598,10391,801,0,26378,5594,5997,0,3598,9591,802,0,25582
2015,Somalia,Shabelle Hoose : Gobolka - Region,18666,17411,0,11203,32352,2493,0,82125,17417,18670,0,11203,29861,2494,0,79645
2015,Somalia,Somaliland,0,0,0,1,1,0,0,2,0,0,0,0,2,0,0,2
2015,Somalia,Sool : Gobolka - Region,556,519,0,334,964,74,0,2447,519,556,0,334,890,74,0,2373
2015,Somalia,South Central,614,854,0,412,958,53,0,2891,645,920,0,472,691,53,0,2781
2015,Somalia,Togdheer : Gobolka - Region,2972,2773,0,1784,5152,397,0,13078,2773,2973,0,1784,4755,397,0,12682
2015,Somalia,Woqooyi Galbeed : Gobolka - Region,5145,4799,0,3088,8918,687,0,22637,4801,5146,0,3088,8231,687,0,21953
2015,Serbia and Kosovo (S/RES/1244 (1999)),Belgrade : Capital city,17,2006,0,2980,16793,6490,0,28286,11,2120,0,3155,16985,4958,0,27229
2015,Serbia and Kosovo (S/RES/1244 (1999)),Belgrade area,13,846,0,1463,9130,4457,0,15909,6,890,0,1639,9794,2833,0,15162
2015,Serbia and Kosovo (S/RES/1244 (1999)),Central and Southern Serbia : Regional grouping,5,4577,0,6679,37927,13716,0,62904,11,4901,0,6994,38506,11045,0,61457
2015,Serbia and Kosovo (S/RES/1244 (1999)),Kosovo (S/RES/1244 (1999)) : Dispersed in the country / territory,1046,1138,0,1191,3537,1316,0,8228,1112,1147,0,1209,4690,1281,0,9439
2015,Serbia and Kosovo (S/RES/1244 (1999)),Serbia : Dispersed in the country / territory,225,255,0,240,500,130,0,1350,225,255,0,240,500,130,0,1350
2015,Serbia and Kosovo (S/RES/1244 (1999)),Vojvodina : Autonomous province,0,508,0,1060,7858,4964,0,14390,0,569,0,1146,8625,2875,0,13215
2015,South Sudan,Abyei Region,0,0,0,0,0,0,0,0,0,0,0,0,0,0,0,0
2015,South Sudan,Ajuong Thok,2866,2964,0,1722,5438,233,0,13223,2981,3304,0,3170,8296,205,0,17956
2015,South Sudan,Andari : Point,40,28,0,14,85,7,0,174,34,34,0,11,53,10,0,142
2015,South Sudan,Central Equatoria : Wilayat - State,0,0,0,0,0,0,0,0,0,0,0,0,0,0,0,0
2015,South Sudan,Doro : Point,5839,6265,0,3143,9570,576,0,25393,6313,6484,0,3440,6932,480,0,23649
2015,South Sudan,Eastern Equatoria : Wilayat - State,0,0,0,0,0,0,0,0,0,0,0,0,0,0,0,0
2015,South Sudan,Ezo : County,259,344,0,166,933,83,0,1785,281,371,0,177,573,79,0,1481
2015,South Sudan,Gendrassa,1732,2237,0,971,3453,244,0,8637,1892,2172,0,959,2607,315,0,7945
2015,South Sudan,Gorom : Point,142,219,0,108,409,15,0,893,175,230,0,121,435,7,0,968
2015,South Sudan,Jonglei : Wilayat - State,0,0,0,0,0,0,0,0,0,0,0,0,0,0,0,0
2015,South Sudan,Juba : County,212,399,0,182,994,12,0,1799,279,361,0,156,4618,92,0,5506
2015,South Sudan,Kaya,2498,3063,0,1528,4848,383,0,12320,2637,2973,0,1412,3511,509,0,11042
2015,South Sudan,Kodok,112,207,0,68,236,20,0,643,110,192,0,52,177,25,0,556
2015,South Sudan,Lakes : Wilayat - State,0,0,0,0,0,0,0,0,0,0,0,0,0,0,0,0
2015,South Sudan,Lasu : Point,851,1259,0,816,2164,218,0,5308,878,1185,0,826,1811,119,0,4819
2015,South Sudan,Makpandu : Point,352,421,0,183,783,56,0,1795,317,383,0,221,739,55,0,1715
2015,South Sudan,Maridi : County,12,42,0,19,54,0,0,127,15,36,0,20,77,1,0,149
2015,South Sudan,Morobo : County,12,35,0,23,56,5,0,131,12,39,0,22,26,3,0,102
2015,South Sudan,Naandi : Point,26,34,0,13,51,6,0,130,25,31,0,18,47,6,0,127
2015,South Sudan,Northern Bahr El Ghazal : Wilayat - State,0,0,0,0,0,0,0,0,0,0,0,0,0,0,0,0
2015,South Sudan,Pochalla : County,191,347,0,230,563,28,0,1359,204,408,0,181,175,12,0,980
2015,South Sudan,Source Yubu : Point,79,133,0,52,265,13,0,542,97,140,0,60,134,10,0,441
2015,South Sudan,Tambura : County,95,133,0,31,200,5,0,464,105,110,0,44,104,1,0,364
2015,South Sudan,Unity : Wilayat - State,0,0,0,0,0,0,0,0,0,0,0,0,0,0,0,0
2015,South Sudan,Upper Nile : Wilayat - State,0,0,0,0,0,0,0,0,0,0,0,0,0,0,0,0
2015,South Sudan,Warab : Wilayat - State,0,0,0,0,0,0,0,0,0,0,0,0,0,0,0,0
2015,South Sudan,Western Bahr El Ghazal : Wilayat - State,0,0,0,0,0,0,0,0,0,0,0,0,0,0,0,0
2015,South Sudan,Western Equatoria : Wilayat - State,0,0,0,0,0,0,0,0,0,0,0,0,0,0,0,0
2015,South Sudan,Yei : County,51,100,0,71,219,7,0,448,60,129,0,80,763,5,0,1037
2015,South Sudan,Yida : Point,7878,10481,0,5638,14237,691,0,38925,8175,10447,0,4976,7306,502,0,31406
2015,South Sudan,Yusuf Batil,4190,5305,0,2532,8021,713,0,20761,4407,5331,0,2449,5542,884,0,18613
2015,Suriname,Suriname,0,0,0,0,0,0,0,0,0,0,0,0,5,0,0,5
2015,Slovakia,Slovakia : Dispersed in country / territory,0,25,0,35,813,0,0,873,0,63,0,50,1615,0,0,1728
2015,Slovenia,Ljubljana : Obcine - Municipality,0,0,0,5,64,0,0,69,0,0,0,22,211,0,0,233
2015,Slovenia,Slovenia : Dispersed in the country / territory,0,9,0,8,14,0,0,31,1,2,0,9,54,0,0,66
2015,Sweden,Sweden : Dispersed in the country / territory,0,0,0,0,0,0,0,0,0,0,0,0,0,0,0,0
2015,Swaziland,Malindza : Point,20,25,0,16,44,1,0,106,13,21,0,23,71,2,0,130
2015,Swaziland,Swaziland : Dispersed in the country / territory,29,45,0,24,183,3,0,284,27,53,0,40,328,6,0,454
2015,Sint Maarten (Dutch part),Sint Maarten (Dutch part) : Dispersed in the country / territory,0,0,0,0,3,0,0,3,0,0,0,1,7,0,0,8
2015,Syrian Arab Rep.,Al Qunaytirah : Mohafazah - Governorate,0,0,0,0,1,0,0,1,0,0,0,0,0,0,0,0
2015,Syrian Arab Rep.,As-Suweida : Mohafazah - Governorate,3,3,0,5,11,0,0,22,2,5,0,4,7,2,0,20
2015,Syrian Arab Rep.,Idleb : Mohafazah - Governorate,0,5,0,5,17,0,0,27,4,4,0,2,21,0,0,31
2015,Syrian Arab Rep.,Raqqa : Mohafazah - Governorate,4,16,0,14,7,1,0,42,3,10,0,5,9,0,0,27
2015,Syrian Arab Rep.,Rural Damascus : Mohafazah - Governorate,0,0,0,0,0,0,0,0,0,0,0,0,0,0,0,0
2015,Syrian Arab Rep.,Aleppo : Mohafazah - Governorate,28,46,0,66,180,9,0,329,39,70,0,83,172,24,0,388
2015,Syrian Arab Rep.,Damascus : Mohafazah - Governorate,611,1322,0,1133,4535,557,0,8158,671,1337,0,1109,4268,822,0,8207
2015,Syrian Arab Rep.,Dara : Mohafazah - Governorate,9,26,0,14,46,3,0,98,8,32,0,15,26,8,0,89
2015,Syrian Arab Rep.,Dayr Az-Zor : Mohafazah - Governorate,31,77,0,88,42,1,0,239,30,65,0,36,36,2,0,169
2015,Syrian Arab Rep.,Hama : Mohafazah - Governorate,4,7,0,8,24,5,0,48,5,8,0,4,23,5,0,45
2015,Syrian Arab Rep.,Hassakeh : Mohafazah - Governorate,964,1551,0,1492,1570,176,0,5753,930,1580,0,984,1184,113,0,4791
2015,Syrian Arab Rep.,Homs : Mohafazah - Governorate,22,41,0,38,125,6,0,232,28,26,0,42,115,29,0,240
2015,Syrian Arab Rep.,Lattakia : Mohafazah - Governorate,10,22,0,31,117,18,0,198,21,29,0,37,122,14,0,223
2015,Syrian Arab Rep.,Tartous : Mohafazah - Governorate,24,43,0,31,165,15,0,278,21,27,0,48,143,24,0,263
2015,Turks and Caicos Islands,Turks and Caicos Islands : Dispersed in the country / territory,0,0,0,0,1,0,0,1,0,0,0,0,3,0,0,3
2015,Chad,Abgadam : Point,226,508,0,235,658,58,0,1685,220,479,0,178,242,32,0,1151
2015,Chad,Am Nabak : Point,1287,2521,0,2426,6007,579,0,12820,1215,2487,0,1977,1994,359,0,8032
2015,Chad,Amboko : Point,349,1007,0,787,1996,163,0,4302,323,945,0,812,1670,130,0,3880
2015,Chad,Bekourou : Point,229,288,0,107,416,15,0,1055,171,322,0,122,279,15,0,909
2015,Chad,Belome : Point,1128,2485,0,1557,4436,452,0,10058,1178,2396,0,1669,3179,274,0,8696
2015,Chad,Bongor : Point,43,81,0,36,119,5,0,284,43,80,0,35,106,11,0,275
2015,Chad,Bredjing : Point,2644,5139,0,3192,10062,1207,0,22244,2650,5277,0,3162,6676,850,0,18615
2015,Chad,Daha 1,14,35,0,19,60,5,0,133,20,23,0,6,19,3,0,71
2015,Chad,Daha 2,29,47,0,19,67,3,0,165,27,41,0,21,21,2,0,112
2015,Chad,Dar Es Salam : Point,366,600,0,262,870,54,0,2152,365,598,0,273,932,102,0,2270
2015,Chad,Dembo : Point,245,378,0,116,554,45,0,1338,268,378,0,132,351,26,0,1155
2015,Chad,Djabal : Point,1526,2531,0,1631,4855,503,0,11046,1539,2610,0,1613,2977,378,0,9117
2015,Chad,Doholo : Point,147,242,0,143,411,34,0,977,143,322,0,132,372,25,0,994
2015,Chad,Dosseye : Point,671,1823,0,1027,2697,212,0,6430,700,1756,0,1079,1890,225,0,5650
2015,Chad,Farchana : Point,1796,3302,0,2381,6653,755,0,14887,1867,3308,0,2332,3945,462,0,11914
2015,Chad,Gaga : Point,1613,3013,0,2144,5386,411,0,12567,1543,2971,0,2079,3207,319,0,10119
2015,Chad,Gondje : Point,249,935,0,885,1918,125,0,4112,299,965,0,853,1335,66,0,3518
2015,Chad,Gore and Maro,0,0,0,0,0,0,0,0,0,0,0,0,0,0,0,0
2015,Chad,Goz Amer : Point,2345,4120,0,2387,7036,964,0,16852,2396,4138,0,2383,4342,740,0,13999
2015,Chad,Guelendeng : Point,28,53,0,23,77,3,0,184,26,53,0,22,71,8,0,180
2015,Chad,Iridimi : Point,1177,2388,0,1801,4688,467,0,10521,1207,2306,0,1592,2195,253,0,7553
2015,Chad,Kerfi,120,197,0,79,263,28,0,687,137,195,0,75,199,23,0,629
2015,Chad,Kounoungou : Point,1104,2306,0,1991,4684,373,0,10458,1101,2098,0,1726,1744,248,0,6917
2015,Chad,Lac Region,0,0,0,0,0,0,0,0,0,0,0,0,0,0,0,0
2015,Chad,Mile : Point,1227,2485,0,1862,4841,456,0,10871,1326,2389,0,1527,1958,260,0,7460
2015,Chad,Moissala : Point,89,149,0,48,187,7,0,480,94,149,0,50,122,8,0,423
2015,Chad,Moulkou : Point,11,20,0,8,29,1,0,69,11,19,0,8,27,3,0,68
2015,Chad,Moyo : Point,603,1105,0,632,1660,195,0,4195,571,1084,0,542,727,97,0,3021
2015,Chad,N'Djamena : Region,139,344,0,253,832,58,0,1626,134,355,0,266,1257,81,0,2093
2015,Chad,Ngouboua : Point,76,228,0,100,333,17,0,754,80,214,0,93,185,26,0,598
2015,Chad,Oure Cassoni : Point,1653,3549,0,2891,7648,702,0,16443,1642,3462,0,2213,2531,218,0,10066
2015,Chad,Pont Carol : Point,21,40,0,17,57,2,0,137,20,39,0,17,55,6,0,137
2015,Chad,Tchoukoutalia : Point,29,52,0,33,73,1,0,188,22,51,0,11,35,3,0,122
2015,Chad,Touloum : Point,1521,2921,0,2209,5713,637,0,13001,1566,2916,0,1854,2530,331,0,9197
2015,Chad,Treguine : Point,1590,2831,0,1601,5115,606,0,11743,1525,2878,0,1669,3362,450,0,9884
2015,Chad,Refugees located along the border : point,624,1191,0,845,2318,244,0,5222,627,1181,0,768,1196,155,0,3927
2015,Togo,Avepozo,111,112,0,53,205,6,0,487,80,117,0,62,466,6,0,731
2015,Togo,Dankpen : Prefecture,169,252,0,120,347,63,0,951,178,273,0,139,226,39,0,855
2015,Togo,Lome : Commune,133,148,0,140,979,20,0,1420,143,172,0,119,1136,33,0,1603
2015,Togo,Site Tandjouare: Prefecture,70,83,0,27,159,20,0,359,67,89,0,32,38,5,0,231
2015,Togo,Sotouboua : Prefecture,679,899,0,265,1371,146,0,3360,667,1000,0,447,930,141,0,3185
2015,Togo,Tandjoare : Prefecture,1260,1433,0,626,2409,306,0,6034,1215,1517,0,485,224,48,0,3489
2015,Thailand,Ban Don Yang : Point,194,284,0,204,792,64,0,1538,197,304,0,220,727,68,0,1516
2015,Thailand,Ban Mae Surin : Point,177,245,0,189,607,57,0,1275,162,243,0,210,574,58,0,1247
2015,Thailand,Mae La : Point,2437,3424,0,2922,9836,985,0,19604,2585,3565,0,3117,8853,878,0,18998
2015,Thailand,Mae La Oon : Point,790,920,0,794,2388,249,0,5141,833,935,0,805,2301,268,0,5142
2015,Thailand,Mae Ra Ma Luang : Point,838,1039,0,974,2794,278,0,5923,818,1169,0,961,2513,303,0,5764
2015,Thailand,Mae Sot,0,10,0,14,75,2,0,101,1,7,0,9,128,3,0,148
2015,Thailand,Mai Nai Soi : Point,608,976,0,723,2555,295,0,5157,604,1009,0,711,2719,267,0,5310
2015,Thailand,Nu Po : Point,720,1037,0,835,3025,278,0,5895,740,1053,0,792,2884,238,0,5707
2015,Thailand,Thailand : Dispersed in the country / territory,11,21,0,33,73,0,0,138,11,26,0,77,186,0,0,300
2015,Thailand,Tham Hin : Point,466,644,0,416,1705,153,0,3384,494,656,0,396,1483,139,0,3168
2015,Thailand,Umpium : Point,786,1022,0,859,3271,313,0,6251,839,1080,0,854,3206,257,0,6236
2015,Thailand,Bangkok : Metropolitan administration,468,628,0,434,2303,126,0,3959,496,680,0,474,3284,134,0,5068
2015,Tajikistan,Dushanbe : Capital city,0,0,0,0,0,2,0,2,0,0,0,0,0,0,0,0
2015,Tajikistan,Dushanbe; Capital city,2,0,0,0,3,0,0,5,1,1,0,0,10,0,0,12
2015,Tajikistan,Khatlon : Province,0,0,0,0,0,0,0,0,0,0,0,0,0,0,0,0
2015,Tajikistan,Khujand : City of provincial subordination,0,0,0,0,0,0,0,0,0,0,0,0,0,0,0,0
2015,Tajikistan,Tajikistan : Dispersed in the country / territory,0,0,0,0,0,0,0,0,0,0,0,0,0,0,0,0
2015,Turkmenistan,Ashgabat : Capital city,0,0,0,0,0,2,0,2,0,0,0,0,4,0,0,4
2015,Turkmenistan,Mary : Region,0,0,0,0,0,0,0,0,0,0,0,0,1,0,0,1
2015,Turkmenistan,Turkmenabat : District,0,0,0,0,8,0,0,8,0,0,0,0,8,0,0,8
2015,Turkmenistan,Turkmenbashi : District,0,0,0,0,1,2,0,3,0,0,0,0,0,0,0,0
2015,Turkmenistan,Turkmenistan : Dispersed in the country / territory,0,40,0,39,3565,274,0,3918,0,65,0,64,2790,288,0,3207
2015,Timor-Leste,Dili : District,0,0,0,0,1,0,0,1,1,1,0,0,3,0,0,5
2015,Trinidad and Tobago,Port of Spain : Municipality,2,4,0,5,41,1,0,53,7,2,0,5,134,0,0,148
2015,Tunisia,Bizerte : Wilayah - Governorate,0,1,0,1,4,0,0,6,0,2,0,2,8,0,0,12
2015,Tunisia,Gabes : Wilayah - Governorate,0,0,0,0,0,0,0,0,0,0,0,0,2,0,0,2
2015,Tunisia,Gafsa : Wilayah - Governorate,3,7,0,2,10,2,0,24,3,7,0,5,10,1,0,26
2015,Tunisia,Jendouba,0,1,0,0,0,0,0,1,0,1,0,0,1,0,0,2
2015,Tunisia,Kairouan,0,2,0,1,2,0,0,5,0,1,0,0,1,0,0,2
2015,Tunisia,Kasserine,1,5,0,1,7,2,0,16,2,4,0,0,8,0,0,14
2015,Tunisia,Kebili Governorate,0,0,0,0,1,0,0,1,0,0,0,0,1,0,0,1
2015,Tunisia,Medenine : Wilayah - Governorate,4,3,0,1,16,0,0,24,9,5,0,5,61,2,0,82
2015,Tunisia,Monastir : Mutamadiyah - Delegation,1,0,0,0,2,0,0,3,0,0,0,0,4,0,0,4
2015,Tunisia,Nabeul,1,0,0,0,2,1,0,4,0,0,0,0,6,0,0,6
2015,Tunisia,Sfax : Wilayah - Governorate,5,4,0,4,11,1,0,25,3,4,0,2,14,0,0,23
2015,Tunisia,Sidi Bouzid Governorate,1,0,0,0,3,0,0,4,0,1,0,1,3,0,0,5
2015,Tunisia,Sousse : Wilayah - Governorate,7,6,0,5,21,2,0,41,4,9,0,2,30,1,0,46
2015,Tunisia,Tunis : Wilayah - Governorate,12,16,0,26,73,7,0,134,10,27,0,15,185,5,0,242
2015,Turkey,Adana : Province,63,126,0,81,463,25,0,758,69,145,0,120,668,21,0,1023
2015,Turkey,Adiyaman : Province,3,3,0,3,29,0,0,38,10,15,0,3,51,2,0,81
2015,Turkey,Afyonkarahisar : Province,328,503,0,337,1615,118,0,2901,339,488,0,421,2385,105,0,3738
2015,Turkey,Agri : Province,19,33,0,41,111,3,0,207,15,47,0,134,298,5,0,499
2015,Turkey,Aksaray : Province,170,327,0,211,821,71,0,1600,183,336,0,215,1123,65,0,1922
2015,Turkey,Amasya : Province,150,298,0,193,821,55,0,1517,174,292,0,230,1220,74,0,1990
2015,Turkey,Ankara : Province,82,118,0,91,459,34,0,784,71,156,0,114,721,34,0,1096
2015,Turkey,Antalya : Province,0,0,0,0,1,0,0,1,0,0,0,1,3,0,0,4
2015,Turkey,Ardahan : Province,3,7,0,9,24,1,0,44,4,10,0,7,69,0,0,90
2015,Turkey,Artvin : Province,6,7,0,3,30,0,0,46,9,14,0,9,107,2,0,141
2015,Turkey,Aydin : Province,0,0,0,0,0,0,0,0,0,0,0,0,5,1,0,6
2015,Turkey,Balikesir : Province,160,315,0,186,1087,39,0,1787,188,379,0,270,2270,48,0,3155
2015,Turkey,Bartin : Province,0,0,0,0,0,0,0,0,0,0,0,0,0,0,0,0
2015,Turkey,Batman : Province,100,179,0,120,416,22,0,837,96,201,0,147,486,19,0,949
2015,Turkey,Bayburt : Province,25,32,0,18,90,4,0,169,17,36,0,21,239,3,0,316
2015,Turkey,Bilecik : Province,305,429,0,274,1509,87,0,2604,342,505,0,343,3843,78,0,5111
2015,Turkey,Bingol : Province,0,0,0,0,0,0,0,0,0,0,0,0,0,0,0,0
2015,Turkey,Bitlis : Province,0,1,0,1,1,0,0,3,1,1,0,0,2,0,0,4
2015,Turkey,Bolu : Province,209,319,0,177,1016,51,0,1772,222,342,0,236,1867,49,0,2716
2015,Turkey,Burdur : Province,77,169,0,126,946,15,0,1333,117,161,0,202,1777,26,0,2283
2015,Turkey,Bursa : Province,0,1,0,1,6,1,0,9,1,1,0,0,12,1,0,15
2015,Turkey,Canakkale : Province,76,149,0,89,716,13,0,1043,91,169,0,136,2266,14,0,2676
2015,Turkey,Cankiri : Province,305,518,0,294,1583,105,0,2805,356,600,0,420,2817,84,0,4277
2015,Turkey,Corum : Province,397,520,0,290,1172,76,0,2455,383,574,0,367,1426,67,0,2817
2015,Turkey,Denizli : Province,178,321,0,225,1715,47,0,2486,176,373,0,298,3162,53,0,4062
2015,Turkey,Diyarbakir : Province,215,381,0,361,914,76,0,1947,278,464,0,376,877,51,0,2046
2015,Turkey,Duzce : Province,148,228,0,124,720,59,0,1279,165,264,0,166,1230,52,0,1877
2015,Turkey,Edirne : Province,3,2,0,5,19,0,0,29,8,7,0,3,47,0,0,65
2015,Turkey,Elazig : Province,70,79,0,59,325,6,0,539,76,112,0,77,746,11,0,1022
2015,Turkey,Erzincan : Province,124,181,0,125,488,14,0,932,109,199,0,200,1638,9,0,2155
2015,Turkey,Erzurum : Province,53,115,0,77,311,9,0,565,70,97,0,91,626,14,0,898
2015,Turkey,Eskisehir : Province,261,434,0,245,1422,72,0,2434,303,492,0,350,2040,73,0,3258
2015,Turkey,Gaziantep : Province,74,130,0,79,321,20,0,624,75,113,0,90,515,18,0,811
2015,Turkey,Giresun : Province,121,187,0,145,586,28,0,1067,126,208,0,195,1307,17,0,1853
2015,Turkey,Gumushane : Province,82,105,0,48,327,6,0,568,85,117,0,90,1171,8,0,1471
2015,Turkey,Hakkari : Province,1,0,0,0,1,0,0,2,0,2,0,1,13,0,0,16
2015,Turkey,Hatay : Province,6,8,0,11,26,2,0,53,1,5,0,2,28,1,0,37
2015,Turkey,Igdir : Province,4,3,0,1,10,0,0,18,3,2,0,2,28,1,0,36
2015,Turkey,Isparta : Province,199,329,0,215,1261,44,0,2048,242,394,0,265,2280,51,0,3232
2015,Turkey,Istanbul : Province,296,496,0,285,2081,121,0,3279,302,579,0,429,4152,131,0,5593
2015,Turkey,Izmir : Province,12,26,0,24,90,4,0,156,12,33,0,26,214,6,0,291
2015,Turkey,Kahramanmaras : Province,20,51,0,27,131,2,0,231,19,51,0,31,168,4,0,273
2015,Turkey,Karabuk : Province,241,383,0,212,1056,55,0,1947,258,420,0,274,2403,56,0,3411
2015,Turkey,Karaman : Province,230,322,0,199,957,41,0,1749,246,387,0,282,2469,43,0,3427
2015,Turkey,Kars : Province,25,48,0,34,139,2,0,248,23,62,0,38,236,3,0,362
2015,Turkey,Kastamonu : Province,299,403,0,255,1317,55,0,2329,313,496,0,351,3437,55,0,4652
2015,Turkey,Kayseri : Province,143,257,0,167,1069,61,0,1697,144,311,0,229,1599,54,0,2337
2015,Turkey,Kilis : Province,2,2,0,3,10,0,0,17,2,4,0,3,15,1,0,25
2015,Turkey,Kirikkale : Province,279,424,0,255,1235,67,0,2260,278,431,0,324,1959,65,0,3057
2015,Turkey,Kirsehir : Province,130,217,0,160,746,99,0,1352,162,251,0,173,954,80,0,1620
2015,Turkey,Kocaeli : Province,0,0,0,1,3,0,0,4,1,0,0,2,3,0,0,6
2015,Turkey,Konya : Province,249,370,0,238,1190,49,0,2096,289,441,0,360,2103,53,0,3246
2015,Turkey,Kutahya : Province,318,425,0,254,1286,52,0,2335,303,498,0,309,2203,66,0,3379
2015,Turkey,Malatya : Province,59,115,0,74,322,8,0,578,57,141,0,98,463,21,0,780
2015,Turkey,Manisa : Province,420,598,0,361,2149,59,0,3587,451,748,0,569,6149,81,0,7998
2015,Turkey,Mardin : Province,315,483,0,408,1119,99,0,2424,310,505,0,442,1092,66,0,2415
2015,Turkey,Mersin : Province,97,178,0,139,586,54,0,1054,87,210,0,130,726,54,0,1207
2015,Turkey,Mugla : Province,1,2,0,0,4,0,0,7,0,0,0,0,4,0,0,4
2015,Turkey,Nevsehir : Province,359,482,0,299,1677,44,0,2861,364,543,0,438,3325,57,0,4727
2015,Turkey,Nigde : Province,169,257,0,208,1070,78,0,1782,190,327,0,219,1749,67,0,2552
2015,Turkey,Ordu : Province,232,272,0,177,798,34,0,1513,209,320,0,216,1272,49,0,2066
2015,Turkey,Osmaniye : Province,0,0,0,0,3,0,0,3,0,0,0,0,0,0,0,0
2015,Turkey,Rize : Province,0,0,0,0,0,0,0,0,0,0,0,0,0,0,0,0
2015,Turkey,Sakarya : Province,266,470,0,288,1472,95,0,2591,309,521,0,389,2426,89,0,3734
2015,Turkey,Samsun : Province,424,723,0,437,1919,125,0,3628,509,775,0,491,3143,112,0,5030
2015,Turkey,Sanliurfa : Province,22,47,0,37,106,4,0,216,29,58,0,37,106,5,0,235
2015,Turkey,Siirt : Province,44,90,0,71,205,16,0,426,63,78,0,75,243,13,0,472
2015,Turkey,Sinop : Province,287,341,0,273,1264,42,0,2207,287,452,0,376,2379,43,0,3537
2015,Turkey,Sirnak : Province,75,122,0,106,311,21,0,635,72,119,0,105,313,23,0,632
2015,Turkey,Sivas : Province,259,360,0,248,1128,26,0,2021,228,430,0,330,2303,41,0,3332
2015,Turkey,Tekirdag : Province,0,5,0,1,11,0,0,17,2,2,0,3,16,1,0,24
2015,Turkey,Tokat : Province,373,493,0,361,1696,83,0,3006,404,608,0,485,3057,88,0,4642
2015,Turkey,Trabzon : Province,275,373,0,239,1121,29,0,2037,298,425,0,340,2173,33,0,3269
2015,Turkey,Tunceli : Province,0,0,0,0,0,0,0,0,0,0,0,0,0,0,0,0
2015,Turkey,Usak : Province,274,376,0,257,1351,37,0,2295,298,474,0,352,2771,44,0,3939
2015,Turkey,Van : Province,52,80,0,43,328,7,0,510,53,86,0,161,615,14,0,929
2015,Turkey,Yalova : Province,174,311,0,139,1172,91,0,1887,163,297,0,194,1909,73,0,2636
2015,Turkey,Yozgat : Province,276,350,0,215,1034,74,0,1949,257,395,0,338,1413,70,0,2473
2015,Turkey,Zondulak : Province,298,418,0,246,1459,48,0,2469,339,499,0,336,4518,65,0,5757
2015,Turkey,Turkey : Dispersed in the country / territory,22,26,0,48,106,6,0,208,27,43,0,716,390,6,0,1182
2015,United Rep. of Tanzania,Chogo : Point,6,7,0,13,47,0,0,73,5,8,0,11,52,1,0,77
2015,United Rep. of Tanzania,Katumba : Point,3622,7867,0,6290,14935,1351,0,34065,3725,7748,0,5617,13858,1403,0,32351
2015,United Rep. of Tanzania,Kigoma : Region,1817,2241,0,2010,4525,255,0,10848,1694,2212,0,1942,5112,419,0,11379
2015,United Rep. of Tanzania,Mishamo : Point,3562,6667,0,5109,11820,1090,0,28248,3505,6721,0,4349,11390,1167,0,27132
2015,United Rep. of Tanzania,Nduta camp,2478,3412,0,6214,7638,567,0,20309,2219,2987,0,5925,6306,655,0,18092
2015,United Rep. of Tanzania,Nyarugusu : Point,12535,15339,0,14267,32017,2066,0,76224,14102,14881,0,13725,29989,1726,0,74423
2015,United Rep. of Tanzania,Ulyankulu : Point,3040,6743,0,4120,10449,881,0,25233,2884,6433,0,4407,9661,672,0,24057
2015,United Rep. of Tanzania,Dar es Salaam : Region,6,7,0,10,34,2,0,59,7,9,0,7,27,0,0,50
2015,Uganda,Adjumani : District,9962,16463,0,10387,24919,2610,0,64341,10359,17397,0,11494,15493,1097,0,55840
2015,Uganda,Arua,2170,4310,0,2947,5405,431,0,15263,2326,4584,0,3476,3679,155,0,14220
2015,Uganda,Kampala : City,3221,6282,0,5835,19112,542,0,34992,4063,6329,0,5476,22690,494,0,39052
2015,Uganda,Kiryandongo : District,2901,6288,0,4444,9343,711,0,23687,3146,6591,0,5026,7566,299,0,22628
2015,Uganda,Kyaka II,2053,3037,0,2101,5957,435,0,13583,2024,3068,0,2040,5969,428,0,13529
2015,Uganda,Kyangwali : Point,3464,5205,0,2950,8722,702,0,21043,3407,5354,0,3054,8292,637,0,20744
2015,Uganda,Nakivale : Point,6429,10747,0,7514,22733,1158,0,48581,6436,10995,0,7502,24141,1084,0,50158
2015,Uganda,Oruchinga : Point,526,799,0,435,1278,83,0,3121,541,790,0,408,1108,83,0,2930
2015,Uganda,Rwamanja : Point,7461,8121,0,3611,14065,708,0,33966,7283,7997,0,3843,15535,630,0,35288
2015,Uganda,Uganda : Dispersed in the country / territory,18000,18000,0,18000,18000,18000,0,90000,18000,18000,0,18000,18000,18000,0,90000
2015,Ukraine,Ukraine : Dispersed in the country / territory,0,0,0,0,0,0,0,0,0,0,0,0,0,0,0,0
2015,Uruguay,Montevideo : Department,3,16,0,17,95,12,0,143,4,16,0,20,176,21,0,237
2015,United States of America,United States of America : Dispersed in the country / territory,0,0,0,0,0,0,0,0,0,0,0,0,0,0,0,0
2015,Uzbekistan,Tashkent : City,0,7,0,6,25,5,0,43,3,5,0,17,29,7,0,61
2015,Uzbekistan,Termez : District,0,0,0,0,0,0,0,0,0,0,0,0,3,0,0,3
2015,Uzbekistan,Uzbekistan: Dispersed in the country,0,0,0,0,0,0,0,0,0,0,0,0,0,0,0,0
2015,Venezuela (Bolivarian Republic of),Amazonas : Estado - State,0,0,0,0,0,0,0,0,0,0,0,0,0,0,0,0
2015,Venezuela (Bolivarian Republic of),Apure : Point,0,0,0,0,1,0,0,1,0,0,0,0,1,0,0,1
2015,Venezuela (Bolivarian Republic of),Bolivar,0,0,0,0,0,0,0,0,0,0,0,0,0,0,0,0
2015,Venezuela (Bolivarian Republic of),Caracas : Point,5,4,0,5,25,0,0,39,3,1,0,0,95,1,0,100
2015,Venezuela (Bolivarian Republic of),Tachira : Point,3,0,0,5,5,0,0,13,0,1,0,2,20,0,0,23
2015,Venezuela (Bolivarian Republic of),Venezuela : Dispersed in the country / territory,159,334,0,565,1939,122,0,3119,198,435,0,732,2038,169,0,3572
2015,Venezuela (Bolivarian Republic of),Zulia : Point,1,1,0,4,6,1,0,13,2,3,0,2,16,2,0,25
2015,Viet Nam,Viet Nam : Dispersed in the country / territory,0,0,0,0,0,0,0,0,0,0,0,0,0,0,0,0
2015,Vanuatu,Port Vila : Point,0,0,0,0,1,0,0,1,0,0,0,0,0,0,0,0
2015,Samoa,Apia,0,0,0,0,1,0,0,1,1,0,0,0,1,0,0,2
2015,Yemen,Abyan: Muhafazah - Governorate,8077,27261,0,17165,45436,3029,0,100968,6881,24083,0,17202,34404,3440,0,86010
2015,Yemen,Abyan: Muhafazah ?Çô Governorate,2,4,0,1,5,1,0,13,1,0,0,1,11,1,0,14
2015,Yemen,Aden: Muhafazah - Governorate,553,1865,0,1174,3109,207,0,6908,471,1648,0,1177,2354,235,0,5885
2015,Yemen,Aden: Muhafazah ?Çô Governorate,719,1538,0,1600,11109,370,0,15336,803,1554,0,2349,29392,326,0,34424
2015,Yemen,Al Bayda: Muhafazah - Governorate,7660,25853,0,16278,43088,2873,0,95752,6525,22838,0,16313,32626,3263,0,81565
2015,Yemen,Al Dali: Muhafazah - Governorate,6162,20793,0,13092,34658,2310,0,77015,5248,18369,0,13119,26242,2624,0,65602
2015,Yemen,Al Hudaydah: Muhafazah - Governorate,886,2990,0,1900,5071,343,0,11190,753,2644,0,1905,4007,398,0,9707
2015,Yemen,Al Jawf : Muhafazah - Governorate,0,6,0,1,8,1,0,16,1,1,0,2,11,0,0,15
2015,Yemen,Al Jawf: Muhafazah - Governorate,4461,15057,0,9480,25094,1673,0,55765,3800,13301,0,9501,19001,1900,0,47503
2015,Yemen,Al Maharah: Muhafazah ?Çô Governorate,86,176,0,67,436,9,0,774,78,176,0,67,1134,19,0,1474
2015,Yemen,Al Mahrah: Muhafazah - Governorate,172,582,0,366,969,65,0,2154,147,514,0,367,734,73,0,1835
2015,Yemen,Al Mahwit: Muhafazah - Governorate,1332,4497,0,2833,7499,500,0,16661,1135,3973,0,2838,5680,568,0,14194
2015,Yemen,Al-Bayda : Muhafazah - Governorate,6,14,0,14,60,4,0,98,4,25,0,10,204,5,0,248
2015,Yemen,Amran : Muhafazah - Governorate,0,3,0,5,8,0,0,16,1,8,0,4,11,0,0,24
2015,Yemen,Amran: Muhafazah - Governorate,12460,42054,0,26479,70090,4673,0,155756,10614,37151,0,26536,53072,5307,0,132680
2015,Yemen,Dhamar : Muhafazah - Governorate,1,10,0,15,65,8,0,99,2,11,0,7,150,23,0,193
2015,Yemen,Dhamar: Muhafazah - Governorate,5950,20082,0,12644,33470,2231,0,74377,5069,17741,0,12672,25344,2534,0,63360
2015,Yemen,Hadramawt: Muhafazah - Governorate,4561,15624,0,9777,26903,1800,0,58665,3924,13796,0,9804,23432,2094,0,53050
2015,Yemen,Hajjah : Muhafazah - Governorate,0,3,0,1,3,0,0,7,0,1,0,2,10,1,0,14
2015,Yemen,Hajjah: Muhafazah - Governorate,9869,33309,0,20972,55514,3701,0,123365,8407,29425,0,21018,42035,4204,0,105089
2015,Yemen,Ibb: Muhafazah - Governorate,5618,18943,0,11932,31621,2108,0,70222,4786,16738,0,11961,23974,2400,0,59859
2015,Yemen,Lahij: Muhafazah - Governorate,1939,6544,0,4120,10907,727,0,24237,1652,5781,0,4130,8259,826,0,20648
2015,Yemen,Lahij: Muhafazah ?Çô Governorate,1005,1719,0,1258,4075,124,0,8181,1210,1778,0,1290,3573,148,0,7999
2015,Yemen,Ma'arib: Muhafazah - Governorate,1979,6686,0,4211,11149,743,0,24768,1689,5909,0,4218,8455,845,0,21116
2015,Yemen,Raymah: Muhafazah ?Çô Governorate,1590,5367,0,3379,8946,596,0,19878,1355,4742,0,3387,6774,677,0,16935
2015,Yemen,Sa'dah : Muhafazah - Governorate,0,6,0,8,30,6,0,50,3,4,0,7,59,3,0,76
2015,Yemen,Sa'dah: Muhafazah - Governorate,7484,25257,0,15902,42095,2806,0,93544,6375,22312,0,15937,31874,3187,0,79685
2015,Yemen,Sana?ÇÖa: Muhafazah ?Çô Governorate,896,3129,0,1891,14651,732,0,21299,979,3332,0,2047,17129,782,0,24269
2015,Yemen,Sanaa: Muhafazah - Governorate,8285,27962,0,17606,46604,3107,0,103564,7058,24702,0,17644,35289,3529,0,88222
2015,Yemen,Shabwah: Muhafazah - Governorate,537,1811,0,1140,3029,202,0,6719,458,1601,0,1143,2297,229,0,5728
2015,Yemen,Socotra: Muhafazah - Governorate,668,2256,0,1420,3759,251,0,8354,569,1992,0,1423,2846,285,0,7115
2015,Yemen,Taizz: Muhafazah - Governorate,17046,57418,0,36215,96128,6408,0,213215,14546,50742,0,36262,72719,7256,0,181525
2015,Yemen,Amanat Al Asimah: Muhafazah - Governorate,2347,7921,0,4987,13202,880,0,29337,1999,6997,0,4998,9996,1000,0,24990
2015,Yemen,Yemen : Dispersed in the country / territory,2995,8984,0,7487,38930,1497,0,59893,2995,8984,0,7487,68876,1497,0,89839
2015,South Africa,South Africa : Dispersed in the country / territory,0,0,0,0,0,0,0,0,0,0,0,0,0,0,0,0
2015,Zambia,Lusaka : District,262,692,0,641,2312,93,0,4000,221,712,0,639,3890,180,0,5642
2015,Zambia,Mayukwayukwa : Point,971,1293,0,860,2581,144,0,5849,940,1291,0,835,2842,297,0,6205
2015,Zambia,Meheba : Point,990,2187,0,1490,3697,282,0,8646,1056,2146,0,1470,4328,431,0,9431
2015,Zambia,Zambia : Dispersed in the country / territory,637,1444,0,979,2712,400,0,6172,602,1316,0,1018,2786,512,0,6234
2015,Zimbabwe,Harare : City,98,128,0,86,313,6,0,631,77,127,0,103,439,9,0,755
2015,Zimbabwe,Manicaland : Province,472,654,0,431,2703,28,0,4288,487,705,0,544,3150,33,0,4919
2015,Zimbabwe,Zimbabwe : Dispersed in the country / territory,0,0,0,0,0,0,0,0,0,0,0,0,0,0,0,0
2016,Aruba,Aruba : Dispersed in the country / territory,0,0,0,0,1,0,0,1,0,1,0,0,3,0,0,4
2016,Afghanistan,Badakhshan,1187,1478,0,903,1964,238,0,5770,1245,945,0,972,1948,320,0,5430
2016,Afghanistan,Badakhshan : Wilayat - Province,2063,2562,0,1579,3436,422,0,10062,2173,1670,0,1709,3436,563,0,9551
2016,Afghanistan,Badghis : Wilayat - Province,4167,4121,0,5144,8779,1383,0,23594,3700,4113,0,5901,8573,1567,0,23854
2016,Afghanistan,Badghis : Wllayat - Province,17,9,0,12,29,3,0,70,9,12,0,4,32,0,0,57
2016,Afghanistan,Badghis:Wllayet - Province,1081,1069,0,1344,2285,361,0,6140,961,1069,0,1540,2233,407,0,6210
2016,Afghanistan,Baghlan : Wilayat - Province,1405,1322,0,1078,2311,216,0,6332,1396,1193,0,1075,1904,320,0,5888
2016,Afghanistan,Baghlan : Wllayat - Province,7958,7305,0,5694,10628,1156,0,32741,7940,5949,0,6487,10317,1509,0,32202
2016,Afghanistan,Balkh : Wilayat - Province,3410,4779,0,4871,8061,2144,0,23265,4790,3458,0,4713,7498,2465,0,22924
2016,Afghanistan,Bamyan : Wilayat - Province,23,24,0,15,100,10,0,172,31,46,0,45,49,10,0,181
2016,Afghanistan,Bamyan: Wilayat - Province,46,54,0,46,108,6,0,260,63,75,0,95,103,17,0,353
2016,Afghanistan,Daykundi : Wilayat - Province,20,47,0,43,80,28,0,218,33,37,0,61,100,3,0,234
2016,Afghanistan,Farah : Wilayat - Province,12900,15790,0,21341,29700,5331,0,85062,14521,9944,0,20084,29328,5984,0,79861
2016,Afghanistan,Faryab : Wilayat - Province,2339,2801,0,3020,5603,1460,0,15223,2842,2334,0,2922,5320,1432,0,14850
2016,Afghanistan,Ghazni : Wilayat - Province,4737,5816,0,5346,12786,1075,0,29760,8549,5980,0,6830,16210,1690,0,39259
2016,Afghanistan,Ghor : Wilayat - Province,4675,5240,0,3561,8458,796,0,22730,5293,4197,0,4036,8404,867,0,22797
2016,Afghanistan,Helmand : Wilayat - Province,19703,20036,0,17923,47314,5654,0,110630,21366,23091,0,16280,46140,5110,0,111987
2016,Afghanistan,Herat : Wilayat - Province,13641,17630,0,9152,31920,1700,0,74043,18943,11189,0,14829,27563,1675,0,74199
2016,Afghanistan,Hirat : Wilayat - Province,80,78,0,122,354,0,0,634,136,139,0,210,373,58,0,916
2016,Afghanistan,Jawzjan : Wilayat - Province,2700,3099,0,3008,4947,663,0,14417,2837,2411,0,2752,4387,783,0,13170
2016,Afghanistan,Kabul : Wilayat - Province,18364,18558,0,14154,37614,2896,0,91586,22351,18339,0,16343,38231,4465,0,99729
2016,Afghanistan,Kandahar : Wilayat - Province,12843,10737,0,8208,18580,2601,0,52969,11194,13895,0,8895,20334,2936,0,57254
2016,Afghanistan,Kapisa : Wilayat - Province,1889,2076,0,1697,4196,333,0,10191,2685,2061,0,2098,4822,419,0,12085
2016,Afghanistan,Khost : Wilayat - Province,4703,7051,0,3022,6347,696,0,21819,4994,7271,0,3735,6853,837,0,23690
2016,Afghanistan,Kunar : Wilayat - Province,5658,5821,0,3070,8633,317,0,23499,6364,5201,0,3600,8595,364,0,24124
2016,Afghanistan,Kunduz : Wilayat - Province,18244,16062,0,11386,31834,3577,0,81103,17860,16858,0,13661,29376,3506,0,81261
2016,Afghanistan,Laghman : Wilayat - Province,4564,4159,0,2869,7084,324,0,19000,4911,4220,0,3178,6780,561,0,19650
2016,Afghanistan,Logar : Wilayat - Province,4993,4864,0,4183,9886,663,0,24589,6437,5092,0,4611,10145,1040,0,27325
2016,Afghanistan,Nangarhar : Wilayat - Province,38758,34365,0,23578,57089,2327,0,156117,41636,35294,0,26462,56477,3405,0,163274
2016,Afghanistan,Nimroz,234,249,0,199,401,60,0,1143,243,266,0,207,385,76,0,1177
2016,Afghanistan,Nimroz : Wilayat - Province,243,258,0,203,407,51,0,1162,252,275,0,214,392,62,0,1195
2016,Afghanistan,Nuristan : Wilayat - Province,860,840,0,363,1477,4,0,3544,1031,687,0,623,1517,13,0,3871
2016,Afghanistan,Paktika : Walayat - Province,46,45,0,34,80,9,0,214,59,52,0,49,85,8,0,253
2016,Afghanistan,Paktika : Wilayat - Province,4331,7797,0,1844,5578,410,0,19960,4345,8996,0,3118,7028,669,0,24156
2016,Afghanistan,Paktya : Walayat - Province,1710,1640,0,1258,3153,255,0,8016,1859,1696,0,1369,2838,334,0,8096
2016,Afghanistan,Paktya : Wilayat - Province,3676,3374,0,3112,5421,609,0,16192,3909,3735,0,2845,5017,638,0,16144
2016,Afghanistan,Panjsher : Wilayat - Province,28,32,0,26,74,3,0,163,33,22,0,22,80,8,0,165
2016,Afghanistan,Panjshir : Walayat - Province,9,12,0,8,33,2,0,64,14,14,0,11,32,6,0,77
2016,Afghanistan,Panjshir : Wilayat - Province,206,235,0,185,542,57,0,1225,326,266,0,239,659,73,0,1563
2016,Afghanistan,Parwan : Wilayat - Province,1515,1605,0,1507,3543,258,0,8428,2118,1764,0,1711,3987,437,0,10017
2016,Afghanistan,Samangan : Wilayat - Province,663,721,0,571,1654,319,0,3928,681,515,0,680,1517,378,0,3771
2016,Afghanistan,Sar-e Pul : Wilayat - Province,2723,2556,0,2394,5400,1220,0,14293,2979,2273,0,2148,4697,1315,0,13412
2016,Afghanistan,Takhar : Wilayat - Province,16271,12490,0,9155,20648,2274,0,60838,13304,14019,0,9052,20692,3177,0,60244
2016,Afghanistan,Uruzgan : Wilayat - Province,6072,4802,0,3618,8348,1256,0,24096,5207,6433,0,3865,9031,1325,0,25861
2016,Afghanistan,Uruzghon : Wilayat - Province,4000,3163,0,2380,5502,824,0,15869,3436,4247,0,2541,5930,872,0,17026
2016,Afghanistan,Wardak : Wilayat - Province,2596,3342,0,3448,8401,411,0,18198,5091,3613,0,4135,10714,795,0,24348
2016,Afghanistan,Zabul : Wilayat - Province,2414,1955,0,1474,3424,496,0,9763,2104,2621,0,1599,3701,540,0,10565
2016,Afghanistan,Afghanistan : Dispersed in the country / territory,30,20,0,30,250,120,0,450,30,20,0,30,250,120,0,450
2016,Angola,Angola : Dispersed in the country / territory,0,0,0,0,0,0,0,0,0,0,0,0,0,0,0,0
2016,Anguilla,"The Valley, Anguilla",0,0,0,0,0,0,0,0,0,0,0,0,1,0,0,1
2016,Albania,Babrru Centre,3,5,0,1,5,1,0,15,2,4,0,3,12,1,0,22
2016,Albania,Mamurras : Bashki - Municipality,0,1,0,0,1,0,0,2,0,2,0,0,0,0,0,2
2016,Albania,Peshkopi : Bashki - Municipality,0,0,0,0,0,1,0,1,0,0,0,0,0,0,0,0
2016,Albania,Saranda,0,0,0,0,1,0,0,1,0,0,0,0,0,0,0,0
2016,Albania,Tirana Urban : Point,6,4,0,2,1196,195,0,1403,6,4,0,4,1232,194,0,1440
2016,Albania,Albania : Dispersed in the country/territory,617,616,0,615,615,0,0,2463,615,616,0,615,616,0,0,2462
2016,United Arab Emirates,"Abu Dhabi, Emirates",55,176,0,273,216,30,0,750,54,165,0,290,219,29,0,757
2016,Argentina,Argentina : Dispersed in the country / territory,20,82,0,101,1654,325,0,2182,19,110,0,139,4413,602,0,5283
2016,Armenia,Aragatsotn : Marz - Province,0,0,0,0,39,18,0,57,0,0,0,0,32,10,0,42
2016,Armenia,Ararat : Marz - Province,0,0,0,0,32,33,0,65,0,0,0,0,36,37,0,73
2016,Armenia,Armavir : Marz - Province,0,0,0,0,47,37,0,84,0,0,0,0,49,17,0,66
2016,Armenia,Gergharkunik : Marz - Province,0,0,0,0,34,12,0,46,0,0,0,0,36,12,0,48
2016,Armenia,Kotayk : Marz - Province,0,0,0,0,85,55,0,140,0,0,0,0,88,35,0,123
2016,Armenia,Lori : Marz - Province,0,0,0,0,43,14,0,57,0,0,0,0,38,10,0,48
2016,Armenia,Shirak : Marz - Province,0,0,0,0,14,3,0,17,0,0,0,0,11,3,0,14
2016,Armenia,Syunik : Marz - Province,0,0,0,0,54,18,0,72,0,0,0,0,47,6,0,53
2016,Armenia,Tavush : Marz - Province,0,0,0,0,2,18,0,20,0,0,0,1,0,1,0,2
2016,Armenia,Vayots Dzor : Marz - Province,0,1,0,0,10,0,0,11,1,0,0,1,11,0,0,13
2016,Armenia,Yerevan : City,61,97,0,95,702,213,0,1168,66,100,0,112,745,153,0,1176
2016,Antigua and Barbuda,St. John,0,0,0,0,0,0,0,0,0,0,0,0,4,0,0,4
2016,Australia,Australia : Dispersed in the country / territory,0,0,0,0,0,0,0,0,0,0,0,0,0,0,0,0
2016,Austria,Austria : Dispersed in the country / territory,0,0,0,0,0,0,0,0,0,0,0,0,0,0,0,0
2016,Azerbaijan,Absheron : Rayon,0,0,0,0,0,0,0,0,0,0,0,0,0,0,0,0
2016,Azerbaijan,Aghdam : Rayon,0,0,0,0,0,0,0,0,0,0,0,0,0,0,0,0
2016,Azerbaijan,Aghdash : Rayon,0,0,0,0,0,0,0,0,0,0,0,0,0,0,0,0
2016,Azerbaijan,Aghjabedi : Rayon,0,0,0,0,0,0,0,0,0,0,0,0,0,0,0,0
2016,Azerbaijan,Aghstafa : Rayon,0,0,0,0,0,0,0,0,0,0,0,0,0,0,0,0
2016,Azerbaijan,Aghsu : Rayon,0,0,0,0,0,0,0,0,0,0,0,0,0,0,0,0
2016,Azerbaijan,Astara : Rayon,0,0,0,0,0,0,0,0,0,0,0,0,0,0,0,0
2016,Azerbaijan,Azerbaijan : Dispersed in the country/territory,0,0,0,0,0,0,0,0,0,0,0,0,0,0,0,0
2016,Azerbaijan,Baku : Municipality,50,76,0,87,295,25,0,533,62,90,0,83,480,33,0,748
2016,Azerbaijan,Balakan : Rayon,0,0,0,0,0,0,0,0,0,0,0,0,0,0,0,0
2016,Azerbaijan,Barda : Rayon,0,0,0,0,0,0,0,0,0,0,0,0,0,0,0,0
2016,Azerbaijan,Beylagan : Rayon,0,0,0,0,0,0,0,0,0,0,0,0,0,0,0,0
2016,Azerbaijan,Bilasuvar : Rayon,0,0,0,0,0,0,0,0,0,0,0,0,0,0,0,0
2016,Azerbaijan,Dashkasan : Rayon,0,0,0,0,0,0,0,0,0,0,0,0,0,0,0,0
2016,Azerbaijan,Fuzuli : Rayon,0,0,0,0,0,0,0,0,0,0,0,0,0,0,0,0
2016,Azerbaijan,Gabala : Point,0,0,0,0,0,0,0,0,0,0,0,0,0,0,0,0
2016,Azerbaijan,Gadabay : Rayon,0,0,0,0,0,0,0,0,0,0,0,0,0,0,0,0
2016,Azerbaijan,Gakh : Point,0,0,0,0,0,0,0,0,0,0,0,0,0,0,0,0
2016,Azerbaijan,Ganja : Municipality,0,0,0,0,0,0,0,0,0,0,0,0,0,0,0,0
2016,Azerbaijan,Gazakh : Point,0,0,0,0,0,0,0,0,0,0,0,0,0,0,0,0
2016,Azerbaijan,Gobustan : Rayon,0,0,0,0,0,0,0,0,0,0,0,0,0,0,0,0
2016,Azerbaijan,Goranboy : Rayon,0,0,0,0,0,0,0,0,0,0,0,0,0,0,0,0
2016,Azerbaijan,Goychay : Rayon,0,0,0,0,0,0,0,0,0,0,0,0,0,0,0,0
2016,Azerbaijan,Goygol : Rayon,0,0,0,0,0,0,0,0,0,0,0,0,0,0,0,0
2016,Azerbaijan,Guba : Point,0,0,0,0,0,0,0,0,0,0,0,0,0,0,0,0
2016,Azerbaijan,Gusar : Point,0,0,0,0,0,0,0,0,0,0,0,0,0,0,0,0
2016,Azerbaijan,Hajigabul : Rayon,0,0,0,0,0,0,0,0,0,0,0,0,0,0,0,0
2016,Azerbaijan,Imishli : Rayon,0,0,0,0,0,0,0,0,0,0,0,0,0,0,0,0
2016,Azerbaijan,Ismayilli : Rayon,0,0,0,0,0,0,0,0,0,0,0,0,0,0,0,0
2016,Azerbaijan,Jalilabad : Point,0,0,0,0,0,0,0,0,0,0,0,0,0,0,0,0
2016,Azerbaijan,Khachmaz : Rayon,0,0,0,0,0,0,0,0,0,0,0,0,0,0,0,0
2016,Azerbaijan,Khizi : Point,0,0,0,0,0,0,0,0,0,0,0,0,0,0,0,0
2016,Azerbaijan,Kurdamir : Rayon,0,0,0,0,0,0,0,0,0,0,0,0,0,0,0,0
2016,Azerbaijan,Lachin (Takhta Korpu) : Point,0,0,0,0,0,0,0,0,0,0,0,0,0,0,0,0
2016,Azerbaijan,Lankaran : Municipality,0,0,0,0,0,0,0,0,0,0,0,0,0,0,0,0
2016,Azerbaijan,Masalli : Rayon,0,0,0,0,0,0,0,0,0,0,0,0,0,0,0,0
2016,Azerbaijan,Mingechavir : Municipality,0,0,0,0,0,0,0,0,0,0,0,0,0,0,0,0
2016,Azerbaijan,Naftalan : Municipality,0,0,0,0,0,0,0,0,0,0,0,0,0,0,0,0
2016,Azerbaijan,Nakhchivan : Autonomous republic,0,0,0,0,0,0,0,0,0,0,0,0,0,0,0,0
2016,Azerbaijan,Neftchala : Rayon,0,0,0,0,0,0,0,0,0,0,0,0,0,0,0,0
2016,Azerbaijan,Oghuz : Rayon,0,0,0,0,0,0,0,0,0,0,0,0,0,0,0,0
2016,Azerbaijan,Saatli : Rayon,0,0,0,0,0,0,0,0,0,0,0,0,0,0,0,0
2016,Azerbaijan,Sabirabad : Rayon,0,0,0,0,0,0,0,0,0,0,0,0,0,0,0,0
2016,Azerbaijan,Salyan : Rayon,0,0,0,0,0,0,0,0,0,0,0,0,0,0,0,0
2016,Azerbaijan,Samukh : Rayon,0,0,0,0,0,0,0,0,0,0,0,0,0,0,0,0
2016,Azerbaijan,Shabran : Rayon,0,0,0,0,0,0,0,0,0,0,0,0,0,0,0,0
2016,Azerbaijan,Shaki : Municipality,0,0,0,0,0,0,0,0,0,0,0,0,0,0,0,0
2016,Azerbaijan,Shamakhi : Rayon,0,0,0,0,0,0,0,0,0,0,0,0,0,0,0,0
2016,Azerbaijan,Shamkir : Rayon,0,0,0,0,0,0,0,0,0,0,0,0,0,0,0,0
2016,Azerbaijan,Shirvan : Municipality,0,0,0,0,0,0,0,0,0,0,0,0,0,0,0,0
2016,Azerbaijan,Siyazan : Rayon,0,0,0,0,0,0,0,0,0,0,0,0,0,0,0,0
2016,Azerbaijan,Sumgayit : Municipality,0,0,0,0,0,0,0,0,0,0,0,0,0,0,0,0
2016,Azerbaijan,Tartar : Rayon,0,0,0,0,0,0,0,0,0,0,0,0,0,0,0,0
2016,Azerbaijan,Tovuz : Rayon,0,0,0,0,0,0,0,0,0,0,0,0,0,0,0,0
2016,Azerbaijan,Ujar : Rayon,0,0,0,0,0,0,0,0,0,0,0,0,0,0,0,0
2016,Azerbaijan,Yevlakh : Municipality,0,0,0,0,0,0,0,0,0,0,0,0,0,0,0,0
2016,Azerbaijan,Zagatala : Rayon,0,0,0,0,0,0,0,0,0,0,0,0,0,0,0,0
2016,Azerbaijan,Zardab : Rayon,0,0,0,0,0,0,0,0,0,0,0,0,0,0,0,0
2016,Burundi,Bujumbura: Town,1444,2540,0,2097,6482,376,0,12939,1405,2575,0,2091,6096,304,0,12471
2016,Burundi,Bwagiriza : Point,741,1134,0,730,1879,104,0,4588,785,1234,0,732,1551,88,0,4390
2016,Burundi,Kavumu: Point,1220,1869,0,953,2473,74,0,6589,1324,1881,0,979,1796,89,0,6069
2016,Burundi,Kinama: Point,726,983,0,696,1731,102,0,4238,692,1036,0,739,1441,70,0,3978
2016,Burundi,Musasa : Point,521,886,0,560,1318,57,0,3342,574,872,0,624,1024,39,0,3133
2016,Burundi,Burundi : Dispersed in the country / territory,50,103,0,79,266,19,0,517,44,106,0,73,225,9,0,457
2016,Belgium,Belgium : Dispersed in the country / territory,0,0,0,0,0,0,0,0,0,0,0,0,0,0,0,0
2016,Benin,Benin : Dispersed in the country / territory,39,66,0,59,303,11,0,478,50,64,0,66,370,7,0,557
2016,Burkina Faso,Bobo-Dioulasso : Department,43,103,0,78,218,12,0,454,35,91,0,45,168,16,0,355
2016,Burkina Faso,Dori,0,1,0,1,0,0,0,2,0,1,0,0,0,0,0,1
2016,Burkina Faso,Goudebo : Point,791,1218,0,612,2127,169,0,4917,792,1211,0,618,1792,226,0,4639
2016,Burkina Faso,Mentao : Point,893,1635,0,805,2795,240,0,6368,914,1609,0,844,2259,289,0,5915
2016,Burkina Faso,Ouagadougou : Point,45,88,0,67,307,18,0,525,41,97,0,106,433,21,0,698
2016,Burkina Faso,Burkina Faso : Dispersed in the country / territory,575,1210,0,703,1874,101,0,4463,604,1352,0,808,1437,138,0,4339
2016,Bangladesh,Bandarban : Zila - District,0,0,0,2,5,1,0,8,0,0,0,1,8,1,0,10
2016,Bangladesh,Bangladesh : Dispersed in the country / territory,0,0,0,0,0,0,0,0,0,0,0,0,0,0,0,0
2016,Bangladesh,Chittagong : Zila - District,0,0,0,0,3,0,0,3,0,0,0,0,0,0,0,0
2016,Bangladesh,Cox's Bazar : Zila - District,0,2,0,2,8,0,0,12,0,1,0,2,7,2,0,12
2016,Bangladesh,Dhaka : Zila - District,0,5,0,0,6,0,0,11,1,1,0,1,11,2,0,16
2016,Bangladesh,Kutupalong : Point,869,1540,0,1193,3395,148,0,7145,1024,1577,0,1203,2695,176,0,6675
2016,Bangladesh,Nayapara : Point,1249,2175,0,1743,5020,232,0,10419,1339,2134,0,1816,3356,247,0,8892
2016,Bangladesh,Rangamati : Zila - District,0,0,0,1,1,0,0,2,0,0,0,0,2,1,0,3
2016,Bulgaria,Bulgaria : Dispersed in the country / territory,0,0,0,0,0,0,0,0,0,0,0,0,0,0,0,0
2016,Bahrain,Bahrain : Dispersed in the country / territory,17,30,0,14,112,5,0,178,26,26,0,14,126,12,0,204
2016,Bahamas,Bahamas : Dispersed in the country / territory,0,0,0,0,7,0,0,7,0,0,0,1,14,4,0,19
2016,Bahamas,Carmichael Detention Center,0,0,0,0,0,0,0,0,0,0,0,0,5,0,0,5
2016,Bosnia and Herzegovina,Bosnia and Herzegovina : Dispersed in the country / territory,16,24,0,155,2048,827,0,3070,20,15,0,148,1764,356,0,2303
2016,Belarus,Belarus : Dispersed in the country / territory,0,0,0,0,0,0,0,0,0,0,0,0,0,0,0,0
2016,Belarus,Brest : Oblast - Region,0,0,0,0,0,0,0,0,0,0,0,0,2,0,0,2
2016,Belarus,Brest Oblast - Region,0,0,0,0,1,0,0,1,1,0,0,0,7,1,0,9
2016,Belarus,Gomel : Oblast - Region,1,2,0,1,1,0,0,5,1,0,0,1,2,0,0,4
2016,Belarus,Gomel: Oblast - Region,2,5,0,0,19,5,0,31,4,4,0,0,43,0,0,51
2016,Belarus,Grodno: Oblast - Region,0,0,0,1,4,0,0,5,0,0,0,0,15,0,0,15
2016,Belarus,Horad Minsk: City,0,4,0,8,57,17,0,86,4,14,0,9,175,5,0,207
2016,Belarus,Minsk : Oblast - Region,0,0,0,0,5,0,0,5,0,0,0,0,3,0,0,3
2016,Belarus,Minsk: Oblast - Region,1,1,0,2,4,0,0,8,0,2,0,1,15,0,0,18
2016,Belarus,Mogilev : Oblast - Region,0,0,0,2,9,0,0,11,1,1,0,0,15,0,0,17
2016,Belarus,Vitebsk : Oblast - Region,0,3,0,0,2,0,0,5,0,2,0,1,5,0,0,8
2016,Belarus,Vitebsk: Oblast - Region,1,4,0,0,6,1,0,12,0,0,0,1,18,0,0,19
2016,Belize,Belize : Dispersed in the country / territory,0,0,0,0,0,0,0,0,0,0,0,0,0,0,0,0
2016,Bolivia (Plurinational State of),Bolivia (Plurinational State of),0,0,0,0,0,0,0,0,0,0,0,0,0,0,0,0
2016,Brazil,Brazil : Dispersed in the country / territory,9,470,0,215,8174,65,0,8933,11,452,0,218,29857,61,0,30599
2016,Barbados,Barbados : Dispersed in the country / territory,0,0,0,0,1,0,0,1,0,0,0,0,1,0,0,1
2016,Brunei Darussalam,Brunei Darussalam : Dispersed in the country / territory,0,0,0,0,0,0,0,0,0,0,0,0,0,0,0,0
2016,Botswana,Dukwi : Point,169,234,0,148,505,18,0,1074,206,243,0,144,1124,41,0,1758
2016,Central African Rep.,Bambari: Pladama-Ouaka,244,277,0,115,415,30,0,1081,325,297,0,128,214,20,0,984
2016,Central African Rep.,Bamingui-Bangoran : Prefecture,0,0,0,0,0,0,0,0,0,0,0,0,0,0,0,0
2016,Central African Rep.,Bangui : Commune,136,196,0,138,444,14,0,928,123,191,0,150,489,34,0,987
2016,Central African Rep.,Basse Kotto,0,0,0,0,0,0,0,0,0,0,0,0,0,0,0,0
2016,Central African Rep.,Batalimo,9,19,0,11,27,5,0,71,18,10,0,6,39,2,0,75
2016,Central African Rep.,Haut-Mbomou : Prefecture,0,0,0,0,0,0,0,0,0,0,0,0,0,0,0,0
2016,Central African Rep.,Haut-Mbomou-Bambouti,280,437,0,625,317,38,0,1697,324,457,0,490,202,22,0,1495
2016,Central African Rep.,Haute-Kotto : Prefecture,0,0,0,0,0,0,0,0,0,0,0,0,0,0,0,0
2016,Central African Rep.,Kemo,0,0,0,0,0,0,0,0,0,0,0,0,0,0,0,0
2016,Central African Rep.,Lobaye,0,0,0,0,0,0,0,0,0,0,0,0,0,0,0,0
2016,Central African Rep.,Mambere Kadei,0,0,0,0,0,0,0,0,0,0,0,0,0,0,0,0
2016,Central African Rep.,Mboki,8,15,0,11,50,4,0,88,7,23,0,17,51,7,0,105
2016,Central African Rep.,Mbomou : Prefecture,0,0,0,0,0,0,0,0,0,0,0,0,0,0,0,0
2016,Central African Rep.,Nana Mambere,0,0,0,0,0,0,0,0,0,0,0,0,0,0,0,0
2016,Central African Rep.,Nana-Gribizi : Economic prefecture,0,0,0,0,0,0,0,0,0,0,0,0,0,0,0,0
2016,Central African Rep.,Obo,192,189,0,104,532,63,0,1080,229,201,0,111,422,44,0,1007
2016,Central African Rep.,Ombella M'Poko : Prefecture,0,0,0,0,0,0,0,0,0,0,0,0,0,0,0,0
2016,Central African Rep.,Ouaka,0,0,0,0,0,0,0,0,0,0,0,0,0,0,0,0
2016,Central African Rep.,Ouham : Prefecture,0,0,0,0,0,0,0,0,0,0,0,0,0,0,0,0
2016,Central African Rep.,Ouham-Pende : Prefecture,0,0,0,0,0,0,0,0,0,0,0,0,0,0,0,0
2016,Central African Rep.,Rafai,3,0,0,0,13,0,0,16,1,0,0,0,31,1,0,33
2016,Central African Rep.,Sangha Mbaere,0,0,0,0,0,0,0,0,0,0,0,0,0,0,0,0
2016,Central African Rep.,Vakaga : Prefecture,0,0,0,0,0,0,0,0,0,0,0,0,0,0,0,0
2016,Central African Rep.,Zemio : Sous-prefecture,247,267,0,138,681,79,0,1412,305,293,0,143,557,62,0,1360
2016,Canada,Canada,316,477,0,443,7234,514,0,8984,469,471,0,512,12969,526,0,14947
2016,Switzerland,Switzerland : Dispersed in the country / territory,2949,3323,0,2388,15772,877,0,25309,3099,3514,0,5004,30099,652,0,42368
2016,Chile,Chile : Dispersed in the country / territory,44,38,0,44,724,12,0,862,47,57,0,39,947,19,0,1109
2016,China,Anhui: Province,0,0,0,0,0,0,0,0,0,0,0,0,1,0,0,1
2016,China,Beijing : Municipality,0,2,0,1,37,0,0,40,3,0,0,1,78,1,0,83
2016,China,Chongqing : Municipality,0,0,0,0,0,0,0,0,0,0,0,0,1,0,0,1
2016,China,Fujian : Province,0,0,0,0,5,0,0,5,1,0,0,0,15,0,0,16
2016,China,Gansu : Province,1,0,0,0,2,0,0,3,0,0,0,1,1,0,0,2
2016,China,Guangdong : Province,16,13,0,4,61,0,0,94,7,6,0,8,90,0,0,111
2016,China,Guangxi : Autonomous Region,0,0,0,0,0,0,0,0,0,0,0,0,3,0,0,3
2016,China,Guizhou: Province,0,0,0,0,0,0,0,0,0,0,0,0,1,0,0,1
2016,China,Hainan : Province,0,0,0,0,0,0,0,0,0,0,0,0,2,0,0,2
2016,China,Hebei : Province,2,3,0,2,32,2,0,41,2,1,0,0,98,2,0,103
2016,China,Heilongjiang: Province,0,0,0,0,0,0,0,0,0,0,0,0,2,0,0,2
2016,China,Henan : Province,0,0,0,0,9,0,0,9,0,0,0,0,49,0,0,49
2016,China,Hubei : Province,2,2,0,0,16,0,0,20,0,2,0,0,45,0,0,47
2016,China,Hunan : Province,0,0,0,0,1,0,0,1,0,0,0,0,5,0,0,5
2016,China,Jiangsu : Province,5,4,0,2,9,0,0,20,0,6,0,1,22,0,0,29
2016,China,Jiangxi : Province,0,0,0,0,0,0,0,0,0,0,0,0,0,0,0,0
2016,China,Liaoning : Province,1,0,0,0,2,0,0,3,0,0,0,0,8,0,0,8
2016,China,Neimenggu : Autonomous Region,0,0,0,0,1,0,0,1,0,0,0,0,2,0,0,2
2016,China,Shaanxi : Province,0,0,0,0,1,0,0,1,0,0,0,0,5,0,0,5
2016,China,Shandong : Province,0,1,0,0,2,0,0,3,0,1,0,0,5,0,0,6
2016,China,Shanghai : Municipality,1,0,0,0,5,0,0,6,0,0,0,0,7,0,0,7
2016,China,Shanxi : Province,0,0,0,0,1,0,0,1,0,0,0,0,5,0,0,5
2016,China,Sichuan : Province,0,0,0,0,0,0,0,0,0,0,0,0,3,0,0,3
2016,China,Xinjiang : Autonomous Region,1,3,0,0,3,0,0,7,2,1,0,0,6,0,0,9
2016,China,Yunnan : Province,0,0,0,0,0,0,0,0,0,0,0,0,0,0,0,0
2016,China,Zhejiang : Province,1,2,0,0,15,2,0,20,0,1,0,1,47,0,0,49
2016,Côte d'Ivoire,Abidjan : Departement,41,61,0,36,199,17,0,354,30,77,0,53,346,16,0,522
2016,Côte d'Ivoire,C??te d'Ivoire : Dispersed in the country / territory,0,0,0,0,0,0,0,0,0,0,0,0,0,0,0,0
2016,Côte d'Ivoire,C?â??te d'Ivoire : Dispersed in the country / territory,0,0,0,0,0,0,0,0,0,0,0,0,0,0,0,0
2016,Côte d'Ivoire,Guiglo : Departement,15,15,0,10,38,4,0,82,10,25,0,16,26,1,0,78
2016,Côte d'Ivoire,Tabou : Departement,51,79,0,71,195,11,0,407,57,75,0,50,172,4,0,358
2016,Cameroon,Adinkol : Point,28,97,0,58,139,11,0,333,24,81,0,73,100,18,0,296
2016,Cameroon,Akonolinga,0,0,0,0,0,0,0,0,0,0,0,0,1,0,0,1
2016,Cameroon,Akwaya,53,76,0,31,204,20,0,384,56,84,0,23,61,7,0,231
2016,Cameroon,Alhamdou,105,214,0,115,344,16,0,794,115,206,0,101,275,27,0,724
2016,Cameroon,Ambam,0,0,0,0,0,0,0,0,0,0,0,0,2,0,0,2
2016,Cameroon,Ayos,0,0,0,0,0,0,0,0,0,0,0,0,1,0,0,1
2016,Cameroon,Babongo : Point,2,1,0,1,10,0,0,14,0,4,0,7,7,2,0,20
2016,Cameroon,Bafia,0,0,0,0,2,0,0,2,2,0,0,1,2,0,0,5
2016,Cameroon,Bafouck : Point,67,117,0,85,226,22,0,517,60,118,0,71,218,28,0,495
2016,Cameroon,Bafoussam,1,2,0,1,2,0,0,6,2,1,0,0,8,0,0,11
2016,Cameroon,Bagangte,0,0,0,0,0,0,0,0,0,0,0,0,1,0,0,1
2016,Cameroon,Bagodo : Point,8,63,0,84,192,8,0,355,3,71,0,86,144,20,0,324
2016,Cameroon,Baham,0,0,0,0,1,0,0,1,0,0,0,0,1,0,0,1
2016,Cameroon,Bakombo,3,7,0,7,8,1,0,26,3,11,0,8,8,0,0,30
2016,Cameroon,Bamenda,0,1,0,0,1,0,0,2,0,0,0,1,4,0,0,5
2016,Cameroon,Bana,0,0,0,0,0,0,0,0,1,0,0,0,1,0,0,2
2016,Cameroon,Bandongoue,12,33,0,31,47,2,0,125,13,37,0,20,34,2,0,106
2016,Cameroon,Banyo,119,136,0,80,313,24,0,672,122,160,0,85,195,32,0,594
2016,Cameroon,Barka Lamou,21,33,0,19,50,3,0,126,13,31,0,25,34,2,0,105
2016,Cameroon,Batchenga,0,0,0,0,0,0,0,0,0,0,0,0,1,0,0,1
2016,Cameroon,Batouri,6,31,0,21,64,4,0,126,16,25,0,20,94,5,0,160
2016,Cameroon,Bazzama : Point,34,108,0,104,250,17,0,513,21,106,0,101,162,20,0,410
2016,Cameroon,Bebarang,2,4,0,0,2,1,0,9,0,1,0,0,2,0,0,3
2016,Cameroon,Bedobo : Point,15,128,0,101,286,17,0,547,16,105,0,91,193,20,0,425
2016,Cameroon,Beka,19,37,0,15,48,3,0,122,20,37,0,10,13,3,0,83
2016,Cameroon,Beke Chantier,18,46,0,30,80,0,0,174,11,69,0,30,62,10,0,182
2016,Cameroon,Belabo,33,85,0,55,127,10,0,310,28,86,0,54,127,10,0,305
2016,Cameroon,Belebina,0,0,0,0,0,1,0,1,0,0,0,0,6,0,0,6
2016,Cameroon,Belel,0,0,0,0,2,0,0,2,0,0,0,2,8,0,0,10
2016,Cameroon,Belimbam,10,58,0,21,73,2,0,164,15,61,0,23,55,8,0,162
2016,Cameroon,Belita II,7,21,0,10,30,3,0,71,5,26,0,10,21,0,0,62
2016,Cameroon,Bertoua,14,28,0,27,77,5,0,151,9,39,0,25,73,2,0,148
2016,Cameroon,Betare Oya,85,171,0,100,398,9,0,763,98,178,0,84,319,7,0,686
2016,Cameroon,Bigoro,10,60,0,40,110,6,0,226,15,53,0,61,72,14,0,215
2016,Cameroon,Bimbappe,0,5,0,5,9,4,0,23,3,4,0,5,0,1,0,13
2016,Cameroon,Bindiba,8,24,0,8,18,2,0,60,7,12,0,5,7,4,0,35
2016,Cameroon,Boforo,33,71,0,76,157,10,0,347,24,97,0,91,91,11,0,314
2016,Cameroon,Bombe Bakari,5,27,0,13,32,4,0,81,4,24,0,8,80,5,0,121
2016,Cameroon,Bombe Chateau,8,22,0,10,32,0,0,72,12,25,0,7,22,1,0,67
2016,Cameroon,Bombe Pana,11,109,0,79,180,13,0,392,14,97,0,93,170,15,0,389
2016,Cameroon,Borgop,1073,1641,0,816,2682,214,0,6426,1146,1596,0,813,1840,225,0,5620
2016,Cameroon,Borgop : Point,10,69,0,62,120,10,0,271,17,55,0,50,91,9,0,222
2016,Cameroon,Bot-Makak,0,0,0,0,0,0,0,0,0,0,0,0,1,0,0,1
2016,Cameroon,Boubara : Point,26,124,0,116,320,32,0,618,20,110,0,107,259,34,0,530
2016,Cameroon,Bougogo,4,11,0,6,12,1,0,34,1,19,0,9,11,2,0,42
2016,Cameroon,Boulembe : Point,56,157,0,143,325,25,0,706,64,161,0,136,233,21,0,615
2016,Cameroon,Bouli : Point,13,95,0,79,191,15,0,393,13,80,0,67,142,14,0,316
2016,Cameroon,Buea,0,0,0,0,1,0,0,1,0,0,0,0,6,0,0,6
2016,Cameroon,Campo,0,0,0,0,0,0,0,0,0,0,0,0,1,0,0,1
2016,Cameroon,Colomine,38,101,0,87,176,7,0,409,40,117,0,74,129,11,0,371
2016,Cameroon,Dakere Babongo : Point,39,105,0,79,193,11,0,427,29,101,0,76,118,13,0,337
2016,Cameroon,Damissa,45,118,0,65,195,11,0,434,54,106,0,71,154,17,0,402
2016,Cameroon,Dang Patou : Point,13,86,0,71,189,9,0,368,13,74,0,69,129,12,0,297
2016,Cameroon,Diel,48,79,0,34,123,20,0,304,46,62,0,53,81,19,0,261
2016,Cameroon,Digou Adamou : Point,2,4,0,2,14,1,0,23,0,3,0,11,10,4,0,28
2016,Cameroon,Dip,0,11,0,5,13,1,0,30,4,5,0,2,14,0,0,25
2016,Cameroon,Dir : Point,4,25,0,16,59,1,0,105,1,20,0,27,36,7,0,91
2016,Cameroon,Djakone,72,127,0,59,180,5,0,443,69,112,0,56,118,8,0,363
2016,Cameroon,Djalingo : Point,11,33,0,34,87,14,0,179,5,36,0,49,66,10,0,166
2016,Cameroon,Djallo,9,30,0,18,48,3,0,108,8,32,0,22,18,3,0,83
2016,Cameroon,Djaoro Mone,34,95,0,53,130,8,0,320,28,69,0,62,54,6,0,219
2016,Cameroon,Djohong : Point,12,61,0,44,126,6,0,249,16,61,0,43,101,14,0,235
2016,Cameroon,Dompla,144,298,0,128,424,21,0,1015,178,308,0,126,334,20,0,966
2016,Cameroon,Dompta,91,128,0,64,236,10,0,529,94,162,0,62,160,10,0,488
2016,Cameroon,Dondoube,6,32,0,19,43,1,0,101,12,20,0,12,20,4,0,68
2016,Cameroon,Douala : Point,663,802,0,495,2244,66,0,4270,660,776,0,445,2409,38,0,4328
2016,Cameroon,Dschang,1,2,0,1,4,0,0,8,1,1,0,1,5,0,0,8
2016,Cameroon,Ebolowa,1,0,0,3,4,0,0,8,2,0,0,0,7,0,0,9
2016,Cameroon,Edea,2,0,0,0,1,0,0,3,0,2,0,0,1,0,0,3
2016,Cameroon,Eseka,0,0,0,0,0,0,0,0,2,0,0,0,2,0,0,4
2016,Cameroon,Fada : Point,26,66,0,49,139,7,0,287,34,83,0,62,80,19,0,278
2016,Cameroon,Fokoue,0,0,0,0,0,0,0,0,0,0,0,0,1,0,0,1
2016,Cameroon,Foumbam,1,0,0,0,1,0,0,2,0,0,0,0,1,0,0,1
2016,Cameroon,Gadji Foulbe,1,5,0,1,3,0,0,10,4,2,0,0,3,0,0,9
2016,Cameroon,Gado Badzere,2234,3409,0,1630,5955,336,0,13564,2305,3361,0,1605,4222,425,0,11918
2016,Cameroon,Gado Badzere : Point,50,92,0,65,192,26,0,425,40,92,0,79,126,24,0,361
2016,Cameroon,Gaina,11,34,0,22,64,6,0,137,13,55,0,16,33,12,0,129
2016,Cameroon,Gandinang : Point,0,1,0,1,5,2,0,9,0,3,0,2,4,0,0,9
2016,Cameroon,Gandong,11,27,0,12,46,1,0,97,11,31,0,14,23,3,0,82
2016,Cameroon,Garga Libona : Point,89,192,0,175,412,28,0,896,74,218,0,201,267,28,0,788
2016,Cameroon,Garga Sarali : Point,134,205,0,128,411,34,0,912,122,250,0,120,306,36,0,834
2016,Cameroon,Gargapela : Point,125,262,0,161,407,41,0,996,115,292,0,167,272,30,0,876
2016,Cameroon,Gari Gombo,57,113,0,79,211,15,0,475,65,139,0,64,205,15,0,488
2016,Cameroon,Garoua,5,13,0,6,24,2,0,50,9,15,0,5,75,7,0,111
2016,Cameroon,Garoua-Boulai : Point,851,2765,0,2127,5565,403,0,11711,949,2635,0,2083,3443,431,0,9541
2016,Cameroon,Gbabio,7,7,0,2,20,1,0,37,13,11,0,2,17,0,0,43
2016,Cameroon,Gbakim : Point,5,39,0,45,111,4,0,204,9,34,0,35,100,13,0,191
2016,Cameroon,Gbata,12,28,0,14,41,2,0,97,14,23,0,18,17,4,0,76
2016,Cameroon,Gbatoua Godole,216,486,0,381,815,88,0,1986,192,463,0,351,522,84,0,1612
2016,Cameroon,Gbiti : Point,442,1770,0,1287,3660,204,0,7363,424,1751,0,1261,2793,330,0,6559
2016,Cameroon,Gomana,7,26,0,34,55,3,0,125,8,40,0,35,32,3,0,118
2016,Cameroon,Goro,28,113,0,93,186,12,0,432,24,102,0,85,131,21,0,363
2016,Cameroon,Goundjel : Point,0,3,0,3,13,0,0,19,0,1,0,2,14,0,0,17
2016,Cameroon,Gribi,3,7,0,1,9,0,0,20,1,3,0,0,6,3,0,13
2016,Cameroon,Guiwa Yangamo : Point,161,296,0,179,570,40,0,1246,200,305,0,174,502,44,0,1225
2016,Cameroon,Helbao,35,76,0,35,117,9,0,272,48,82,0,25,62,7,0,224
2016,Cameroon,Jericho,7,30,0,18,44,0,0,99,5,35,0,13,31,4,0,88
2016,Cameroon,Kambele,23,61,0,45,93,12,0,234,23,56,0,36,97,10,0,222
2016,Cameroon,Kela Sami,2,9,0,4,5,0,0,20,2,6,0,3,0,0,0,11
2016,Cameroon,Kenzou : Point,492,1395,0,1057,2894,160,0,5998,456,1386,0,1043,2267,232,0,5384
2016,Cameroon,Kette : Point,150,542,0,443,1147,63,0,2345,141,603,0,392,774,106,0,2016
2016,Cameroon,Kombo Laka : Point,107,203,0,136,405,26,0,877,121,239,0,123,419,38,0,940
2016,Cameroon,Komboul,15,35,0,22,49,1,0,122,14,38,0,19,30,2,0,103
2016,Cameroon,Kouba : Point,4,64,0,69,130,10,0,277,9,51,0,59,76,19,0,214
2016,Cameroon,Kounde,7,12,0,10,15,2,0,46,5,10,0,5,7,1,0,28
2016,Cameroon,Kribi,1,1,0,0,1,0,0,3,1,0,0,0,8,0,0,9
2016,Cameroon,Kwele,49,166,0,100,312,24,0,651,44,162,0,112,191,25,0,534
2016,Cameroon,Lamou,6,7,0,4,20,2,0,39,6,17,0,5,16,1,0,45
2016,Cameroon,Libongo,74,211,0,105,362,10,0,762,101,187,0,96,318,27,0,729
2016,Cameroon,Limbe,1,0,0,0,0,0,0,1,0,0,0,0,2,0,0,2
2016,Cameroon,Lokoti : Point,69,201,0,103,318,20,0,711,79,150,0,121,231,35,0,616
2016,Cameroon,Lolo,954,1457,0,777,2742,192,0,6122,931,1433,0,783,2508,265,0,5920
2016,Cameroon,Makak,0,0,0,0,1,0,0,1,0,0,0,0,0,0,0,0
2016,Cameroon,Man Regara,56,128,0,75,189,11,0,459,67,106,0,48,124,9,0,354
2016,Cameroon,Mandjou : Point,514,1340,0,937,2435,166,0,5392,516,1313,0,932,1628,160,0,4549
2016,Cameroon,Maroua,0,0,0,0,0,0,0,0,0,0,0,0,0,1,0,1
2016,Cameroon,Mbai-Mboum,501,884,0,487,1461,97,0,3430,532,933,0,462,1029,106,0,3062
2016,Cameroon,Mbale,3,5,0,4,5,0,0,17,2,5,0,0,0,0,0,7
2016,Cameroon,Mbalmayo,2,6,0,2,8,0,0,18,1,1,0,2,7,0,0,11
2016,Cameroon,Mbarang : Point,60,113,0,111,209,16,0,509,59,131,0,86,139,20,0,435
2016,Cameroon,Mbewe : Point,18,28,0,18,52,10,0,126,14,27,0,14,35,5,0,95
2016,Cameroon,Mbile,910,1463,0,694,2765,159,0,5991,929,1468,0,763,2580,230,0,5970
2016,Cameroon,Mbile : Point,17,65,0,90,212,15,0,399,11,55,0,70,159,18,0,313
2016,Cameroon,Mbodo,7,19,0,6,25,2,0,59,6,13,0,8,9,3,0,39
2016,Cameroon,Mbomba,1,7,0,8,14,1,0,31,3,8,0,9,8,4,0,32
2016,Cameroon,Mbombete,27,77,0,40,104,6,0,254,39,74,0,32,115,20,0,280
2016,Cameroon,Mbondo : Point,16,60,0,78,142,13,0,309,20,70,0,63,120,18,0,291
2016,Cameroon,Mbonga : Point,16,61,0,59,158,5,0,299,10,74,0,61,128,20,0,293
2016,Cameroon,Mborguene : Point,6,79,0,61,162,7,0,315,10,66,0,77,160,11,0,324
2016,Cameroon,Mbouda,0,0,0,0,0,0,0,0,0,0,0,0,1,0,0,1
2016,Cameroon,Mboula : Point,3,42,0,59,133,10,0,247,1,58,0,54,87,26,0,226
2016,Cameroon,Mbouma,10,31,0,11,40,2,0,94,11,20,0,13,33,3,0,80
2016,Cameroon,Mboumama : Point,32,197,0,147,402,22,0,800,35,194,0,140,282,46,0,697
2016,Cameroon,Mboy,10,13,0,10,18,0,0,51,9,8,0,7,61,5,0,90
2016,Cameroon,Meidougou : Point,229,499,0,413,1040,90,0,2271,237,514,0,407,637,95,0,1890
2016,Cameroon,Meiganga : Point,243,730,0,585,1389,95,0,3042,225,741,0,633,849,109,0,2557
2016,Cameroon,Mengang,0,0,0,0,0,0,0,0,0,0,0,0,1,0,0,1
2016,Cameroon,Mikila : Point,34,99,0,72,176,9,0,390,48,107,0,71,112,15,0,353
2016,Cameroon,Mimbang : Point,0,2,0,8,22,1,0,33,0,5,0,5,24,5,0,39
2016,Cameroon,Minawao,6313,8233,0,4038,12153,1211,0,31948,6489,8261,0,4044,7949,1384,0,28127
2016,Cameroon,Mobe : Point,31,77,0,63,146,10,0,327,22,88,0,70,95,11,0,286
2016,Cameroon,Moinam,6,11,0,13,29,2,0,61,0,20,0,10,21,5,0,56
2016,Cameroon,Mombal,4,11,0,6,11,1,0,33,3,13,0,2,7,0,0,25
2016,Cameroon,Monatele,0,0,0,0,0,0,0,0,0,0,0,0,1,0,0,1
2016,Cameroon,Muyuka,0,0,0,0,0,0,0,0,0,0,0,0,1,0,0,1
2016,Cameroon,Nabemo : Point,72,104,0,92,239,15,0,522,77,132,0,96,204,21,0,530
2016,Cameroon,Nandoungue : Point,38,164,0,160,329,35,0,726,40,172,0,140,225,30,0,607
2016,Cameroon,Nanga-Eboko,1,0,0,2,2,0,0,5,0,1,0,0,3,0,0,4
2016,Cameroon,Nd??l??l??,2,12,0,6,11,0,0,31,5,8,0,9,12,1,0,35
2016,Cameroon,Ndanga Gandima : Point,99,225,0,130,366,37,0,857,114,179,0,137,242,36,0,708
2016,Cameroon,Ndokayo : Point,376,1145,0,833,1951,147,0,4452,344,1127,0,789,1363,159,0,3782
2016,Cameroon,Ngam,688,1053,0,498,1661,81,0,3981,708,1051,0,436,1136,119,0,3450
2016,Cameroon,Ngaoui : Point,616,1390,0,1167,2779,217,0,6169,647,1523,0,1150,1664,226,0,5210
2016,Cameroon,Ngaoundal,10,24,0,8,27,2,0,71,9,26,0,9,10,1,0,55
2016,Cameroon,Ngaoundere,68,148,0,106,295,28,0,645,57,149,0,101,154,14,0,475
2016,Cameroon,Ngarisingo,86,165,0,88,250,16,0,605,90,149,0,91,251,40,0,621
2016,Cameroon,Ngazi : Point,10,30,0,10,45,3,0,98,5,22,0,12,29,1,0,69
2016,Cameroon,Ngoura,2,1,0,0,4,0,0,7,1,2,0,1,15,0,0,19
2016,Cameroon,Nguindi : Point,10,59,0,54,148,5,0,276,12,56,0,45,87,13,0,213
2016,Cameroon,Ngunbela : Point,10,14,0,12,24,2,0,62,9,9,0,14,25,2,0,59
2016,Cameroon,Nkolmetet,0,1,0,1,0,0,0,2,1,0,0,0,1,0,0,2
2016,Cameroon,Nkongsamba,0,1,0,0,1,0,0,2,1,0,0,0,2,0,0,3
2016,Cameroon,Nkoteng,2,1,0,0,2,0,0,5,0,1,0,1,2,0,0,4
2016,Cameroon,Nyabi : Point,48,335,0,370,960,72,0,1785,60,341,0,304,645,81,0,1431
2016,Cameroon,Nyambaka,6,24,0,27,46,5,0,108,7,30,0,31,30,6,0,104
2016,Cameroon,Obala,1,3,0,3,6,0,0,13,5,4,0,0,11,0,0,20
2016,Cameroon,Ouli,4,8,0,6,18,0,0,36,3,21,0,11,19,0,0,54
2016,Cameroon,Oundjiki,1,6,0,0,5,0,0,12,0,6,0,0,12,1,0,19
2016,Cameroon,Ouro Idje,8,20,0,14,29,1,0,72,7,21,0,7,20,0,0,55
2016,Cameroon,Ouro Souley,62,85,0,35,142,6,0,330,49,87,0,38,77,6,0,257
2016,Cameroon,Ouro-Adde : Point,106,263,0,179,435,37,0,1020,114,297,0,179,279,23,0,892
2016,Cameroon,Pana,2,12,0,11,14,0,0,39,0,4,0,6,10,3,0,23
2016,Cameroon,Petit Ngaoundere,31,57,0,37,79,3,0,207,38,59,0,29,40,3,0,169
2016,Cameroon,Roblin,2,4,0,3,10,1,0,20,2,2,0,2,2,1,0,9
2016,Cameroon,Roma,4,17,0,6,22,1,0,50,3,20,0,19,15,0,0,57
2016,Cameroon,Samba : Point,26,86,0,70,147,16,0,345,31,78,0,46,91,17,0,263
2016,Cameroon,Sandaye : Point,5,27,0,22,54,2,0,110,5,26,0,23,49,4,0,107
2016,Cameroon,Sandji,6,50,0,43,103,6,0,208,3,56,0,40,76,11,0,186
2016,Cameroon,Sandji II,7,26,0,7,38,3,0,81,6,22,0,10,43,0,0,81
2016,Cameroon,Sangmelima,0,0,0,0,0,0,0,0,0,0,0,0,3,0,0,3
2016,Cameroon,Simi,5,36,0,26,43,6,0,116,5,32,0,25,25,4,0,91
2016,Cameroon,Sodenou,7,68,0,45,103,9,0,232,9,60,0,46,78,7,0,200
2016,Cameroon,Sodepa,7,33,0,13,48,3,0,104,7,29,0,19,36,3,0,94
2016,Cameroon,Sourma,2,16,0,4,26,0,0,48,4,17,0,4,4,1,0,30
2016,Cameroon,Tapare : Point,8,31,0,31,71,6,0,147,8,41,0,37,45,9,0,140
2016,Cameroon,Tikolo,6,16,0,9,20,0,0,51,8,17,0,8,14,4,0,51
2016,Cameroon,Timangolo,512,856,0,514,1573,87,0,3542,507,906,0,504,1415,125,0,3457
2016,Cameroon,Timangolo : Point,36,80,0,58,185,22,0,381,41,76,0,63,134,22,0,336
2016,Cameroon,Tocktoyo,78,402,0,324,831,47,0,1682,82,421,0,327,581,90,0,1501
2016,Cameroon,Tongo Gandima : Point,285,513,0,289,936,97,0,2120,277,529,0,318,587,123,0,1834
2016,Cameroon,Touboro,21,35,0,13,48,3,0,120,23,24,0,12,27,4,0,90
2016,Cameroon,Wissambo,1,0,0,0,1,0,0,2,0,0,0,1,3,0,0,4
2016,Cameroon,Woumbou : Point,67,213,0,137,362,21,0,800,59,200,0,145,242,27,0,673
2016,Cameroon,Yamba : Point,169,356,0,261,633,54,0,1473,183,392,0,262,461,62,0,1360
2016,Cameroon,Yaounde : Point,1103,1147,0,800,2906,97,0,6053,1110,1054,0,657,3719,88,0,6628
2016,Cameroon,Yarmbang : Point,86,257,0,175,398,38,0,954,99,254,0,155,210,28,0,746
2016,Cameroon,Yokadouma,86,149,0,88,325,11,0,659,78,141,0,84,395,28,0,726
2016,Cameroon,Yokosire : Point,40,169,0,146,371,35,0,761,49,154,0,173,235,42,0,653
2016,Cameroon,Yola,16,24,0,8,39,3,0,90,10,31,0,15,44,2,0,102
2016,Cameroon,Zamboi,19,52,0,30,77,3,0,181,14,71,0,32,46,9,0,172
2016,Cameroon,Zembe Borongo : Point,122,353,0,328,796,64,0,1663,117,371,0,348,504,72,0,1412
2016,Cameroon,Far-North : Dispersed in the territory,30908,28434,0,22254,37089,4945,0,123630,28852,27649,0,25246,32458,6010,0,120215
2016,Dem. Rep. of the Congo,Aba : Point,17,8,0,8,37,7,0,77,12,9,0,11,37,3,0,72
2016,Dem. Rep. of the Congo,Aga,1883,2168,0,1117,2708,138,0,8014,1764,2170,0,1116,1764,96,0,6910
2016,Dem. Rep. of the Congo,Ariwara : Point,66,111,0,54,138,10,0,379,57,93,0,34,110,16,0,310
2016,Dem. Rep. of the Congo,Aru : Point,0,4,0,1,4,0,0,9,2,4,0,2,6,2,0,16
2016,Dem. Rep. of the Congo,Bangalu,82,90,0,53,213,16,0,454,80,83,0,49,162,13,0,387
2016,Dem. Rep. of the Congo,Bas -Fleuve,33,34,0,35,71,4,0,177,21,38,0,28,96,40,0,223
2016,Dem. Rep. of the Congo,Biaka/Kotakoli,594,594,0,160,1010,37,0,2395,575,633,0,106,644,23,0,1981
2016,Dem. Rep. of the Congo,Bikoro,0,0,0,0,0,0,0,0,2,2,0,1,1,0,0,6
2016,Dem. Rep. of the Congo,BILI(camp),1118,1185,0,363,1542,108,0,4316,1152,1271,0,480,1658,89,0,4650
2016,Dem. Rep. of the Congo,Biringi,92,72,0,59,136,5,0,364,89,96,0,57,228,10,0,480
2016,Dem. Rep. of the Congo,Bitima,93,77,0,35,144,4,0,353,110,79,0,30,86,3,0,308
2016,Dem. Rep. of the Congo,Bokungu,3,2,0,0,2,0,0,7,2,3,0,0,2,0,0,7
2016,Dem. Rep. of the Congo,Bolomba,3,1,0,1,2,0,0,7,2,2,0,2,2,0,0,8
2016,Dem. Rep. of the Congo,Bomongo,0,0,0,0,0,0,0,0,0,0,0,0,2,0,0,2
2016,Dem. Rep. of the Congo,Bondo : Point,1300,1305,0,625,2462,185,0,5877,1217,1299,0,655,1719,152,0,5042
2016,Dem. Rep. of the Congo,Bosobolo,1250,1241,0,403,2562,139,0,5595,1135,1076,0,220,1180,53,0,3664
2016,Dem. Rep. of the Congo,Boyabu,2158,2505,0,1082,3871,223,0,9839,2136,2414,0,1094,2008,77,0,7729
2016,Dem. Rep. of the Congo,Bukavu : Point,91,129,0,56,249,9,0,534,87,139,0,86,189,13,0,514
2016,Dem. Rep. of the Congo,Buta : Point,2,3,0,5,7,0,0,17,4,4,0,2,6,1,0,17
2016,Dem. Rep. of the Congo,Dilolo : Point,58,70,0,46,78,7,0,259,54,86,0,62,69,5,0,276
2016,Dem. Rep. of the Congo,Doruma : Point,865,714,0,412,1303,102,0,3396,793,769,0,374,698,71,0,2705
2016,Dem. Rep. of the Congo,Dungu : Point,1624,1835,0,954,2487,321,0,7221,1745,1912,0,1160,1913,137,0,6867
2016,Dem. Rep. of the Congo,Duru,32,13,0,4,43,2,0,94,21,15,0,4,28,1,0,69
2016,Dem. Rep. of the Congo,Fizi : Point,333,353,0,145,711,38,0,1580,313,373,0,152,845,76,0,1759
2016,Dem. Rep. of the Congo,Fungurume,2,3,0,3,6,0,0,14,3,4,0,3,9,0,0,19
2016,Dem. Rep. of the Congo,Gangala,126,117,0,59,206,19,0,527,119,116,0,62,120,17,0,434
2016,Dem. Rep. of the Congo,Gemena,101,122,0,64,183,9,0,479,106,125,0,40,130,2,0,403
2016,Dem. Rep. of the Congo,Goma : Point,95,166,0,124,316,3,0,704,97,114,0,127,348,4,0,690
2016,Dem. Rep. of the Congo,Hamba,2,1,0,2,0,0,0,5,0,1,0,5,1,1,0,8
2016,Dem. Rep. of the Congo,Haut-Uele : District,119,222,0,154,286,22,0,803,149,203,0,152,184,9,0,697
2016,Dem. Rep. of the Congo,Idjwi: Territoire,112,122,0,64,229,23,0,550,114,153,0,61,78,23,0,429
2016,Dem. Rep. of the Congo,Ingbokolo : Point,1119,1306,0,664,2123,116,0,5328,1041,1233,0,489,905,52,0,3720
2016,Dem. Rep. of the Congo,Inke,1611,2101,0,902,2720,202,0,7536,1639,2098,0,1107,2161,115,0,7120
2016,Dem. Rep. of the Congo,Isiro : Point,4,3,0,7,14,1,0,29,2,5,0,5,18,0,0,30
2016,Dem. Rep. of the Congo,Ituri : District,23285,29580,0,15857,45029,5816,0,119567,22332,31115,0,16095,36749,4142,0,110433
2016,Dem. Rep. of the Congo,Kabalo,38,42,0,13,49,0,0,142,37,52,0,14,49,2,0,154
2016,Dem. Rep. of the Congo,Kailo,1,1,0,5,11,0,0,18,1,0,0,0,4,0,0,5
2016,Dem. Rep. of the Congo,Kakanda,0,1,0,3,2,0,0,6,0,1,0,0,2,0,0,3
2016,Dem. Rep. of the Congo,Kalehe : Point,1004,1247,0,714,1503,49,0,4517,862,1216,0,681,1325,69,0,4153
2016,Dem. Rep. of the Congo,Kalemie : Point,56,76,0,27,87,3,0,249,38,65,0,32,109,1,0,245
2016,Dem. Rep. of the Congo,Kambove : Territoire,5,9,0,2,9,0,0,25,3,4,0,3,11,1,0,22
2016,Dem. Rep. of the Congo,Kapata,7,10,0,4,15,2,0,38,7,6,0,7,20,3,0,43
2016,Dem. Rep. of the Congo,Kasaji,2,5,0,5,1,0,0,13,4,1,0,5,1,0,0,11
2016,Dem. Rep. of the Congo,Kasongo,10,13,0,8,37,2,0,70,16,16,0,7,39,2,0,80
2016,Dem. Rep. of the Congo,Kasumabalesa,1,5,0,5,6,0,0,17,6,3,0,3,5,0,0,17
2016,Dem. Rep. of the Congo,Katanda,3,2,0,3,4,0,0,12,1,1,0,1,7,1,0,11
2016,Dem. Rep. of the Congo,Katanga : Province,78310,102762,0,48198,155706,13912,0,398888,81163,103660,0,51912,120876,8501,0,366112
2016,Dem. Rep. of the Congo,Katshia : Point,24,28,0,51,50,4,0,157,25,34,0,47,35,13,0,154
2016,Dem. Rep. of the Congo,Kendriyo,1707,2296,0,1217,2713,133,0,8066,1728,2474,0,1333,1997,100,0,7632
2016,Dem. Rep. of the Congo,Kimaza : Point,24,36,0,48,36,4,0,148,21,36,0,34,24,3,0,118
2016,Dem. Rep. of the Congo,Kinshasa : Province,67,101,0,86,177,10,0,441,48,91,0,105,265,20,0,529
2016,Dem. Rep. of the Congo,Kipushi,3,11,0,8,20,5,0,47,7,15,0,4,18,6,0,50
2016,Dem. Rep. of the Congo,Kisenge,10,14,0,12,21,0,0,57,14,14,0,11,6,0,0,45
2016,Dem. Rep. of the Congo,Kolwezi,6,9,0,3,11,0,0,29,4,7,0,3,17,0,0,31
2016,Dem. Rep. of the Congo,Kongolo,15,12,0,5,31,1,0,64,10,16,0,9,30,1,0,66
2016,Dem. Rep. of the Congo,Libenge,567,546,0,244,805,48,0,2210,570,541,0,228,542,30,0,1911
2016,Dem. Rep. of the Congo,Likasi : City,0,0,0,0,0,1,0,1,0,0,0,0,0,0,0,0
2016,Dem. Rep. of the Congo,Loukolela,17,18,0,7,26,0,0,68,18,24,0,13,44,0,0,99
2016,Dem. Rep. of the Congo,Lubero : Point,838,1008,0,694,1233,71,0,3844,731,1041,0,752,1156,87,0,3767
2016,Dem. Rep. of the Congo,Lubumbashi : Point,235,289,0,337,429,35,0,1325,247,315,0,330,746,16,0,1654
2016,Dem. Rep. of the Congo,Lukolo,25,16,0,6,60,1,0,108,31,15,0,6,102,3,0,157
2016,Dem. Rep. of the Congo,Luputa,5,10,0,13,6,1,0,35,6,7,0,9,12,1,0,35
2016,Dem. Rep. of the Congo,Lusenda (camp),3164,2876,0,1175,5392,200,0,12807,3206,2945,0,1184,4628,150,0,12113
2016,Dem. Rep. of the Congo,Lusuku : Point,6,12,0,32,14,0,0,64,17,13,0,27,28,2,0,87
2016,Dem. Rep. of the Congo,Mahola,22,18,0,30,27,1,0,98,13,14,0,41,30,1,0,99
2016,Dem. Rep. of the Congo,Makanza,0,0,0,0,0,0,0,0,0,0,0,0,1,0,0,1
2016,Dem. Rep. of the Congo,Maniema : Province,18721,24973,0,12164,37338,3998,0,97194,18778,22789,0,13000,30402,2837,0,87806
2016,Dem. Rep. of the Congo,Manono,24,31,0,6,40,0,0,101,28,28,0,6,43,0,0,105
2016,Dem. Rep. of the Congo,Masisi : Point,9336,11234,0,7730,13739,805,0,42844,8144,11609,0,8377,12880,971,0,41981
2016,Dem. Rep. of the Congo,Mbandaka,14,15,0,10,22,0,0,61,16,25,0,10,38,1,0,90
2016,Dem. Rep. of the Congo,Mbanza Ngungu,10,27,0,35,16,0,0,88,15,31,0,88,63,4,0,201
2016,Dem. Rep. of the Congo,Mboti,102,54,0,35,116,5,0,312,97,64,0,43,178,10,0,392
2016,Dem. Rep. of the Congo,Meri,1483,1680,0,922,2231,278,0,6594,1463,1712,0,919,1774,146,0,6014
2016,Dem. Rep. of the Congo,Mobayi Mbongo,260,195,0,70,344,15,0,884,265,207,0,97,318,19,0,906
2016,Dem. Rep. of the Congo,Mogoroko,20,9,0,5,27,1,0,62,15,10,0,8,14,1,0,48
2016,Dem. Rep. of the Congo,Mogoroko1,1,2,0,3,10,0,0,16,1,2,0,1,5,4,0,13
2016,Dem. Rep. of the Congo,Mokambo,2,0,0,0,5,0,0,7,2,3,0,2,4,0,0,11
2016,Dem. Rep. of the Congo,Mole,1778,2154,0,986,3216,130,0,8264,1742,1893,0,1004,2000,67,0,6706
2016,Dem. Rep. of the Congo,Mosombo,110,95,0,31,227,30,0,493,98,75,0,43,169,45,0,430
2016,Dem. Rep. of the Congo,Musonoie,2,1,0,2,4,2,0,11,1,1,0,1,5,1,0,9
2016,Dem. Rep. of the Congo,Mwene Ditu : Point,3,2,0,6,5,0,0,16,1,3,0,8,10,1,0,23
2016,Dem. Rep. of the Congo,Mwenga : Point,2805,3489,0,2010,4208,128,0,12640,2426,3423,0,1916,3719,193,0,11677
2016,Dem. Rep. of the Congo,Niangara,5,6,0,3,15,2,0,31,3,11,0,4,15,1,0,34
2016,Dem. Rep. of the Congo,Nord Ubangi,1206,1307,0,518,1982,116,0,5129,1131,1322,0,572,2290,101,0,5416
2016,Dem. Rep. of the Congo,Nord-Kivu : Province,115805,153059,0,73347,222331,21520,0,586062,116154,150949,0,76864,174491,13480,0,531938
2016,Dem. Rep. of the Congo,Nyunzu,4,4,0,7,9,0,0,24,3,4,0,2,6,0,0,15
2016,Dem. Rep. of the Congo,Pangi,4,3,0,1,5,0,0,13,3,9,0,3,6,0,0,21
2016,Dem. Rep. of the Congo,Rutshuru : Point,6843,8234,0,5666,10070,591,0,31404,5969,8509,0,6141,9441,711,0,30771
2016,Dem. Rep. of the Congo,Sakania,0,1,0,1,2,0,0,4,0,4,0,1,1,0,0,6
2016,Dem. Rep. of the Congo,Sandoa,6,15,0,8,14,0,0,43,12,15,0,7,20,0,0,54
2016,Dem. Rep. of the Congo,Sud Ubangi,5,5,0,2,10,1,0,23,2,2,0,0,12,0,0,16
2016,Dem. Rep. of the Congo,Sud-Kivu : Province,50687,71919,0,31608,103887,10757,0,268858,52784,73956,0,33770,86398,5082,0,251990
2016,Dem. Rep. of the Congo,Sugba,228,219,0,119,468,35,0,1069,235,207,0,103,283,14,0,842
2016,Dem. Rep. of the Congo,Tshabobo : Point,20,35,0,66,52,2,0,175,32,36,0,61,47,12,0,188
2016,Dem. Rep. of the Congo,Tshopo : District,4488,4380,0,2293,7150,597,0,18908,4395,4530,0,2378,7244,545,0,19092
2016,Dem. Rep. of the Congo,Uvira : Point,594,765,0,431,976,45,0,2811,516,742,0,402,832,59,0,2551
2016,Dem. Rep. of the Congo,Walikale : Point,4894,5888,0,4050,7195,422,0,22449,4268,6088,0,4390,6749,509,0,22004
2016,Dem. Rep. of the Congo,Wikong,6,9,0,16,17,0,0,48,5,7,0,13,7,1,0,33
2016,Dem. Rep. of the Congo,Zongo Villages,462,472,0,171,765,33,0,1903,457,458,0,157,508,19,0,1599
2016,Congo,Betou : Point,2636,2361,0,1328,4970,241,0,11536,2541,2301,0,1333,4565,197,0,10937
2016,Congo,Bouenza,0,0,0,2,1,0,0,3,0,2,0,0,9,0,0,11
2016,Congo,Brazzaville : Capital,792,1218,0,926,3433,81,0,6450,856,1236,0,875,5398,82,0,8447
2016,Congo,Dolisie: Point,0,0,0,1,0,0,0,1,0,2,0,2,14,0,0,18
2016,Congo,Ewo : District,3,1,0,1,3,0,0,8,1,3,0,2,13,0,0,19
2016,Congo,Impfondo : Point,687,1029,0,692,2051,174,0,4633,710,1115,0,656,2097,128,0,4706
2016,Congo,Komi : Point,6,4,0,4,12,3,0,29,1,6,0,4,18,2,0,31
2016,Congo,Kondi Mbaka : Point,14,16,0,5,35,2,0,72,7,17,0,14,60,11,0,109
2016,Congo,Loukolela : Point,162,311,0,191,513,19,0,1196,162,325,0,208,617,36,0,1348
2016,Congo,Malolo : Point,8,30,0,15,53,10,0,116,14,25,0,19,36,9,0,103
2016,Congo,Ngo : Point,40,63,0,47,80,1,0,231,50,81,0,43,215,6,0,395
2016,Congo,Oyo : Point,29,52,0,43,80,2,0,206,31,51,0,53,173,5,0,313
2016,Congo,Pointe Noire : Point,135,163,0,93,444,9,0,844,135,142,0,76,1135,15,0,1503
2016,Congo,Pool : Departement,1082,1328,0,1907,4684,777,0,9778,938,1188,0,1307,2824,451,0,6708
2016,Congo,Sangha : Departement,112,184,0,155,385,9,0,845,102,159,0,140,586,14,0,1001
2016,Colombia,Arauca,1,2,0,1,5,0,0,9,2,2,0,1,6,0,0,11
2016,Colombia,Barcelona : Point,0,0,0,0,0,0,0,0,0,0,0,0,1,0,0,1
2016,Colombia,Barranquilla,0,1,0,0,4,0,0,5,0,1,0,0,1,0,0,2
2016,Colombia,Bogota : Capital district,10,17,0,17,87,11,0,142,15,10,0,13,191,14,0,243
2016,Colombia,Bucaramanga : Municipality,0,0,0,0,1,0,0,1,0,0,0,0,6,0,0,6
2016,Colombia,Buenaventura : Point,0,0,0,0,0,0,0,0,0,0,0,0,2,0,0,2
2016,Colombia,C??cuta : Point,2,2,0,2,19,1,0,26,3,3,0,2,24,1,0,33
2016,Colombia,Cali : Point,0,1,0,1,2,0,0,4,0,0,0,0,6,2,0,8
2016,Colombia,Cartagena : Point,0,0,0,0,3,1,0,4,1,0,0,0,12,0,0,13
2016,Colombia,Duitama : Point,0,0,0,0,0,1,0,1,0,0,0,0,0,0,0,0
2016,Colombia,Ibagu?? : Point,0,0,0,0,4,0,0,4,0,0,0,2,3,0,0,5
2016,Colombia,Icononzo,1,0,0,0,1,0,0,2,0,1,0,0,1,0,0,2
2016,Colombia,Leticia : Municipality,0,0,0,0,1,0,0,1,0,0,0,0,2,0,0,2
2016,Colombia,Maicao : Point,0,0,0,0,2,0,0,2,1,2,0,0,2,0,0,5
2016,Colombia,Medell?¡n : Point,1,0,0,0,4,1,0,6,0,3,0,2,11,0,0,16
2016,Colombia,Monteria,0,0,0,0,0,0,0,0,0,0,0,0,1,0,0,1
2016,Colombia,Pamplona,0,0,0,0,1,0,0,1,0,0,0,0,0,0,0,0
2016,Colombia,Pasto,1,0,0,0,1,0,0,2,0,0,0,0,2,0,0,2
2016,Colombia,Pereira : Municipality,0,0,0,0,2,0,0,2,0,0,0,0,1,0,0,1
2016,Colombia,Puerto Legu?¡zamo,0,0,0,0,0,0,0,0,0,0,0,0,1,0,0,1
2016,Colombia,San Andres Islas : Department,0,0,0,0,1,1,0,2,0,0,0,0,3,1,0,4
2016,Colombia,Tulu?â?í : Point,0,0,0,0,0,0,0,0,0,0,0,0,1,0,0,1
2016,Colombia,Tulu?í : Point,0,0,0,0,0,0,0,0,0,0,0,0,2,0,0,2
2016,Colombia,Tumaco : Municipality,0,1,0,0,1,0,0,2,0,1,0,1,0,0,0,2
2016,Colombia,Various,0,0,0,0,0,0,0,0,0,0,0,0,6,0,0,6
2016,Colombia,Villavicencio,0,0,0,0,3,0,0,3,0,0,0,0,1,0,0,1
2016,Colombia,Villeta,0,0,0,0,1,0,0,1,0,0,0,0,1,0,0,1
2016,Cabo Verde,Cabo Verde : Dispersed in the country/territory,0,0,0,0,0,0,0,0,0,0,0,0,0,0,0,0
2016,Costa Rica,Costa Rica : Dispersed in the country / territory,4,23,0,13,23,4,0,67,3,21,0,12,21,8,0,65
2016,Cuba,Artemisa : Provincia,0,0,0,0,0,0,0,0,0,0,0,0,1,0,0,1
2016,Cuba,Camaguey : Provincia,0,0,0,0,2,0,0,2,0,0,0,1,8,0,0,9
2016,Cuba,Ciego de Avila : Provincia,0,0,0,0,0,0,0,0,0,0,0,0,10,0,0,10
2016,Cuba,Cienfuegos : Provincia,0,0,0,0,0,0,0,0,0,0,0,0,27,0,0,27
2016,Cuba,Granma : Provincia,0,0,0,0,0,0,0,0,0,0,0,0,5,0,0,5
2016,Cuba,Guant?â?ínamo : Provincia,0,0,0,0,0,0,0,0,0,0,0,0,1,0,0,1
2016,Cuba,Guant?ínamo : Provincia,0,0,0,0,0,0,0,0,0,0,0,0,15,0,0,15
2016,Cuba,Holguin : Provincia,0,0,0,0,0,0,0,0,0,0,0,0,12,0,0,12
2016,Cuba,La Habana : Provincia,1,5,0,3,43,1,0,53,4,10,0,4,113,2,0,133
2016,Cuba,Las Tunas : Provincia,0,0,0,0,0,0,0,0,0,0,0,0,8,0,0,8
2016,Cuba,Matanzas : Provincia,0,0,0,1,4,0,0,5,0,1,0,0,7,0,0,8
2016,Cuba,Mayabeque : Provincia,0,0,0,0,0,0,0,0,0,0,0,0,3,0,0,3
2016,Cuba,Pinar del Rio : Provincia,0,3,0,0,1,0,0,4,0,0,0,0,16,0,0,16
2016,Cuba,Sancti Spiritus : Provincia,0,0,0,0,0,0,0,0,0,0,0,0,8,0,0,8
2016,Cuba,Santiago de Cuba : Provincia,0,0,0,0,2,0,0,2,0,0,0,0,2,0,0,2
2016,Cuba,Villa Clara : Provincia,0,0,0,0,0,0,0,0,1,1,0,0,1,0,0,3
2016,Cuba,Villaclara : Provincia,0,0,0,0,0,0,0,0,0,0,0,0,16,0,0,16
2016,Curaçao,Curacao : Dispersed in the country / territory,3,1,0,8,43,0,0,55,5,8,0,2,38,3,0,56
2016,Cayman Islands,Cayman Islands : Dispersed in the country / territory,0,0,0,0,6,0,0,6,0,0,0,0,12,0,0,12
2016,Cyprus,Cyprus : Dispersed in the country / territory,0,0,0,0,0,0,0,0,0,0,0,0,0,0,0,0
2016,Czech Rep.,Czech Republic : Dispersed in the country / territory,0,0,0,0,0,0,0,0,0,0,0,0,0,0,0,0
2016,Germany,Germany : Dispersed in the country / territory,53847,61034,0,38211,250067,18815,0,421974,58292,71268,0,84639,613177,19495,0,846871
2016,Djibouti,Ali-Addeh : Point,1188,1582,0,982,3868,244,0,7864,1212,1639,0,1047,3382,227,0,7507
2016,Djibouti,Djibouti : Point,198,377,0,275,1201,68,0,2119,199,392,0,310,1942,82,0,2925
2016,Djibouti,Hol-Hol : Point,235,455,0,295,852,40,0,1877,250,454,0,323,807,44,0,1878
2016,Djibouti,Obock : Pont,99,151,0,98,401,48,0,797,88,150,0,125,473,59,0,895
2016,Denmark,Denmark : Dispersed in the country / territory,0,0,0,0,0,0,0,0,0,0,0,0,0,0,0,0
2016,Dominican Rep.,Dominican Republic : Dispersed in the country / territory,10,106,0,103,435,32,0,686,18,101,0,93,427,63,0,702
2016,Algeria,Algiers : Wilaya - Province,14,12,0,7,36,0,0,69,14,11,0,13,120,2,0,160
2016,Algeria,Tindouf : Wilaya - Province,0,0,0,0,0,0,0,0,0,0,0,0,0,0,0,0
2016,Algeria,Algeria : Dispersed in the country / territory,338,400,0,266,1080,43,0,2127,357,465,0,279,2432,50,0,3583
2016,Ecuador,Ecuador : Dispersed in the country / territory,1343,2940,0,5199,17996,1158,0,28636,987,2864,0,3664,22385,1988,0,31888
2016,Egypt,6th October : Muhafazah - Governorate,1954,3189,0,2059,9462,826,0,17490,2064,3485,0,2339,10815,835,0,19538
2016,Egypt,Al Sharqia : Muhafazah - Governorate,519,855,0,492,2042,138,0,4046,529,867,0,530,2183,154,0,4263
2016,Egypt,Alexandria : Muhafazah - Governorate,1199,2150,0,1341,5869,508,0,11067,1281,2172,0,1472,5841,553,0,11319
2016,Egypt,Aswan : Muhafazah - Governorate,1,2,0,0,8,0,0,11,1,4,0,2,24,1,0,32
2016,Egypt,Asyut : Muhafazah - Governorate,21,35,0,27,80,3,0,166,26,33,0,20,80,6,0,165
2016,Egypt,Beni Suef : Muhafazah - Governorate,15,17,0,15,34,4,0,85,11,14,0,11,47,3,0,86
2016,Egypt,Cairo : Muhafazah - Governorate,2730,4514,0,3572,17830,784,0,29430,2823,4660,0,4038,18178,755,0,30454
2016,Egypt,Dakahliya : Muhafazah - Governorate,188,359,0,209,873,46,0,1675,195,428,0,222,902,67,0,1814
2016,Egypt,Damietta : Muhafazah - Governorate,507,877,0,581,2358,201,0,4524,567,924,0,616,2273,181,0,4561
2016,Egypt,El-Beheira : Muhafazah - Governorate,60,83,0,54,184,15,0,396,54,92,0,46,187,16,0,395
2016,Egypt,Fayoum : Muhafazah - Governorate,11,34,0,23,86,6,0,160,12,29,0,29,96,5,0,171
2016,Egypt,Gharbeya : Muhafazah - Governorate,49,87,0,44,254,22,0,456,56,92,0,71,249,29,0,497
2016,Egypt,Giza : Muhafazah - Governorate,956,1434,0,1362,6283,325,0,10360,1036,1473,0,1634,7375,342,0,11860
2016,Egypt,Helwan : Muhafazah - Governorate,231,372,0,344,2343,34,0,3324,268,383,0,327,1890,40,0,2908
2016,Egypt,Ismailia : Muhafazah - Governorate,56,77,0,53,228,8,0,422,58,93,0,54,261,14,0,480
2016,Egypt,Kalyobiya : Muhafazah - Governorate,876,1453,0,838,3650,278,0,7095,914,1510,0,900,3873,257,0,7454
2016,Egypt,Luxor : Muhafazah - Governorate,4,8,0,6,22,3,0,43,9,4,0,2,24,0,0,39
2016,Egypt,Matrouh : Muhafazah - Governorate,64,78,0,48,198,10,0,398,69,85,0,44,206,16,0,420
2016,Egypt,Menia : Muhafazah - Governorate,16,21,0,13,42,3,0,95,13,18,0,19,64,2,0,116
2016,Egypt,Monofiya : Muhafazah - Governorate,115,213,0,133,543,45,0,1049,124,256,0,172,514,50,0,1116
2016,Egypt,New Valley : Muhafazah - Governorate,0,0,0,0,0,0,0,0,0,0,0,0,2,0,0,2
2016,Egypt,North Sinai : Muhafazah - Governorate,5,8,0,2,12,0,0,27,1,4,0,4,13,1,0,23
2016,Egypt,Port-Said : Muhafazah - Governorate,25,60,0,43,161,15,0,304,25,56,0,33,143,18,0,275
2016,Egypt,Qena : Muhafazah - Governorate,3,5,0,8,19,2,0,37,5,4,0,6,28,1,0,44
2016,Egypt,Red Sea : Muhafazah - Governorate,39,81,0,48,180,16,0,364,35,70,0,37,174,21,0,337
2016,Egypt,Sohag : Muhafazah - Governorate,4,11,0,13,48,6,0,82,11,6,0,6,54,3,0,80
2016,Egypt,South Sinai : Muhafazah - Governorate,0,13,0,3,17,3,0,36,3,2,0,2,31,2,0,40
2016,Egypt,Suez : Muhafazah - Governorate,25,40,0,47,136,7,0,255,30,45,0,49,152,4,0,280
2016,Egypt,Kafr El Shiekh : Muhafazah - Governorate,38,65,0,33,140,12,0,288,42,60,0,42,146,14,0,304
2016,Egypt,Egypt : Dispersed in the country / territory,6323,8030,0,4986,13174,854,0,33367,7020,5081,0,10030,14596,574,0,37301
2016,Eritrea,Asmara : Point,3,2,0,1,7,0,0,13,0,2,0,4,11,0,0,17
2016,Eritrea,Emkulu : Point,186,275,0,162,421,15,0,1059,217,268,0,209,470,25,0,1189
2016,Eritrea,Gash Barka : Zoba - Region,6,12,0,2,16,0,0,36,3,12,0,6,29,2,0,52
2016,Spain,Spain : Dispersed in the country / territory,0,0,0,0,0,0,0,0,0,0,0,0,0,0,0,0
2016,Estonia,Estonia : Dispersed in the country / territory,0,0,0,0,0,0,0,0,0,0,0,0,0,0,0,0
2016,Ethiopia,Ad-Damazin Transit Centre : Point,36,370,0,173,617,66,0,1262,42,367,0,200,589,98,0,1296
2016,Ethiopia,Adiharush : Point,407,449,0,563,1632,11,0,3062,412,565,0,938,2766,36,0,4717
2016,Ethiopia,Akula Community : Point,203,181,0,97,380,17,0,878,178,242,0,91,187,12,0,710
2016,Ethiopia,Asaita : Point,642,1383,0,853,2664,227,0,5769,714,1561,0,1018,2434,270,0,5997
2016,Ethiopia,Awbarre : Point,1293,1425,0,1418,2835,229,0,7200,1323,1441,0,1425,2522,279,0,6990
2016,Ethiopia,Ayne-Deeb,209,690,0,522,1272,70,0,2763,176,666,0,448,328,90,0,1708
2016,Ethiopia,Bambasi Camp : Point,1961,1885,0,942,3016,277,0,8081,2028,1934,0,1122,2711,269,0,8064
2016,Ethiopia,Berhale : Point,508,1669,0,1005,1940,72,0,5194,548,1707,0,1074,1463,133,0,4925
2016,Ethiopia,Bokolmanyo : Point,2852,6644,0,4188,8397,483,0,22564,2915,6761,0,4496,5336,533,0,20041
2016,Ethiopia,Border areas (Gambella),0,0,0,0,0,0,0,0,0,0,0,0,0,0,0,0
2016,Ethiopia,Borena : Awrajja - Zone,330,385,0,313,811,146,0,1985,356,407,0,313,592,121,0,1789
2016,Ethiopia,Buramino : Point,1982,7853,0,3571,7697,445,0,21548,2105,7697,0,3762,4055,438,0,18057
2016,Ethiopia,Burbiey,0,0,0,0,0,0,0,0,0,0,0,0,0,0,0,0
2016,Ethiopia,Dalool,297,1118,0,741,1793,85,0,4034,296,1238,0,769,874,108,0,3285
2016,Ethiopia,Erebti,19,76,0,44,117,8,0,264,16,82,0,57,88,11,0,254
2016,Ethiopia,Hilaweyn : Point,3745,8197,0,3863,8285,450,0,24540,3901,8005,0,4049,4504,523,0,20982
2016,Ethiopia,Hitsats,328,503,0,436,2391,12,0,3670,353,537,0,1275,4717,28,0,6910
2016,Ethiopia,Jewi,6029,9553,0,4956,11681,547,0,32766,6254,9655,0,5531,2620,163,0,24223
2016,Ethiopia,Kebribeyah : Point,821,1308,0,1324,2734,138,0,6325,751,1334,0,1308,2014,97,0,5504
2016,Ethiopia,Kobe Camp : Point,3395,7876,0,3736,8066,627,0,23700,3456,7773,0,4180,5249,676,0,21334
2016,Ethiopia,Kule Camp,4118,7696,0,3625,11585,757,0,27781,4288,7599,0,4154,6937,314,0,23292
2016,Ethiopia,Mai-Ayni : Point,685,692,0,533,2158,21,0,4089,747,779,0,1283,3130,73,0,6012
2016,Ethiopia,Matar,0,0,0,0,0,0,0,0,0,0,0,0,0,0,0,0
2016,Ethiopia,Melkadida : Point,2650,4866,0,3078,5706,301,0,16601,2674,5013,0,3365,3587,376,0,15015
2016,Ethiopia,Nguenyyiel : Point,3245,2883,0,1545,6080,284,0,14037,2860,3865,0,1469,2990,178,0,11362
2016,Ethiopia,NyingNyang : Point,0,0,0,0,0,0,0,0,0,0,0,0,0,0,0,0
2016,Ethiopia,Okugo:Point,1037,1240,0,642,2341,203,0,5463,1091,1318,0,662,1177,66,0,4314
2016,Ethiopia,Pagak:Point,0,0,0,0,0,0,0,0,0,0,0,0,0,0,0,0
2016,Ethiopia,Pamdong:Point,0,0,0,0,0,0,0,0,0,0,0,0,0,0,0,0
2016,Ethiopia,Pugnido : Point,5932,9357,0,5076,13957,870,0,35192,6166,9661,0,5765,6863,228,0,28683
2016,Ethiopia,Pugnido2,2052,2642,0,884,3619,200,0,9397,2072,2701,0,1248,1309,69,0,7399
2016,Ethiopia,Sheder : Point,719,1332,0,1078,2614,141,0,5884,697,1347,0,1121,1764,73,0,5002
2016,Ethiopia,Sherkole : Point,1053,1357,0,809,2072,88,0,5379,1120,1482,0,935,2476,95,0,6108
2016,Ethiopia,Shimelba (Shire/Shiraro) : Point,367,436,0,274,1134,182,0,2393,348,453,0,305,1793,174,0,3073
2016,Ethiopia,Tierkidi:Point,6966,10833,0,5806,14935,786,0,39326,7055,10923,0,6519,5497,277,0,30271
2016,Ethiopia,Tongo Camp : Point,1205,1238,0,860,2283,193,0,5779,1294,1301,0,973,2251,203,0,6022
2016,Ethiopia,Tsore Camp : Point,874,1150,0,768,1829,92,0,4713,952,1249,0,1513,2345,97,0,6156
2016,Ethiopia,Urban OCPs,0,0,0,0,0,0,0,0,0,0,0,0,0,0,0,0
2016,Ethiopia,Ethiopia : Dispersed in the country / territory,15,29,0,21,123,31,0,219,15,20,0,18,212,23,0,288
2016,Ethiopia,Addis Ababa : Astedader akabibi - Chartered city,734,1649,0,985,6994,179,0,10541,729,1673,0,1072,5700,255,0,9429
2016,Finland,Finland,0,0,0,0,0,0,0,0,0,0,0,0,0,0,0,0
2016,Finland,Finland : Dispersed in the country / territory,0,0,0,0,0,0,0,0,0,0,0,0,0,0,0,0
2016,Fiji,Lotoka,0,0,0,0,0,0,0,0,0,0,0,0,1,0,0,1
2016,Fiji,Nadi,0,0,0,0,0,0,0,0,0,0,0,0,1,0,0,1
2016,Fiji,Suva : Point,0,0,0,1,5,0,0,6,0,0,0,1,5,0,0,6
2016,France,France : Dispersed in the country / territory,0,0,0,0,0,0,0,0,0,0,0,0,0,0,0,0
2016,Micronesia (Federated States of),Pohnpei,0,0,0,0,0,0,0,0,0,0,0,0,4,0,0,4
2016,Gabon,Akieni : Point,1,2,0,1,3,0,0,7,0,3,0,2,3,0,0,8
2016,Gabon,Bitam : Point,0,0,0,0,0,0,0,0,0,0,0,1,1,0,0,2
2016,Gabon,Bongoville : Point,1,0,0,0,1,0,0,2,0,0,0,0,3,0,0,3
2016,Gabon,Booue : Point,0,0,0,0,4,0,0,4,0,0,0,0,3,0,0,3
2016,Gabon,Franceville : Point,28,78,0,31,185,1,0,323,26,67,0,42,281,16,0,432
2016,Gabon,Gamba : Point,0,0,0,0,1,0,0,1,0,0,0,0,0,0,0,0
2016,Gabon,Koulamoutou : Point,9,22,0,12,41,0,0,84,10,21,0,9,74,2,0,116
2016,Gabon,Lambarene : Point,0,0,0,0,0,0,0,0,0,0,0,0,2,0,0,2
2016,Gabon,Lastoursville : Point,0,2,0,1,0,0,0,3,0,0,0,0,6,0,0,6
2016,Gabon,Leconi,0,0,0,0,0,0,0,0,0,0,0,0,3,1,0,4
2016,Gabon,Libreville : Point,28,70,0,77,359,8,0,542,39,95,0,88,536,57,0,815
2016,Gabon,Makokou : Point,1,1,0,0,1,0,0,3,0,2,0,1,1,0,0,4
2016,Gabon,Medouneu,0,0,0,0,0,0,0,0,0,0,0,0,1,0,0,1
2016,Gabon,Mitzic : Point,0,0,0,0,0,0,0,0,0,0,0,0,3,0,0,3
2016,Gabon,Moanda : Point,11,25,0,14,48,0,0,98,8,17,0,15,86,1,0,127
2016,Gabon,Mouila : Point,0,1,0,3,15,0,0,19,0,1,0,4,23,1,0,29
2016,Gabon,Mounana : Point,0,3,0,0,9,0,0,12,0,0,0,1,10,1,0,12
2016,Gabon,Ndjole : Point,0,0,0,0,0,0,0,0,0,0,0,0,1,1,0,2
2016,Gabon,Ngwoni : Point,0,1,0,0,1,0,0,2,0,0,0,0,3,0,0,3
2016,Gabon,Ntoum : Point,0,1,0,1,3,0,0,5,0,2,0,0,5,0,0,7
2016,Gabon,Okondja : Point,1,0,0,0,2,0,0,3,0,0,0,1,11,1,0,13
2016,Gabon,Oyem : Point,0,0,0,0,1,0,0,1,0,0,0,0,5,0,0,5
2016,Gabon,Pana/Dienga : Point,0,0,0,0,0,0,0,0,0,0,0,0,2,0,0,2
2016,Gabon,Port-Gentil : Point,5,3,0,3,23,2,0,36,6,5,0,1,64,8,0,84
2016,Gabon,Tchibanga : Point,0,0,0,0,5,0,0,5,0,2,0,0,5,0,0,7
2016,United Kingdom,United Kingdom of Great Britain and Northern Ireland : Dispersed in the country / territory,0,0,0,0,0,0,0,0,0,0,0,0,0,0,0,0
2016,Georgia,Abkhazia : Autonomous republic,25,44,0,22,177,35,0,303,20,41,0,28,187,33,0,309
2016,Georgia,Martqop?ÇÖi : Point,0,0,0,0,1,0,0,1,0,0,0,1,4,0,0,5
2016,Georgia,Pankisi Gorge,9,13,0,18,80,2,0,122,12,15,0,26,56,7,0,116
2016,Georgia,Rustavi,0,0,0,0,1,0,0,1,0,0,0,0,0,0,0,0
2016,Georgia,Georgia : Dispersed in the country / territory,11359,13655,0,12096,77085,32885,0,147080,11859,14713,0,13342,67900,21031,0,128845
2016,Ghana,Accra : District,83,87,0,70,435,10,0,685,82,103,0,72,826,27,0,1110
2016,Ghana,Ampain : Point,222,278,0,219,1025,49,0,1793,236,301,0,224,862,26,0,1649
2016,Ghana,Asanti Region,0,0,0,1,13,1,0,15,4,2,0,0,32,0,0,38
2016,Ghana,Brong Ahafo,2,2,0,1,15,0,0,20,3,0,0,0,9,0,0,12
2016,Ghana,Buduburam : Point,16,28,0,68,583,30,0,725,22,29,0,69,470,17,0,607
2016,Ghana,Central Region and its environs,12,26,0,19,92,4,0,153,14,31,0,22,130,7,0,204
2016,Ghana,Eastern region environa,1,3,0,1,9,0,0,14,3,4,0,0,7,1,0,15
2016,Ghana,Egyeikroum : Point,107,115,0,94,401,14,0,731,116,135,0,68,396,13,0,728
2016,Ghana,Fetentaa : Point,81,79,0,60,282,11,0,513,65,95,0,62,244,4,0,470
2016,Ghana,Krisan : Point,44,53,0,40,150,7,0,294,43,59,0,37,329,5,0,473
2016,Ghana,Volta : Region,96,223,0,192,687,65,0,1263,87,240,0,184,953,67,0,1531
2016,Ghana,Western region environa,16,19,0,16,48,1,0,100,7,19,0,6,58,3,0,93
2016,Guinea,Conakry : Special zone,28,52,0,72,254,7,0,413,30,70,0,79,421,13,0,613
2016,Guinea,Kouankan : Point,328,357,0,343,1004,51,0,2083,296,354,0,297,911,39,0,1897
2016,Guinea,Nzerekore : Prefecture,17,12,0,10,43,2,0,84,14,26,0,13,30,3,0,86
2016,Gambia,Gambia : Dispersed in the country / territory,497,854,0,600,1902,227,0,4080,461,881,0,593,1651,274,0,3860
2016,Guinea-Bissau,Asselem,10,16,0,7,36,8,0,77,8,20,0,5,31,6,0,70
2016,Guinea-Bissau,Bachil,35,52,0,39,98,17,0,241,33,65,0,33,57,8,0,196
2016,Guinea-Bissau,Barraca Lugar,11,19,0,5,40,6,0,81,9,21,0,3,19,1,0,53
2016,Guinea-Bissau,Barraca Mandioca,11,19,0,11,39,5,0,85,12,19,0,11,26,7,0,75
2016,Guinea-Bissau,Beguingue II,22,32,0,24,106,19,0,203,32,43,0,25,50,8,0,158
2016,Guinea-Bissau,Bigene : Point,27,58,0,32,96,18,0,231,21,61,0,33,63,13,0,191
2016,Guinea-Bissau,Bissau : Autonomous sector,7,6,0,2,16,6,0,37,4,5,0,5,52,3,0,69
2016,Guinea-Bissau,Bufa,9,21,0,9,27,5,0,71,9,21,0,5,14,2,0,51
2016,Guinea-Bissau,Campada,12,23,0,9,61,10,0,115,8,17,0,17,53,3,0,98
2016,Guinea-Bissau,Canjandi,23,33,0,14,81,15,0,166,21,49,0,18,74,7,0,169
2016,Guinea-Bissau,Carabane,14,25,0,17,72,7,0,135,19,22,0,20,55,6,0,122
2016,Guinea-Bissau,Caruai,15,22,0,11,41,13,0,102,19,39,0,6,29,11,0,104
2016,Guinea-Bissau,Catel,12,15,0,11,32,4,0,74,10,20,0,14,26,4,0,74
2016,Guinea-Bissau,Djacumundo,24,37,0,23,75,16,0,175,23,47,0,20,60,7,0,157
2016,Guinea-Bissau,Djambam,18,23,0,12,49,4,0,106,11,21,0,14,27,4,0,77
2016,Guinea-Bissau,Djegue,21,52,0,31,111,23,0,238,24,55,0,26,75,7,0,187
2016,Guinea-Bissau,Djendem,4,13,0,4,17,2,0,40,7,9,0,5,17,3,0,41
2016,Guinea-Bissau,Erame,14,44,0,16,79,16,0,169,18,44,0,20,35,13,0,130
2016,Guinea-Bissau,Guinea-Bissau : Dispersed In the country/territory,0,0,0,0,0,0,0,0,0,0,0,0,0,0,0,0
2016,Guinea-Bissau,Ingore,15,27,0,12,69,10,0,133,12,22,0,19,48,12,0,113
2016,Guinea-Bissau,Ingorezinho,25,33,0,19,70,5,0,152,28,36,0,12,57,10,0,143
2016,Guinea-Bissau,Jolmete : Point,36,47,0,46,110,10,0,249,27,58,0,40,87,10,0,222
2016,Guinea-Bissau,Kassolol,13,17,0,7,32,8,0,77,4,14,0,2,28,9,0,57
2016,Guinea-Bissau,Mandina,9,8,0,3,44,8,0,72,5,11,0,5,23,5,0,49
2016,Guinea-Bissau,Maque,9,22,0,11,38,1,0,81,9,13,0,13,26,1,0,62
2016,Guinea-Bissau,Mbaiam,27,33,0,26,71,10,0,167,21,34,0,24,44,5,0,128
2016,Guinea-Bissau,Papia,21,28,0,13,54,8,0,124,18,36,0,20,36,3,0,113
2016,Guinea-Bissau,Pelundo,11,57,0,16,58,10,0,152,9,25,0,19,44,7,0,104
2016,Guinea-Bissau,Saiam,24,41,0,26,76,6,0,173,21,33,0,25,42,8,0,129
2016,Guinea-Bissau,Sancoma,18,42,0,20,96,12,0,188,28,36,0,28,56,10,0,158
2016,Guinea-Bissau,Sao Domingos : Point,0,2,0,2,2,1,0,7,1,1,0,3,5,1,0,11
2016,Guinea-Bissau,Sedengal,14,28,0,15,63,9,0,129,21,31,0,31,41,9,0,133
2016,Guinea-Bissau,Sindina,16,41,0,21,75,2,0,155,26,39,0,25,42,8,0,140
2016,Guinea-Bissau,Sungutoto,24,44,0,17,113,20,0,218,12,56,0,34,72,12,0,186
2016,Guinea-Bissau,Tarrero,21,21,0,9,74,11,0,136,23,21,0,7,63,5,0,119
2016,Guinea-Bissau,Varela,16,32,0,13,69,8,0,138,16,33,0,11,55,15,0,130
2016,Greece,Greece : Dispersed in the country / territory,0,0,0,0,0,0,0,0,0,0,0,0,0,0,0,0
2016,Grenada,St. George's,0,0,0,0,0,0,0,0,0,0,0,0,1,0,0,1
2016,Guatemala,Guatemala : Dispersed in the country / territory,2,4,0,25,103,10,0,144,4,6,0,23,118,7,0,158
2016,Guyana,Guyana : Dispersed in the country / territory,0,0,0,3,4,0,0,7,0,0,0,1,3,0,0,4
2016,"China, Hong Kong SAR","Hong Kong SAR, China : Dispersed in the country / territory",6,7,0,3,29,0,0,45,4,5,0,4,51,2,0,66
2016,Honduras,Honduras : Dispersed in the country / territory,10001,12703,0,13702,48609,4300,0,89315,11100,15903,0,12501,41607,3600,0,84711
2016,Croatia,Bjelovar : Point,0,0,0,0,0,0,0,0,0,0,0,0,1,0,0,1
2016,Croatia,Croatia : Dispersed in the country / territory,0,0,0,0,0,0,0,0,0,0,0,0,0,0,0,0
2016,Croatia,Grad Zagreb : Grad - City,16,10,0,6,45,1,0,78,9,15,0,12,357,2,0,395
2016,Croatia,Jezevo : Point,0,0,0,0,0,0,0,0,0,0,0,0,10,0,0,10
2016,Croatia,Kutina,3,7,0,3,20,0,0,33,10,11,0,6,14,0,0,41
2016,Croatia,Kutina : Point,0,0,0,0,0,0,0,0,0,0,0,0,0,0,0,0
2016,Croatia,Rijeka : Point,0,0,0,0,0,0,0,0,0,0,0,0,3,0,0,3
2016,Croatia,Vinkovci : Point,0,0,0,0,1,0,0,1,0,0,0,0,0,0,0,0
2016,Croatia,Zagreb,13,16,0,8,44,0,0,81,7,12,0,19,142,0,0,180
2016,Haiti,Haiti : Dispersed in the country / territory,0,541,0,307,268,3,0,1119,0,546,0,347,289,1,0,1183
2016,Haiti,Port au Prince : Point,0,0,0,0,3,0,0,3,0,0,0,0,7,0,0,7
2016,Hungary,B??k??scsaba,0,0,0,0,0,0,0,0,0,0,0,0,0,0,0,0
2016,Hungary,Balassagyarmat,0,0,0,0,0,0,0,0,0,0,0,0,0,0,0,0
2016,Hungary,Hungary : Dispersed in the country / territory,0,0,0,0,0,0,0,0,0,0,0,0,0,0,0,0
2016,Hungary,Kiskunhalas,0,0,0,0,0,0,0,0,0,0,0,0,0,0,0,0
2016,Hungary,Kormend,0,0,0,0,0,0,0,0,0,0,0,0,0,0,0,0
2016,Hungary,Nyirbator,0,0,0,0,0,0,0,0,0,0,0,0,0,0,0,0
2016,Hungary,Vamosszabadi,0,0,0,0,0,0,0,0,0,0,0,0,0,0,0,0
2016,Indonesia,Bali,3,6,0,2,22,0,0,33,2,7,0,6,74,0,0,89
2016,Indonesia,Banten,17,31,0,15,98,4,0,165,20,26,0,21,382,2,0,451
2016,Indonesia,Irian Jaya Tengah,0,0,0,0,0,0,0,0,0,0,0,3,19,0,0,22
2016,Indonesia,Jakarta,79,126,0,97,523,14,0,839,90,142,0,251,1738,16,0,2237
2016,Indonesia,Jawa Barat : Provinsi - Province,72,126,0,93,455,35,0,781,105,158,0,152,1515,24,0,1954
2016,Indonesia,Jawa Tengah,7,10,0,5,31,2,0,55,4,11,0,4,27,1,0,47
2016,Indonesia,Jawa Timur,0,1,0,4,3,0,0,8,0,4,0,6,404,0,0,414
2016,Indonesia,Kalimantan Barat : Provinsi - Province,0,0,0,0,0,0,0,0,0,0,0,2,154,0,0,156
2016,Indonesia,Kalimantan Timur,0,0,0,1,2,0,0,3,0,1,0,3,259,0,0,263
2016,Indonesia,Kepulauan Riau : Provinsi - Province,32,22,0,5,103,0,0,162,35,19,0,20,605,2,0,681
2016,Indonesia,Lampung,0,0,0,0,0,0,0,0,0,0,0,0,4,0,0,4
2016,Indonesia,Nanggroe Aceh Darussalam,0,0,0,0,1,0,0,1,1,0,0,0,8,0,0,9
2016,Indonesia,Other,2,1,0,0,3,0,0,6,0,0,0,0,41,0,0,41
2016,Indonesia,Riau : Provinsi - Province,41,60,0,30,163,5,0,299,55,83,0,45,660,8,0,851
2016,Indonesia,Sulawesi Utara : Provinsi - Province,0,2,0,2,6,0,0,10,0,1,0,3,154,1,0,159
2016,Indonesia,Sumatera Barat : Provinsi - Province,0,0,0,0,0,0,0,0,0,0,0,0,1,0,0,1
2016,Indonesia,Sumatera Selatan : Provinsi - Province,0,0,0,0,1,0,0,1,0,0,0,0,0,0,0,0
2016,Indonesia,Sumatera Utara,130,133,0,100,475,12,0,850,135,143,0,143,926,12,0,1359
2016,Indonesia,Yogyakarta,0,0,0,0,0,0,0,0,0,0,0,0,33,0,0,33
2016,Indonesia,Sulawesi Selatan : Provinsi - Province,86,86,0,42,301,9,0,524,104,80,0,92,1169,5,0,1450
2016,Indonesia,Nusa Tenggara Timur : Provinsi - Province,13,15,0,12,43,1,0,84,11,12,0,21,318,1,0,363
2016,India,Delhi : Union territory,1684,2614,0,1890,9389,601,0,16178,1848,2741,0,2123,10305,618,0,17635
2016,India,India : Dispersed in the country / territory,0,0,0,0,0,0,0,0,0,0,0,0,0,0,0,0
2016,India,Tamil Nadu : State,0,0,0,0,0,0,0,0,0,0,0,0,0,0,0,0
2016,Ireland,Ireland : Dispersed in the country / territory,196,275,0,229,2752,124,0,3576,209,282,0,247,5281,147,0,6166
2016,Iran (Islamic Rep. of),Abazar : Point,1,7,0,10,35,6,0,59,5,8,0,12,50,4,0,79
2016,Iran (Islamic Rep. of),Ansar,2,5,0,5,12,2,0,26,1,3,0,6,8,2,0,20
2016,Iran (Islamic Rep. of),Bani Najjar : Point,132,125,0,172,624,17,0,1070,142,128,0,171,608,32,0,1081
2016,Iran (Islamic Rep. of),Bezileh : Point,1,1,0,2,13,1,0,18,1,2,0,4,11,1,0,19
2016,Iran (Islamic Rep. of),Dalaki : Point,30,11,0,13,29,3,0,86,28,9,0,14,22,0,0,73
2016,Iran (Islamic Rep. of),Dilzeh : Point,2,3,0,10,15,2,0,32,4,3,0,5,15,1,0,28
2016,Iran (Islamic Rep. of),Ebrahim Abad,7,9,0,2,20,3,0,41,5,7,0,6,21,4,0,43
2016,Iran (Islamic Rep. of),Islamic Republic of Iran : Dispersed in the country / territory,0,0,0,0,0,0,0,0,0,0,0,0,0,0,0,0
2016,Iran (Islamic Rep. of),Mohajerin : Point,221,246,0,321,904,84,0,1776,201,290,0,284,860,107,0,1742
2016,Iran (Islamic Rep. of),Sultanieh : Point,1,0,0,1,4,3,0,9,1,0,0,1,3,2,0,7
2016,Iran (Islamic Rep. of),Varmahang : Point,1,1,0,2,2,0,0,6,0,0,0,0,3,0,0,3
2016,Iran (Islamic Rep. of),Ziveh : Point,6,18,0,29,97,8,0,158,7,19,0,20,82,12,0,140
2016,Iran (Islamic Rep. of),Torbat e jam : Shahrestan - County,131,252,0,291,1152,98,0,1924,124,254,0,320,1162,152,0,2012
2016,Iran (Islamic Rep. of),Tehran : Shahrestan - County,1,0,0,1,7,0,0,9,1,3,0,3,8,0,0,15
2016,Iran (Islamic Rep. of),Taft : Shahrestan - County,51,47,0,122,218,31,0,469,41,83,0,97,270,24,0,515
2016,Iran (Islamic Rep. of),Sonqor : Shahrestan - County,1,3,0,2,8,2,0,16,1,4,0,4,5,1,0,15
2016,Iran (Islamic Rep. of),Saveh : Shahrestan - County,363,580,0,449,860,34,0,2286,453,530,0,554,814,128,0,2479
2016,Iran (Islamic Rep. of),Sarvestan : Shahrestan - County,52,72,0,53,133,14,0,324,40,54,0,61,142,30,0,327
2016,Iran (Islamic Rep. of),Rafsanjan : Shahrestan - County,342,570,0,592,642,210,0,2356,383,530,0,680,592,282,0,2467
2016,Iran (Islamic Rep. of),Meybod : Shahrestan - County,74,68,0,84,351,20,0,597,70,68,0,105,352,20,0,615
2016,Iran (Islamic Rep. of),Khuzestan : Ostan - Province,0,1,0,0,3,0,0,4,1,0,0,0,3,0,0,4
2016,Iran (Islamic Rep. of),Jahrom : Shahrestan - County,8,13,0,15,50,7,0,93,6,9,0,15,54,4,0,88
2016,Iran (Islamic Rep. of),Bardsir : Shahrestan - County,252,251,0,295,602,35,0,1435,248,265,0,299,608,27,0,1447
2016,Iran (Islamic Rep. of),Ardakan : Shahrestan - County,159,242,0,301,631,38,0,1371,192,262,0,284,707,62,0,1507
2016,Iraq,Al-hasakeh: Muhafazah - Province,0,0,0,0,1,1,0,2,0,1,0,0,2,0,0,3
2016,Iraq,Anbar: Muhafazah - Province,230,652,0,362,1060,132,0,2436,194,645,0,401,733,84,0,2057
2016,Iraq,Babylon: Muhafazah - Province,1,1,0,0,5,1,0,8,1,5,0,3,9,0,0,18
2016,Iraq,Baghdad : Muhafazah - Province,330,520,0,397,2538,455,0,4240,373,559,0,386,2456,557,0,4331
2016,Iraq,Basrah : Muhafazah - Province,17,31,0,32,81,9,0,170,23,40,0,33,78,5,0,179
2016,Iraq,Diyala : Muhafazah - Province,3,18,0,8,67,8,0,104,3,17,0,10,56,6,0,92
2016,Iraq,Duhok: Muhafazah - Province,7394,7741,0,4361,21331,1222,0,42049,7670,8073,0,4803,24017,1035,0,45598
2016,Iraq,Erbil : Muhafazah - Province,6064,6333,0,4585,25289,1710,0,43981,6422,6746,0,5479,35662,1556,0,55865
2016,Iraq,Erbil: Muhafazah - Province,3018,3041,0,1797,8138,475,0,16469,3127,3171,0,1876,8606,351,0,17131
2016,Iraq,Kerbala : Muhafazah - Province,19,18,0,9,68,8,0,122,5,20,0,15,110,9,0,159
2016,Iraq,Kirkuk: Muhafazah - Province,61,91,0,52,202,12,0,418,74,91,0,52,294,16,0,527
2016,Iraq,Missan: Muhafazah - Province,2,3,0,0,5,0,0,10,2,5,0,0,2,1,0,10
2016,Iraq,Muthanna: Muhafazah - Province,0,0,0,0,0,0,0,0,0,0,0,0,0,1,0,1
2016,Iraq,Najaf : Muhafazah - Province,11,18,0,9,69,5,0,112,16,18,0,17,192,5,0,248
2016,Iraq,Ninewa: Muhafazah - Province,86,230,0,165,789,88,0,1358,70,252,0,175,716,78,0,1291
2016,Iraq,Qadissiya: Muhafazah - Province,1,4,0,5,11,1,0,22,0,4,0,3,6,1,0,14
2016,Iraq,Salah al-Din: Muhafazah - Province,2,3,0,4,9,3,0,21,0,3,0,0,18,5,0,26
2016,Iraq,Sulaymaniyah : Muhafazah - Province,1787,1928,0,1173,6588,386,0,11862,1862,2020,0,1485,9790,401,0,15558
2016,Iraq,Sulaymaniyah: Muhafazah - Province,854,785,0,500,2418,135,0,4692,906,861,0,488,2435,118,0,4808
2016,Iraq,Tartous: Muhafazah - Province,0,0,0,0,1,0,0,1,0,0,0,0,1,0,0,1
2016,Iraq,Thi-Qar: Muhafazah - Province,6,17,0,12,21,2,0,58,9,15,0,10,22,0,0,56
2016,Iraq,Wassit: Muhafazah - Province,2,1,0,0,5,1,0,9,1,1,0,0,5,0,0,7
2016,Iraq,Iraq : Dispersed in the country / territory,19,18,0,25,99,7,0,168,21,34,0,23,137,2,0,217
2016,Iceland,Iceland : Dispersed in the country / territory,0,0,0,0,0,0,0,0,0,0,0,0,0,0,0,0
2016,Israel,Israel : Dispersed in the country / territory,0,0,0,0,0,0,0,0,0,0,0,0,0,0,0,0
2016,Italy,Italy: Dispersed in the country / Territory,0,0,0,0,0,0,0,0,0,0,0,0,0,0,0,0
2016,Jamaica,Jamaica : Dispersed in the country / territory,0,0,0,0,6,0,0,6,1,0,0,0,17,0,0,18
2016,Jordan,Ajlun : Governorate,509,908,0,609,1828,184,0,4038,664,1048,0,612,1288,122,0,3734
2016,Jordan,Amman : Governorate,14130,21836,0,13225,60736,7374,0,117301,14857,23169,0,14125,67122,6008,0,125281
2016,Jordan,Aqabah : Governorate,241,326,0,197,887,76,0,1727,271,367,0,215,998,60,0,1911
2016,Jordan,Balqa : Governorate,1440,2138,0,1281,5149,435,0,10443,1568,2285,0,1412,4877,341,0,10483
2016,Jordan,Irbid : Governorate,9154,15419,0,9962,33554,3490,0,71579,9608,16185,0,10199,26445,2398,0,64835
2016,Jordan,Jarash : Governorate,714,1082,0,657,2338,239,0,5030,744,1107,0,686,1955,151,0,4643
2016,Jordan,Karak : Governorate,692,927,0,518,1994,198,0,4329,728,978,0,591,1998,152,0,4447
2016,Jordan,Maan : Governorate,640,812,0,478,1815,136,0,3881,628,833,0,500,1950,102,0,4013
2016,Jordan,Madaba : Governorate,883,1199,0,738,2775,233,0,5828,985,1271,0,802,2732,168,0,5958
2016,Jordan,Mafraq : Governorate,6150,8719,0,5580,18707,1868,0,41024,6571,9064,0,5875,15871,1155,0,38536
2016,Jordan,Mafraq : Zataari Camp,7050,8559,0,5655,16852,1267,0,39383,7514,9088,0,5895,14950,910,0,38357
2016,Jordan,Tafilah : Governorate,107,172,0,84,346,20,0,729,128,175,0,88,376,19,0,786
2016,Jordan,Zarqa : Emirates Jordanian Camp (EJC),645,1006,0,591,1449,93,0,3784,704,994,0,594,1263,70,0,3625
2016,Jordan,Zarqa : Governorate,3289,5352,0,3566,12560,1181,0,25948,3433,5846,0,3648,11115,849,0,24891
2016,Jordan,Zarqa: Azraq Camp,5092,6159,0,3119,11583,713,0,26666,5307,6644,0,3540,9518,477,0,25486
2016,Jordan,Jordan : Dispersed in the country / territory,111,192,0,133,546,59,0,1041,134,224,0,140,577,20,0,1095
2016,Japan,Japan : Dispersed in the country / territory,0,0,0,0,0,0,0,0,0,0,0,0,0,0,0,0
2016,Kazakhstan,Almaty : City,13,27,0,23,134,12,0,209,15,32,0,24,148,10,0,229
2016,Kazakhstan,Almaty : Oblast - Province,0,1,0,4,16,2,0,23,1,2,0,7,23,2,0,35
2016,Kazakhstan,Astana : City,0,0,0,0,0,0,0,0,0,0,0,0,1,0,0,1
2016,Kazakhstan,Karaganda,0,0,0,1,0,0,0,1,0,2,0,2,1,0,0,5
2016,Kazakhstan,Kazakhstan : Dispersed in the country / territory,0,0,0,0,0,0,0,0,0,0,0,0,0,0,0,0
2016,Kazakhstan,Kostanai,0,1,0,0,1,0,0,2,0,0,0,0,1,0,0,1
2016,Kazakhstan,Mangystau,0,0,0,0,0,0,0,0,0,0,0,0,1,0,0,1
2016,Kazakhstan,West Kazakhstan,0,0,0,0,1,0,0,1,0,0,0,0,0,0,0,0
2016,Kazakhstan,Zhambyl : Oblast - Province,1,1,0,0,3,0,0,5,0,2,0,0,6,0,0,8
2016,Kazakhstan,South Kazakhstan : Oblast - Province,13,13,0,15,60,1,0,102,20,23,0,11,98,3,0,155
2016,Kenya,Dagahaley : Point,5902,9319,0,5924,14363,1207,0,36715,5897,9870,0,6423,11613,1129,0,34932
2016,Kenya,Hagadera : Point,6437,10397,0,6715,18010,1471,0,43030,6841,11003,0,7445,14998,1404,0,41691
2016,Kenya,Ifo 2 : Point,3291,4862,0,2847,5744,431,0,17175,3459,5380,0,3589,4947,496,0,17871
2016,Kenya,Ifo : Point,5605,8351,0,5528,14874,1212,0,35570,6018,8669,0,6144,12482,1209,0,34522
2016,Kenya,Kakuma : Point,12501,18487,0,12496,28038,1146,0,72668,12974,20947,0,18801,29021,536,0,82279
2016,Kenya,Kambioos : Point,1009,1574,0,904,1803,137,0,5427,1125,1696,0,1219,1642,149,0,5831
2016,Kenya,Kenya: Dispersed in the country / territory,0,0,0,0,0,0,0,0,0,0,0,0,0,0,0,0
2016,Kenya,Nairobi : Province,2550,4783,0,4819,20253,1119,0,33524,2818,5043,0,4776,20231,759,0,33627
2016,Kyrgyzstan,Kyrgyzstan : Dispersed in the country / territory,11,24,0,23,150,3,0,211,14,28,0,30,168,8,0,248
2016,Cambodia,Phnom Penh : Autonomous municipality,8,16,0,6,36,3,0,69,5,11,0,43,112,3,0,174
2016,Rep. of Korea,Ansan,0,1,0,1,79,1,0,82,1,1,0,2,365,1,0,370
2016,Rep. of Korea,Busan: Gwangyeoksi - Metropolitan City,6,6,0,3,39,0,0,54,8,10,0,7,149,1,0,175
2016,Rep. of Korea,Changwon,1,0,0,0,4,0,0,5,2,0,0,0,31,0,0,33
2016,Rep. of Korea,Cheju,2,0,0,1,55,3,0,61,2,0,0,1,93,1,0,97
2016,Rep. of Korea,Cheonan,0,0,0,1,13,0,0,14,0,0,0,0,58,0,0,58
2016,Rep. of Korea,Cheongju,0,0,0,0,3,0,0,3,0,0,0,0,24,0,0,24
2016,Rep. of Korea,Cheongju Detention,0,1,0,0,1,0,0,2,0,0,0,0,6,0,0,6
2016,Rep. of Korea,Chuncheon,0,0,0,0,3,0,0,3,0,0,0,0,4,0,0,4
2016,Rep. of Korea,Daegu : Gwangyeoksi - Metropolitan city,8,0,0,0,34,0,0,42,2,0,0,0,241,2,0,245
2016,Rep. of Korea,Daejeon : Gwangyeoksi - Metropolitan city,2,3,0,0,10,1,0,16,0,2,0,0,25,1,0,28
2016,Rep. of Korea,Dangjin,0,0,0,0,0,0,0,0,0,0,0,0,2,0,0,2
2016,Rep. of Korea,Donghae,0,0,0,0,1,0,0,1,0,0,0,0,12,0,0,12
2016,Rep. of Korea,Gimhae,0,0,0,0,0,0,0,0,0,0,0,0,2,0,0,2
2016,Rep. of Korea,Goyang,0,0,0,0,5,0,0,5,0,0,0,0,9,0,0,9
2016,Rep. of Korea,Gunsan,0,0,0,0,0,0,0,0,0,0,0,0,4,0,0,4
2016,Rep. of Korea,Gwangju,9,4,0,1,60,0,0,74,8,4,0,3,361,1,0,377
2016,Rep. of Korea,Incheon Airport,32,30,0,18,98,5,0,183,24,26,0,23,107,1,0,181
2016,Rep. of Korea,Inchon: Gwangyeoksi - Metropolitan,12,4,0,3,86,0,0,105,12,4,0,5,542,0,0,563
2016,Rep. of Korea,Jeonju,1,0,0,0,5,0,0,6,0,0,0,1,81,0,0,82
2016,Rep. of Korea,Mokpo,0,0,0,0,0,0,0,0,0,0,0,0,5,0,0,5
2016,Rep. of Korea,Osan,0,0,0,0,71,0,0,71,1,0,0,0,273,2,0,276
2016,Rep. of Korea,Pohang,0,0,0,0,0,0,0,0,0,0,0,0,1,0,0,1
2016,Rep. of Korea,Republic of Korea : Dispersed in the country / territory,0,0,0,0,0,0,0,0,0,0,0,0,0,0,0,0
2016,Rep. of Korea,Sacheon,0,0,0,0,0,0,0,0,0,0,0,0,1,0,0,1
2016,Rep. of Korea,Seosan,0,0,0,0,2,0,0,2,0,0,0,0,6,0,0,6
2016,Rep. of Korea,Suwon,6,2,0,0,118,0,0,126,1,1,0,1,431,2,0,436
2016,Rep. of Korea,Ulsan,2,0,0,0,12,0,0,14,1,3,0,0,99,0,0,103
2016,Rep. of Korea,Unidentified,0,0,0,0,0,0,0,0,0,0,0,0,1,0,0,1
2016,Rep. of Korea,Whasung Detention,0,0,0,0,5,1,0,6,0,0,0,0,14,3,0,17
2016,Rep. of Korea,Yangju,4,0,0,1,68,0,0,73,7,1,0,7,383,3,0,401
2016,Rep. of Korea,Yeosu,0,0,0,0,1,0,0,1,0,0,0,0,3,0,0,3
2016,Rep. of Korea,Seoul : Teukbyeolsi - Capital metropolitan city,76,67,0,29,639,18,0,829,68,80,0,38,3159,23,0,3368
2016,Kuwait,kUWAIT,32,87,0,139,457,65,0,780,45,150,0,122,488,44,0,849
2016,Lebanon,Beirut : Mohafazah - Governorate,23952,30722,0,17568,65710,4516,0,142468,24771,32073,0,18505,54445,3568,0,133362
2016,Lebanon,Beqaa : Mohafazah - Governorate,31010,43641,0,26596,89308,5776,0,196331,32161,45714,0,26585,56101,4550,0,165111
2016,Lebanon,North : Mohafazah - Governorate,91,151,0,95,531,35,0,903,89,164,0,99,318,21,0,691
2016,Lebanon,South : Mohafazah - Governorate,11154,14308,0,7362,27585,1365,0,61774,11819,14887,0,7737,21616,1054,0,57113
2016,Lebanon,Mount Lebanon : Mohafazah - Governorate,21674,30780,0,15480,65430,4010,0,137374,23145,32460,0,16843,60368,3360,0,136176
2016,Liberia,Bahn Refugee Camp,174,317,0,200,566,25,0,1282,188,342,0,201,482,33,0,1246
2016,Liberia,Grand Gedeh : County,73,280,0,140,579,94,0,1166,73,237,0,173,495,63,0,1041
2016,Liberia,Little Wlebbo : Point,218,423,0,284,591,24,0,1540,207,429,0,243,497,21,0,1397
2016,Liberia,Maryland : County,13,92,0,50,154,25,0,334,14,84,0,61,186,11,0,356
2016,Liberia,Montserrado : County,14,39,0,49,210,2,0,314,14,39,0,51,295,13,0,412
2016,Liberia,Nimba : County,2,27,0,14,58,11,0,112,4,16,0,18,43,4,0,85
2016,Liberia,PTP : Point,628,1155,0,584,1906,144,0,4417,666,1155,0,645,1882,122,0,4470
2016,Liberia,River Ghee : County,11,171,0,81,165,14,0,442,14,190,0,99,86,4,0,393
2016,Libya,A jabal Al akhder,0,0,0,0,0,0,0,0,0,0,0,0,0,0,0,0
2016,Libya,Al Aziziyah,0,0,0,0,0,0,0,0,0,0,0,0,0,0,0,0
2016,Libya,Al jafara,0,0,0,0,0,0,0,0,0,0,0,0,0,0,0,0
2016,Libya,Al Margeb,0,0,0,0,0,0,0,0,0,0,0,0,0,0,0,0
2016,Libya,Al Mayah,0,0,0,0,0,0,0,0,0,0,0,0,0,0,0,0
2016,Libya,Az Zahra,0,0,0,0,0,0,0,0,0,0,0,0,0,0,0,0
2016,Libya,Azzawya,0,0,0,0,0,0,0,0,0,0,0,0,0,0,0,0
2016,Libya,Benghazi,0,0,0,0,0,0,0,0,0,0,0,0,0,0,0,0
2016,Libya,Derna,0,0,0,0,0,0,0,0,0,0,0,0,0,0,0,0
2016,Libya,Ejdabia,0,0,0,0,0,0,0,0,0,0,0,0,0,0,0,0
2016,Libya,Libay,737,2904,0,1856,9826,663,0,15986,755,3064,0,2063,15650,1029,0,22561
2016,Libya,Misrata : Popularate,0,0,0,0,0,0,0,0,0,0,0,0,0,0,0,0
2016,Libya,Qasr Bin Ghashir,0,0,0,0,0,0,0,0,0,0,0,0,0,0,0,0
2016,Libya,Sabha : Popularate,0,0,0,0,0,0,0,0,0,0,0,0,0,0,0,0
2016,Libya,Sawiani Bin Adam,0,0,0,0,0,0,0,0,0,0,0,0,0,0,0,0
2016,Libya,Tobruk,0,0,0,0,0,0,0,0,0,0,0,0,0,0,0,0
2016,Libya,Tripoli,0,0,0,0,0,0,0,0,0,0,0,0,0,0,0,0
2016,Libya,Western Mountains : Popularate,0,0,0,0,0,0,0,0,0,0,0,0,0,0,0,0
2016,Saint Lucia,Saint Lucia : Dispersed in the country / territory,0,0,0,0,0,0,0,0,0,0,0,0,2,0,0,2
2016,Liechtenstein,Liechtenstein : Dispersed in the country / territory,0,0,0,0,0,0,0,0,0,0,0,0,0,0,0,0
2016,Sri Lanka,Ampara : District,0,0,0,0,0,0,0,0,0,0,0,0,0,0,0,0
2016,Sri Lanka,Batticaloa,0,0,0,0,0,0,0,0,0,0,0,0,0,0,0,0
2016,Sri Lanka,Colombo : District,12,11,0,10,51,3,0,87,11,12,0,2,71,3,0,99
2016,Sri Lanka,Gampaha : District,48,56,0,39,241,15,0,399,62,71,0,58,352,13,0,556
2016,Sri Lanka,Jaffna : District,6,12,0,12,66,16,0,112,3,10,0,12,55,15,0,95
2016,Sri Lanka,Kaluthara,3,2,0,2,7,0,0,14,3,4,0,1,12,0,0,20
2016,Sri Lanka,Kandy : District,0,0,0,0,1,0,0,1,1,0,0,1,0,0,0,2
2016,Sri Lanka,Kilinochchi : District,1,6,0,3,26,1,0,37,1,6,0,4,22,4,0,37
2016,Sri Lanka,Mannar : District,10,15,0,15,61,9,0,110,8,13,0,18,61,10,0,110
2016,Sri Lanka,Mullaitivu : District,1,4,0,2,19,4,0,30,0,2,0,5,14,4,0,25
2016,Sri Lanka,Puttalam,0,0,0,0,1,0,0,1,0,0,0,0,1,0,0,1
2016,Sri Lanka,Sri Lanka : Dispersed in the country / territory,0,1,0,0,12,2,0,15,0,0,0,3,6,0,0,9
2016,Sri Lanka,Trincomalee : District,15,11,0,6,54,3,0,89,4,21,0,13,54,8,0,100
2016,Sri Lanka,Vavuniya : District,1,8,0,9,31,8,0,57,6,11,0,7,47,4,0,75
2016,Lesotho,Lesotho : Dispersed in the country / territory,1,5,0,0,10,0,0,16,0,3,0,1,27,1,0,32
2016,Lithuania,Lithuania : Dispersed in the country / territory,0,0,0,0,0,0,0,0,0,0,0,0,0,0,0,0
2016,Luxembourg,Luxembourg : Dispersed in the country / territory,0,0,0,0,0,0,0,0,0,0,0,0,0,0,0,0
2016,Latvia,Latvia : Dispersed in the country / territory,0,0,0,0,0,0,0,0,0,0,0,0,0,0,0,0
2016,"China, Macao SAR","Macao SAR, China : Dispersed in the country / territory",0,0,0,0,1,0,0,1,0,0,0,1,3,0,0,4
2016,Morocco,Morocco : Dispersed in the country / territory,384,432,0,329,1351,59,0,2555,388,450,0,519,2757,64,0,4178
2016,Rep. of Moldova,Republic of Moldova : Dispersed in the country / territory,10,22,0,21,98,24,0,175,9,19,0,14,279,21,0,342
2016,Madagascar,Madagascar : Dispersed in the country / territory,2,4,0,0,9,1,0,16,2,5,0,6,24,2,0,39
2016,Mexico,Mexico : Dispersed in the country / territory,0,0,0,0,0,0,0,0,0,0,0,0,0,0,0,0
2016,The former Yugoslav Republic of Macedonia,Berovo : Op?ítina - Municipality,0,0,0,0,1,0,0,1,0,0,0,0,0,0,0,0
2016,The former Yugoslav Republic of Macedonia,Kumanovo,0,0,0,0,4,0,0,4,0,0,0,0,2,1,0,3
2016,The former Yugoslav Republic of Macedonia,Valandovo : Op?ítina - Municipality,0,0,0,0,0,0,0,0,0,0,0,0,1,0,0,1
2016,The former Yugoslav Republic of Macedonia,Vizbegovo : Point,0,1,0,2,5,0,0,8,0,3,0,2,16,0,0,21
2016,The former Yugoslav Republic of Macedonia,Veles,0,1,0,2,1,0,0,4,0,1,0,0,0,1,0,2
2016,The former Yugoslav Republic of Macedonia,Tetovo : Op?ítina - Municipality,0,8,0,8,15,2,0,33,1,4,0,4,18,1,0,28
2016,The former Yugoslav Republic of Macedonia,Stip : Op?ítina - Municipality,2,1,0,1,4,2,0,10,1,2,0,4,2,0,0,9
2016,The former Yugoslav Republic of Macedonia,Skopje : City,23,81,0,63,268,37,0,472,47,78,0,133,260,19,0,537
2016,The former Yugoslav Republic of Macedonia,Probistip : Op?ítina - Municipality,0,0,0,0,0,1,0,1,0,0,0,0,0,0,0,0
2016,The former Yugoslav Republic of Macedonia,Prilep : Op?ítina - Municipality,2,1,0,0,2,0,0,5,1,0,0,1,7,0,0,9
2016,The former Yugoslav Republic of Macedonia,Negotino,0,0,0,0,3,0,0,3,0,0,0,0,0,0,0,0
2016,The former Yugoslav Republic of Macedonia,Kumanovo : Op?ítina - Municipality,2,8,0,5,23,4,0,42,1,9,0,3,11,0,0,24
2016,The former Yugoslav Republic of Macedonia,Kicevo : Op?ítina - Municipality,0,0,0,0,4,1,0,5,0,0,0,0,2,0,0,2
2016,The former Yugoslav Republic of Macedonia,Kavadarci : Op?ítina - Municipality,0,0,0,0,3,0,0,3,0,0,0,0,0,0,0,0
2016,The former Yugoslav Republic of Macedonia,Gostivar : Op?ítina - Municipality,0,2,0,3,10,0,0,15,0,1,0,1,2,0,0,4
2016,The former Yugoslav Republic of Macedonia,Bitola : Op?ítina - Municipality,0,2,0,1,2,0,0,5,0,3,0,0,3,1,0,7
2016,Mali,Bamako : District,143,226,0,176,558,33,0,1136,126,224,0,163,439,25,0,977
2016,Mali,Faragouana : Point,1,4,0,2,7,0,0,14,0,2,0,3,14,0,0,19
2016,Mali,Gao : Region,126,272,0,167,510,46,0,1121,129,237,0,175,403,50,0,994
2016,Mali,Kadiolo,4,11,0,2,11,2,0,30,7,5,0,1,5,2,0,20
2016,Mali,Kayes : Region,1261,1961,0,1252,2750,189,0,7413,1322,2098,0,1239,2847,313,0,7819
2016,Mali,Kidal,13,29,0,24,102,1,0,169,16,20,0,34,123,4,0,197
2016,Mali,Koulikoro,0,1,0,1,6,0,0,8,0,2,0,0,6,2,0,10
2016,Mali,Menaka : Region,21,43,0,27,56,10,0,157,17,51,0,27,47,9,0,151
2016,Mali,Mopti : Region,41,98,0,42,107,14,0,302,46,96,0,54,75,12,0,283
2016,Mali,Segou,8,61,0,33,80,5,0,187,11,55,0,38,41,6,0,151
2016,Mali,Sikasso : Region,44,51,0,31,84,4,0,214,40,36,0,23,95,1,0,195
2016,Mali,Tombouctou,245,669,0,399,1227,153,0,2693,276,649,0,361,852,143,0,2281
2016,Malta,Block C Registrations : Point,0,0,0,0,0,0,0,0,0,0,0,0,0,0,0,0
2016,Malta,Community,0,0,0,0,0,0,0,0,0,0,0,0,0,0,0,0
2016,Malta,Dar Il-Liedna : Point,0,0,0,0,0,0,0,0,0,0,0,0,0,0,0,0
2016,Malta,Hal Far Tent Village : Point,0,0,0,0,0,0,0,0,0,0,0,0,0,0,0,0
2016,Malta,Marsa Open Centre,0,0,0,0,0,0,0,0,0,0,0,0,0,0,0,0
2016,Malta,MEC Balzan : Point,0,0,0,0,0,0,0,0,0,0,0,0,0,0,0,0
2016,Malta,MEC Houses : Point,0,0,0,0,0,0,0,0,0,0,0,0,0,0,0,0
2016,Malta,Peace Lab,0,0,0,0,0,0,0,0,0,0,0,0,0,0,0,0
2016,Myanmar,Bago,1,0,0,0,1,0,0,2,0,1,0,0,1,0,0,2
2016,Myanmar,Rakhine : State,12105,11152,0,8170,27981,2083,0,61491,11923,11996,0,8823,24136,2094,0,58972
2016,Myanmar,Yangon,0,1,0,2,4,1,0,8,2,2,0,1,3,1,0,9
2016,Myanmar,"Kayah, Kayin and Mon states and Tanintharyi region : Regional grouping",5,7,0,3,11,1,0,27,1,3,0,5,7,1,0,17
2016,Myanmar,Kachin and northern Shan states : Regional grouping,6349,7249,0,10777,23474,4151,0,52000,6206,7286,0,10388,20259,2894,0,47033
2016,Montenegro,Bar : Op?à?ítina - Municipality,1,1,0,1,3,5,0,11,1,4,0,0,7,4,0,16
2016,Montenegro,Bar : Op?ítina - Municipality,0,1,0,0,1,1,0,3,0,0,0,0,0,1,0,1
2016,Montenegro,Niksic : Op?ítina - Municipality,0,0,0,1,8,0,0,9,1,0,0,2,13,1,0,17
2016,Montenegro,Plav : Op?ítina - Municipality,0,0,0,0,1,0,0,1,0,0,0,0,3,0,0,3
2016,Montenegro,Rozaj : Op?ítina - Municipality,0,1,0,0,5,1,0,7,0,4,0,2,3,0,0,9
2016,Montenegro,Tivat : Op?ítina - Municipality,0,0,0,3,2,3,0,8,0,0,0,4,1,0,0,5
2016,Montenegro,Ulcinj : Op?ítina - Municipality,0,0,0,1,2,0,0,3,0,0,0,1,4,0,0,5
2016,Montenegro,Podgorica : Op?ítina - Municipality,2,15,0,22,111,21,0,171,4,18,0,32,141,18,0,213
2016,Montenegro,Pljevlja : Op?ítina - Municipality,0,1,0,0,4,0,0,5,0,0,0,2,2,1,0,5
2016,Montenegro,Montenegro : Dispersed in the country / territory,6,17,0,10,78,22,0,133,8,23,0,15,112,14,0,172
2016,Montenegro,Mojkovac : Op?à?ítina - Municipality,0,0,0,0,2,1,0,3,0,0,0,0,0,0,0,0
2016,Montenegro,Kotor : Op?à?ítina - Municipality,0,0,0,0,1,2,0,3,0,0,0,0,2,1,0,3
2016,Montenegro,Kolasin : Op?à?ítina - Municipality,0,0,0,0,0,0,0,0,0,0,0,0,1,0,0,1
2016,Montenegro,Herceg Novi : Op?à?ítina - Municipality,0,0,0,0,3,0,0,3,0,0,0,0,4,0,0,4
2016,Montenegro,Danilovgrad : Op?ítina - Municipality,0,3,0,3,13,0,0,19,1,1,0,5,71,0,0,78
2016,Montenegro,Danilovgrad : Op?à?ítina - Municipality,0,0,0,0,0,2,0,2,0,0,0,0,5,2,0,7
2016,Montenegro,Cetinje : Op?à?ítina - Municipality,0,0,0,0,0,0,0,0,0,0,0,0,1,0,0,1
2016,Montenegro,Budva : Op?à?ítina - Municipality,0,1,0,3,3,2,0,9,0,1,0,0,4,4,0,9
2016,Montenegro,Bijelo Polje : Op?à?ítina - Municipality,0,0,0,0,0,0,0,0,0,0,0,0,1,0,0,1
2016,Montenegro,Berane : Op?à?ítina - Municipality,5,10,0,3,29,4,0,51,5,13,0,4,31,2,0,55
2016,Montenegro,Andrijevica : Op?à?ítina - Municipality,0,0,0,1,2,0,0,3,0,0,0,0,6,1,0,7
2016,Mongolia,Ulaanbaatar : Capital city,1,0,0,0,5,0,0,6,0,0,0,0,7,0,0,7
2016,Mozambique,Cabo Delgado : Provincia,27,12,0,2,79,0,0,120,25,9,0,2,307,1,0,344
2016,Mozambique,Gaza : Provincia,0,1,0,0,1,0,0,2,0,1,0,0,1,0,0,2
2016,Mozambique,Manica : Provincia,0,1,0,2,3,0,0,6,1,1,0,0,13,0,0,15
2016,Mozambique,Maputo Provincia : Provincia,163,200,0,138,708,14,0,1223,167,221,0,149,1166,29,0,1732
2016,Mozambique,Maratane : Point,669,842,0,587,1704,93,0,3895,688,946,0,641,2363,40,0,4678
2016,Mozambique,Nampula : Provincia,206,179,0,95,565,4,0,1049,239,168,0,83,1681,18,0,2189
2016,Mozambique,Niassa : Provincia,14,22,0,12,47,1,0,96,15,17,0,14,115,3,0,164
2016,Mozambique,Sofala : Provincia,2,0,0,0,4,0,0,6,0,0,0,4,20,0,0,24
2016,Mozambique,Tete : Provincia,0,0,0,0,0,0,0,0,0,0,0,0,16,0,0,16
2016,Mozambique,Zambezia : Provincia,30,32,0,10,74,0,0,146,31,20,0,15,181,0,0,247
2016,Mozambique,Maputo : Cidade capital - Capital City,73,116,0,97,413,18,0,717,84,122,0,85,667,22,0,980
2016,Mauritania,Mauritania : Dispersed in the country / territory,0,0,0,0,0,0,0,0,0,0,0,0,0,0,0,0
2016,Mauritania,Mbera : Point,3252,6208,0,3093,11144,1384,0,25081,3298,6069,0,3143,7899,1150,0,21559
2016,Mauritania,Nouakchott and Nouadhibou : Regional grouping,115,191,0,144,447,19,0,916,101,133,0,132,788,25,0,1179
2016,Mauritius,Mauritius,0,0,0,0,1,0,0,1,1,0,0,2,1,0,0,4
2016,Malawi,Dzaleka : Point,2226,2921,0,2050,5270,196,0,12663,2240,3071,0,2215,6589,141,0,14256
2016,Malawi,Luwani Refugee Camp,391,446,0,216,655,47,0,1755,399,458,0,263,577,44,0,1741
2016,Malaysia,Sabah,0,0,0,0,0,0,0,0,0,0,0,0,0,0,0,0
2016,Malaysia,Kuala Lumpur : Wilayah Persekutuan - Federal territory,8710,4677,0,2648,31521,707,0,48263,9243,5040,0,3873,81227,928,0,100311
2016,Namibia,Osire : Point,228,296,0,180,755,16,0,1475,226,294,0,251,1220,20,0,2011
2016,Niger,Ayourou : Point,42,49,0,202,90,24,0,407,40,45,0,114,102,22,0,323
2016,Niger,Camp Abala : Point,1184,1346,0,3131,2121,237,0,8019,1146,1222,0,1899,2100,218,0,6585
2016,Niger,Diffa,23863,31835,0,12121,48463,3378,0,119660,26961,35279,0,13257,40327,6076,0,121900
2016,Niger,Goure,5,13,0,9,37,6,0,70,5,19,0,11,43,5,0,83
2016,Niger,Intikane,1049,1427,0,3886,3126,201,0,9689,1116,1315,0,2510,3305,258,0,8504
2016,Niger,Mangaize : Point,755,658,0,1913,1331,157,0,4814,757,757,0,1273,1370,164,0,4321
2016,Niger,Niamey : Capital district,273,418,0,1000,528,158,0,2377,255,382,0,352,582,66,0,1637
2016,Niger,Tabareybarey : Point,706,896,0,2366,1567,185,0,5720,773,805,0,1088,1496,158,0,4320
2016,Niger,Tazalit,229,237,0,773,669,50,0,1958,250,274,0,568,686,62,0,1840
2016,Nigeria,Abuja FCT,4,0,0,4,2,0,0,10,3,0,0,0,4,0,0,7
2016,Nigeria,Admawa,0,0,0,0,0,0,0,0,0,0,0,0,0,0,0,0
2016,Nigeria,Amana : Point,0,0,0,0,0,0,0,0,0,0,0,0,1,0,0,1
2016,Nigeria,Bauchi,0,0,0,0,0,0,0,0,0,0,0,0,0,0,0,0
2016,Nigeria,Benue,0,0,0,0,0,0,0,0,0,0,0,0,0,0,0,0
2016,Nigeria,Benue : State,0,1,0,1,5,0,0,7,0,0,0,3,6,0,0,9
2016,Nigeria,Borno,0,0,0,0,0,0,0,0,0,0,0,0,0,0,0,0
2016,Nigeria,Gombe,0,0,0,0,0,0,0,0,0,0,0,0,0,0,0,0
2016,Nigeria,Ijebuode : Local government area,3,4,0,2,8,0,0,17,1,7,0,3,30,0,0,41
2016,Nigeria,Kaduna,0,0,0,0,0,0,0,0,0,0,0,0,0,0,0,0
2016,Nigeria,Kano,0,0,0,0,0,0,0,0,0,0,0,0,0,0,0,0
2016,Nigeria,Lagos : State,51,99,0,102,332,0,0,584,64,96,0,65,680,11,0,916
2016,Nigeria,Nasarawa,0,0,0,0,0,0,0,0,0,0,0,0,0,0,0,0
2016,Nigeria,Plateau,0,0,0,0,0,0,0,0,0,0,0,0,0,0,0,0
2016,Nigeria,Taraba,0,0,0,0,0,0,0,0,0,0,0,0,0,0,0,0
2016,Nigeria,Yobe,0,0,0,0,0,0,0,0,0,0,0,0,0,0,0,0
2016,Nigeria,Zamfara,0,0,0,0,0,0,0,0,0,0,0,0,0,0,0,0
2016,Nigeria,Nigeria : Dispersed in the country / territory,4,15,0,6,42,1,0,68,13,10,0,13,134,4,0,174
2016,Nicaragua,Nicaragua : Dispersed in the country / territory,25,32,0,76,140,28,0,301,23,36,0,118,170,19,0,366
2016,Netherlands,Netherlands : Dispersed in the country / territory,0,0,0,0,0,0,0,0,0,0,0,0,0,0,0,0
2016,Norway,Norway : Dispersed in the country / territory,0,0,0,0,0,0,0,0,0,0,0,0,0,0,0,0
2016,Nepal,Beldangi : Point,375,630,0,551,2814,361,0,4731,398,693,0,532,2639,504,0,4766
2016,Nepal,Kathmandu : District,34,47,0,24,157,3,0,265,32,59,0,30,207,6,0,334
2016,Nepal,Kathmandu: District,0,0,0,0,0,0,0,0,0,0,0,0,0,0,0,0
2016,Nepal,Sanischare : Point,101,163,0,120,684,83,0,1151,111,160,0,114,627,102,0,1114
2016,Nepal,Nepal : Dispersed in the country / territory,0,1,0,2,7281,3,0,7287,1,0,0,2,6513,6,0,6522
2016,Nauru,Nauru,0,0,0,0,0,0,0,0,0,0,0,0,0,0,0,0
2016,New Zealand,New Zealand : Dispersed in the country / territory,0,0,0,0,0,0,0,0,0,0,0,0,0,0,0,0
2016,Oman,Oman : Dispersed in the country / territory,31,69,0,45,183,21,0,349,43,46,0,43,188,14,0,334
2016,Pakistan,Akora Khattak,1370,3543,0,2241,5903,456,0,13513,1477,3661,0,2533,6942,816,0,15429
2016,Pakistan,Badaber : Point,1026,1930,0,1452,3599,285,0,8292,1150,2030,0,1439,4411,477,0,9507
2016,Pakistan,Baghicha : Point,80,223,0,152,376,33,0,864,84,244,0,166,426,41,0,961
2016,Pakistan,Balochistan : Province,14784,26334,0,22111,51545,4964,0,119738,15511,27952,0,24184,59391,9337,0,136375
2016,Pakistan,Barakai : Point,1028,1871,0,1663,4441,332,0,9335,1057,2028,0,1785,4911,616,0,10397
2016,Pakistan,Barari : Point,411,727,0,553,1479,145,0,3315,448,705,0,571,1719,215,0,3658
2016,Pakistan,Barawal : Point,2,28,0,32,50,3,0,115,2,30,0,23,94,9,0,158
2016,Pakistan,Basu Mera : Point,354,397,0,389,1070,81,0,2291,348,448,0,417,1126,139,0,2478
2016,Pakistan,Bizen Khel : Point,1,137,0,137,333,28,0,636,2,157,0,177,386,43,0,765
2016,Pakistan,Chagai,3,13,0,16,32,5,0,69,3,29,0,12,39,5,0,88
2016,Pakistan,Chakdara : Point,823,1488,0,1060,2438,142,0,5951,848,1581,0,1054,2852,245,0,6580
2016,Pakistan,Chichana : Point,110,293,0,238,715,70,0,1426,121,362,0,223,961,138,0,1805
2016,Pakistan,Dabara : Point,60,92,0,60,117,13,0,342,40,117,0,64,199,29,0,449
2016,Pakistan,Darsamand : Point,124,335,0,260,710,94,0,1523,132,379,0,293,902,132,0,1838
2016,Pakistan,Gahzgai Minara : Point,99,164,0,161,296,28,0,748,92,198,0,205,383,65,0,943
2016,Pakistan,Gamkol : Point,1861,3189,0,2481,6220,505,0,14256,1985,3255,0,2543,7625,810,0,16218
2016,Pakistan,Gandaf : Point,778,1198,0,874,2184,197,0,5231,798,1275,0,967,2512,240,0,5792
2016,Pakistan,Gandhi Khan Khel : Point,159,445,0,443,928,105,0,2080,178,520,0,442,1056,174,0,2370
2016,Pakistan,Ghulam Banda : Point,535,918,0,649,1744,134,0,3980,550,954,0,719,2000,247,0,4470
2016,Pakistan,Ichrian : Point,194,302,0,220,538,51,0,1305,199,294,0,221,712,70,0,1496
2016,Pakistan,Jalala : Point,467,1096,0,728,2037,180,0,4508,478,1091,0,843,2380,277,0,5069
2016,Pakistan,Kababian : Point,409,880,0,584,1589,97,0,3559,463,924,0,607,2398,191,0,4583
2016,Pakistan,Kahi,141,420,0,314,865,107,0,1847,145,496,0,315,1133,166,0,2255
2016,Pakistan,Kalkatak : Point,105,184,0,147,371,23,0,830,118,208,0,159,467,46,0,998
2016,Pakistan,Karachi : District,18,45,0,54,164,8,0,289,24,50,0,49,133,7,0,263
2016,Pakistan,Kata Kanri : Point,458,668,0,511,1262,167,0,3066,452,721,0,576,1614,203,0,3566
2016,Pakistan,Khairabad : Point,414,1646,0,1275,2546,282,0,6163,517,1718,0,1281,2785,359,0,6660
2016,Pakistan,Khaki : Point,716,954,0,726,1898,200,0,4494,800,986,0,760,2290,276,0,5112
2016,Pakistan,Khazana : Point,299,547,0,383,970,83,0,2282,321,529,0,399,1168,123,0,2540
2016,Pakistan,Khurasan : Point,136,295,0,207,700,68,0,1406,137,275,0,219,843,79,0,1553
2016,Pakistan,Khyber Pakhtunkhwa : Province,110567,168950,0,89464,335844,30520,0,735345,134779,195484,0,115603,355518,35187,0,836571
2016,Pakistan,Koga : Point,412,923,0,714,1745,148,0,3942,490,949,0,777,1800,225,0,4241
2016,Pakistan,Kot Chandna : Point,1397,1570,0,1113,3124,192,0,7396,1391,1705,0,1091,2987,392,0,7566
2016,Pakistan,Kotwai : Point,395,569,0,526,1038,116,0,2644,455,592,0,572,957,210,0,2786
2016,Pakistan,Lakhti Banda : Point,262,425,0,261,807,119,0,1874,317,434,0,314,943,163,0,2171
2016,Pakistan,Lejay Karez : Point,16,61,0,53,110,13,0,253,10,62,0,45,177,38,0,332
2016,Pakistan,Malgagai : Point,445,589,0,491,1013,142,0,2680,469,629,0,536,1370,224,0,3228
2016,Pakistan,Mera Kachori : Point,126,316,0,250,665,59,0,1416,142,303,0,251,737,81,0,1514
2016,Pakistan,Mohammad Kheil : Point,666,572,0,551,1040,77,0,2906,701,577,0,644,1199,169,0,3290
2016,Pakistan,Munda : Point,289,553,0,437,1069,96,0,2444,354,551,0,426,1320,164,0,2815
2016,Pakistan,Naguman : Point,157,232,0,210,448,42,0,1089,161,265,0,187,556,67,0,1236
2016,Pakistan,Oblan : Point,599,1030,0,791,1858,178,0,4456,645,1113,0,786,2126,271,0,4941
2016,Pakistan,Old Shamshatoo,1780,3811,0,3044,8879,549,0,18063,2011,4129,0,3349,10258,1157,0,20904
2016,Pakistan,Padhana : Point,609,684,0,669,1635,131,0,3728,595,659,0,744,1794,236,0,4028
2016,Pakistan,Panian : Point,2977,3937,0,4116,9278,962,0,21270,3047,4263,0,4458,10004,1339,0,23111
2016,Pakistan,Posti : Point,3,22,0,16,30,3,0,74,8,28,0,18,32,9,0,95
2016,Pakistan,Punjab : Province,8714,13950,0,11345,28165,2565,0,64739,9442,14831,0,12341,36637,4035,0,77286
2016,Pakistan,Quetta : District,160,299,0,245,871,53,0,1628,139,371,0,271,481,16,0,1278
2016,Pakistan,Saranan : Point,2132,1420,0,1538,2636,279,0,8005,2264,1541,0,1679,3983,644,0,10111
2016,Pakistan,Sindh : Province,4250,6329,0,5033,13523,984,0,30119,4647,6719,0,5254,16117,1897,0,34634
2016,Pakistan,Surkhab : Point,254,562,0,523,1114,98,0,2551,337,546,0,593,1429,240,0,3145
2016,Pakistan,Thall : Point,418,917,0,745,1871,239,0,4190,405,967,0,770,2243,373,0,4758
2016,Pakistan,Timer : Point,884,1126,0,876,2045,146,0,5077,989,1187,0,921,2116,222,0,5435
2016,Pakistan,Toor : Point,314,329,0,249,598,53,0,1543,322,358,0,270,830,86,0,1866
2016,Pakistan,Utmanzai : Point,210,330,0,302,682,68,0,1592,221,391,0,353,750,109,0,1824
2016,Pakistan,Zafarabad : Point,129,326,0,303,609,64,0,1431,141,317,0,337,933,135,0,1863
2016,Pakistan,Zangal Patai : Point,4,21,0,8,23,0,0,56,10,11,0,10,27,4,0,62
2016,Pakistan,Zar Karez : Point,290,446,0,414,779,92,0,2021,310,457,0,448,913,142,0,2270
2016,Pakistan,Islamabad : Federal capital territory,2108,3224,0,2597,6904,570,0,15403,2329,3415,0,2921,8212,946,0,17823
2016,Pakistan,Azad Kashmir : Pakistan administered area,277,297,0,263,737,63,0,1637,309,343,0,301,1068,135,0,2156
2016,Panama,Panama : Dispersed in the country / territory,385,859,0,2226,4899,890,0,9259,424,949,0,2799,7388,1004,0,12564
2016,Peru,Peru : Dispersed in the country / territory,0,0,0,0,0,0,0,0,0,0,0,0,0,0,0,0
2016,Philippines,Agusan Del Sur,0,0,0,0,0,0,0,0,0,0,0,0,0,0,0,0
2016,Philippines,BASILAN,0,0,0,0,0,0,0,0,0,0,0,0,0,0,0,0
2016,Philippines,BUKIDNON,0,0,0,0,0,0,0,0,0,0,0,0,0,0,0,0
2016,Philippines,CALABARZON (Region IV-A ) : Region,1,1,0,3,15,1,0,21,0,0,0,3,70,4,0,77
2016,Philippines,Central Luzon (Region III) : Region,1,2,0,0,4,0,0,7,1,0,0,0,26,2,0,29
2016,Philippines,Compostela Valley,0,0,0,0,0,0,0,0,0,0,0,0,0,0,0,0
2016,Philippines,Cordillera Administrative Region,0,0,0,0,1,0,0,1,0,0,0,0,5,0,0,5
2016,Philippines,Davao (Region XI) : Region,0,1,0,0,2,0,0,3,0,0,0,0,4,0,0,4
2016,Philippines,Davao del Norte,4,8,0,4,22,3,0,41,3,8,0,7,11,0,0,29
2016,Philippines,Davao del Sur,130,234,0,116,582,46,0,1108,121,239,0,99,508,67,0,1034
2016,Philippines,Davao Oriental,38,73,0,44,182,14,0,351,45,68,0,40,156,21,0,330
2016,Philippines,Ilocos Region,0,0,0,1,2,0,0,3,0,0,0,0,12,1,0,13
2016,Philippines,LANAO DEL NORTE,0,0,0,0,0,0,0,0,0,0,0,0,0,0,0,0
2016,Philippines,LANAO DEL SUR,0,0,0,0,0,0,0,0,0,0,0,0,0,0,0,0
2016,Philippines,MAGUINDANAO,0,0,0,0,0,0,0,0,0,0,0,0,0,0,0,0
2016,Philippines,MIMAROPA (Region IV-B) : Region,0,0,0,0,0,0,0,0,0,0,0,0,0,1,0,1
2016,Philippines,MISAMIS ORIENTAL,0,0,0,0,0,0,0,0,0,0,0,0,0,0,0,0
2016,Philippines,National Capital Region,3,10,0,6,66,5,0,90,7,7,0,3,196,15,0,228
2016,Philippines,National Capital Region (NCR) : Region,0,0,0,0,0,0,0,0,0,0,0,0,3,1,0,4
2016,Philippines,Negros Island Region,0,0,0,0,0,0,0,0,0,0,0,0,6,0,0,6
2016,Philippines,NORTH COTABATO,4,6,0,9,28,5,0,52,11,10,0,10,29,3,0,63
2016,Philippines,Northern Mindanao,0,0,0,0,0,0,0,0,0,0,0,0,2,0,0,2
2016,Philippines,Region 5,0,0,0,0,0,0,0,0,0,0,0,0,3,1,0,4
2016,Philippines,Region 7,0,0,0,0,1,0,0,1,0,0,0,0,16,0,0,16
2016,Philippines,Region 8,0,0,0,0,1,0,0,1,0,0,0,0,0,0,0,0
2016,Philippines,SARANGANI PROVINCE,62,60,0,36,247,23,0,428,84,66,0,23,185,35,0,393
2016,Philippines,SOCCSKSARGEN,0,0,0,0,0,0,0,0,0,0,0,0,3,0,0,3
2016,Philippines,South Cotabato,66,62,0,47,207,24,0,406,55,63,0,45,99,10,0,272
2016,Philippines,Sultan Kudarat,10,16,0,8,39,2,0,75,9,12,0,5,18,7,0,51
2016,Philippines,SULU,0,0,0,0,0,0,0,0,0,0,0,0,0,0,0,0
2016,Philippines,SURIGAO DEL NORTE,0,0,0,0,0,0,0,0,0,0,0,0,0,0,0,0
2016,Philippines,SURIGAO DEL SUR,0,0,0,0,0,0,0,0,0,0,0,0,0,0,0,0
2016,Philippines,Zamboanga del Sur,0,0,0,0,0,0,0,0,0,0,0,0,0,0,0,0
2016,Philippines,Zamboanga Peninsula (Region IX) : Region,0,0,0,0,0,0,0,0,0,0,0,0,0,1,0,1
2016,Philippines,Philippines : Dispersed in the country / territory,1,1,0,2,48,2,0,54,2,4,0,1,110,2,0,119
2016,Palau,Koror : State,0,0,0,0,0,0,0,0,0,0,0,0,1,0,0,1
2016,Papua New Guinea,Papua New Guinea : Dispersed in the country / territory,0,0,0,0,0,0,0,0,0,0,0,0,0,0,0,0
2016,Poland,Bezwola,26,34,0,13,54,1,0,128,22,37,0,16,43,0,0,118
2016,Poland,Biala Podlaska : Powiat - County,14,26,0,12,40,1,0,93,20,28,0,20,42,2,0,112
2016,Poland,Bialystok : Powiat - County,18,27,0,10,35,1,0,91,25,31,0,10,30,1,0,97
2016,Poland,Czerwony Bor : Point,13,22,0,7,34,1,0,77,13,16,0,13,33,0,0,75
2016,Poland,Debak : Point,8,20,0,11,39,0,0,78,17,19,0,15,48,0,0,99
2016,Poland,Grotniki : Point,7,16,0,4,20,0,0,47,16,13,0,1,17,0,0,47
2016,Poland,Grupa : Point,11,23,0,8,31,0,0,73,11,27,0,12,32,0,0,82
2016,Poland,Horbow : Point,19,26,0,7,31,0,0,83,13,21,0,9,33,1,0,77
2016,Poland,Linin : Point,24,23,0,10,52,2,0,111,31,31,0,17,70,2,0,151
2016,Poland,Lukow : Powiat - County,15,29,0,11,36,0,0,91,19,21,0,12,35,0,0,87
2016,Poland,Poland,0,0,0,0,0,0,0,0,0,0,0,0,0,0,0,0
2016,Poland,Warsaw : Powiat - County,10,13,0,12,47,3,0,85,15,20,0,9,0,0,0,44
2016,Portugal,Portugal : Dispersed in the country / territory,0,0,0,0,0,0,0,0,0,0,0,0,0,0,0,0
2016,Paraguay,Paraguay : Dispersed in the country / territory,0,0,0,0,0,0,0,0,0,0,0,0,0,0,0,0
2016,Qatar,Qatar : Dispersed in the country / territory,16,22,0,19,93,10,0,160,13,25,0,9,95,17,0,159
2016,Romania,Romania : Dispersed in the country / territory,124,140,0,95,569,40,0,968,151,157,0,111,1464,54,0,1937
2016,Russian Federation,Russian Federation : Dispersed in the country / territory,0,0,0,0,0,0,0,0,0,0,0,0,0,0,0,0
2016,Rwanda,Bugesera,26,28,0,11,42,2,0,109,19,19,0,16,55,2,0,111
2016,Rwanda,Gatore,26,19,0,13,36,7,0,101,19,26,0,20,99,7,0,171
2016,Rwanda,Gatsibo : Akarere - District,990,1519,0,1436,3610,280,0,7835,1019,1500,0,1336,2370,202,0,6427
2016,Rwanda,Gihembe,933,1016,0,1040,3441,480,0,6910,906,1109,0,979,2549,233,0,5776
2016,Rwanda,Gisagara : Akarere - District,714,1066,0,873,2288,190,0,5131,743,1068,0,754,978,118,0,3661
2016,Rwanda,Huye : Akarere - District,172,343,0,224,962,44,0,1745,190,358,0,272,662,25,0,1507
2016,Rwanda,Kigali : Point,1377,2477,0,1748,8657,332,0,14591,1409,2467,0,1678,8753,199,0,14506
2016,Rwanda,Kirehe,4419,5057,0,3490,12089,820,0,25875,4646,5161,0,3780,12714,458,0,26759
2016,Rwanda,Kiziba : Point,1192,1641,0,1297,4626,529,0,9285,1162,1464,0,1285,3517,428,0,7856
2016,Rwanda,Nyamagabe : Akarere - District,1448,2296,0,1756,4871,388,0,10759,1483,2282,0,1712,2966,289,0,8732
2016,Rwanda,Nyanza,16,11,0,8,22,4,0,61,12,15,0,12,59,4,0,102
2016,Rwanda,Rubavu : Akarere - District,600,434,0,165,377,36,0,1612,559,449,0,166,1248,52,0,2474
2016,Rwanda,Nyagatare (Cyangugu) : Akarere - District,239,189,0,73,416,16,0,933,197,191,0,47,92,7,0,534
2016,Saudi Arabia,KSA various,7,10,0,16,49,4,0,86,5,14,0,17,67,1,0,104
2016,Sudan,Abu Rakham area : Point,1,24,0,32,114,20,0,191,0,25,0,32,107,28,0,192
2016,Sudan,Abuda : Point,137,353,0,371,750,84,0,1695,135,349,0,353,661,105,0,1603
2016,Sudan,Adingrar,0,0,0,0,0,1,0,1,0,0,0,0,1,0,0,1
2016,Sudan,Aroma : Point,0,4,0,1,3,0,0,8,0,0,0,3,5,0,0,8
2016,Sudan,Asotriba : Point,1,1,0,0,3,0,0,5,1,2,0,0,5,1,0,9
2016,Sudan,Awad El Seid : Point,0,24,0,47,160,28,0,259,0,43,0,42,126,42,0,253
2016,Sudan,Basonda : Point,0,0,0,0,1,0,0,1,0,2,0,0,0,0,0,2
2016,Sudan,Blue Nile : Wilayat - State,0,0,0,0,0,0,0,0,0,0,0,0,0,0,0,0
2016,Sudan,Central Darfur : Wilayat - State,867,1010,0,662,1939,253,0,4731,950,951,0,603,1127,141,0,3772
2016,Sudan,Daim : Point,0,2,0,3,1,0,0,6,1,2,0,0,3,0,0,6
2016,Sudan,Dehama : Point,0,0,0,0,0,0,0,0,0,0,0,0,1,1,0,2
2016,Sudan,Diam El-Nour : Point,4,20,0,15,120,8,0,167,8,19,0,21,207,18,0,273
2016,Sudan,Doka : Point,1,1,0,4,3,1,0,10,3,1,0,4,1,1,0,10
2016,Sudan,Dordeab : Point,0,1,0,2,5,0,0,8,0,1,0,0,1,0,0,2
2016,Sudan,Eastern Darfur,0,0,0,0,0,0,0,0,0,0,0,0,0,0,0,0
2016,Sudan,Eastern Darfur : Wilayat - State,0,0,0,0,0,0,0,0,0,0,0,0,0,0,0,0
2016,Sudan,FATH EL RAHMAN : Point,0,14,0,19,103,17,0,153,0,16,0,21,72,26,0,135
2016,Sudan,Fau 5 : Point,7,70,0,80,229,31,0,417,6,83,0,89,218,51,0,447
2016,Sudan,Fau Town : Point,0,0,0,1,1,0,0,2,0,2,0,1,0,0,0,3
2016,Sudan,Gadaref : Wilayat - State,52,161,0,284,262,17,0,776,52,205,0,295,375,42,0,969
2016,Sudan,Geref : Point,0,2,0,1,6,0,0,9,1,3,0,2,11,0,0,17
2016,Sudan,Girba : Point,131,587,0,425,1864,240,0,3247,145,644,0,420,1391,322,0,2922
2016,Sudan,GIRBA TOWN,0,3,0,2,7,3,0,15,1,5,0,2,13,2,0,23
2016,Sudan,Gulsa : Point,0,3,0,8,22,1,0,34,0,3,0,2,11,3,0,19
2016,Sudan,Hasahisa : Point,9,15,0,31,4,0,0,59,3,9,0,24,2,0,0,38
2016,Sudan,Hawata : Point,0,2,0,0,2,0,0,4,0,0,0,0,0,0,0,0
2016,Sudan,Kalakla : Point,0,0,0,0,0,0,0,0,0,0,0,1,2,0,0,3
2016,Sudan,Karkora : Point,0,4,0,2,12,4,0,22,0,3,0,3,11,2,0,19
2016,Sudan,Kassala : Wilayat - State,88,346,0,263,1288,118,0,2103,65,355,0,300,1543,153,0,2416
2016,Sudan,Khartoum : Wilayat - State,1065,2466,0,2275,10516,610,0,16932,1210,2570,0,2696,12444,1046,0,19966
2016,Sudan,Khartoum North : Point,3,1,0,1,1,0,0,6,0,1,0,2,2,0,0,5
2016,Sudan,Kilo 26 : Point,159,735,0,583,2398,328,0,4203,163,833,0,555,1970,422,0,3943
2016,Sudan,Kilo 7 : Point,0,17,0,19,82,16,0,134,0,26,0,25,71,18,0,140
2016,Sudan,Laffa : Point,0,1,0,0,5,2,0,8,0,0,0,1,0,0,0,1
2016,Sudan,Mafaza : Point,0,0,0,0,1,0,0,1,0,0,0,0,0,0,0,0
2016,Sudan,Marghania : Point,0,11,0,5,38,3,0,57,1,5,0,10,80,3,0,99
2016,Sudan,New Halfa : Point,8,13,0,5,83,0,0,109,6,19,0,8,818,11,0,862
2016,Sudan,North Kordofan : Wilayat - State,0,0,0,0,0,0,0,0,0,0,0,0,0,0,0,0
2016,Sudan,Northern Darfur : Wilayat - State,0,0,0,0,0,0,0,0,0,0,0,0,0,0,0,0
2016,Sudan,Port Sudan : District,58,115,0,109,453,41,0,776,53,155,0,97,759,86,0,1150
2016,Sudan,Red Sea : Wilayat - State,0,0,0,0,0,0,0,0,0,0,0,0,0,0,0,0
2016,Sudan,Safawa : Point,0,0,0,0,3,1,0,4,0,0,0,0,0,0,0,0
2016,Sudan,Salalab : Point,12,35,0,29,136,3,0,215,23,33,0,27,172,16,0,271
2016,Sudan,Salmin : Point,0,1,0,0,1,0,0,2,0,0,0,1,1,0,0,2
2016,Sudan,Sennar : Wilayat - State,0,0,0,0,0,0,0,0,0,0,0,0,0,0,0,0
2016,Sudan,Shagarab 1 : Point,888,1943,0,2183,4421,346,0,9781,939,2162,0,2719,5146,492,0,11458
2016,Sudan,Shagarab 2 : Point,356,1117,0,922,2815,255,0,5465,331,1152,0,962,1932,388,0,4765
2016,Sudan,Shagarab 3 : Point,184,601,0,503,1776,206,0,3270,168,596,0,465,1190,299,0,2718
2016,Sudan,Showak,2,5,0,9,9,3,0,28,3,9,0,15,14,3,0,44
2016,Sudan,Sinkat : District,0,0,0,0,0,0,0,0,0,0,0,0,3,0,0,3
2016,Sudan,South Kordofan : Wilayat - State,0,0,0,0,0,0,0,0,0,0,0,0,0,0,0,0
2016,Sudan,Southern Darfur : Wilayat - State,87,192,0,106,288,28,0,701,99,187,0,104,297,18,0,705
2016,Sudan,Suba,0,0,0,0,0,0,0,0,0,0,0,0,1,0,0,1
2016,Sudan,Suwakin : Point,0,9,0,3,9,1,0,22,2,4,0,2,43,3,0,54
2016,Sudan,Tawawa,0,0,0,1,0,0,0,1,0,0,0,0,1,0,0,1
2016,Sudan,Tokar : District,1,0,0,0,1,0,0,2,0,0,0,0,1,0,0,1
2016,Sudan,Um Ali : Point,0,8,0,15,13,2,0,38,3,5,0,7,11,2,0,28
2016,Sudan,Um Gargur : Point,247,868,0,642,2663,338,0,4758,279,896,0,726,2514,482,0,4897
2016,Sudan,Um Gulja : Point,15,33,0,40,26,4,0,118,7,24,0,44,40,6,0,121
2016,Sudan,Um Rakuba : Point,1,14,0,10,3,0,0,28,6,4,0,23,4,2,0,39
2016,Sudan,Um Sagata,0,0,0,2,2,0,0,4,0,0,0,1,1,1,0,3
2016,Sudan,Wad El Hileau : Point,17,58,0,79,85,9,0,248,17,45,0,67,69,9,0,207
2016,Sudan,Wad Medani : Point,18,34,0,154,19,0,0,225,28,43,0,136,14,1,0,222
2016,Sudan,Wad Sherife : Point,585,1457,0,1183,5498,835,0,9558,655,1520,0,1228,3534,757,0,7694
2016,Sudan,Wad Sherife village,21,58,0,98,309,36,0,522,16,97,0,83,168,21,0,385
2016,Sudan,West Kordofan : Wilayat - State,0,0,0,0,0,0,0,0,0,0,0,0,0,0,0,0
2016,Sudan,Western Darfur : Wilayat - State,0,2,0,0,7,0,0,9,1,3,0,0,27,0,0,31
2016,Sudan,White Nile : Wilayat - State,0,0,0,0,0,0,0,0,0,0,0,0,0,0,0,0
2016,Sudan,White Nile :Wilayat - State,9826,13921,0,8704,17980,1821,0,52252,9959,13819,0,7627,9536,677,0,41618
2016,Senegal,Dakar : Point,153,213,0,182,1207,28,0,1783,158,253,0,207,2496,44,0,3158
2016,Senegal,Dakar/Thies : Point,6,17,0,16,29,1,0,69,10,25,0,20,57,3,0,115
2016,Senegal,Richard Toll : Point,1346,1626,0,755,2743,270,0,6740,1376,1525,0,724,2056,227,0,5908
2016,Senegal,Saint Louis,1,2,0,0,9,0,0,12,3,1,0,0,13,1,0,18
2016,Singapore,Singapore : Dispersed in the country / territory,0,0,0,0,1,0,0,1,0,0,0,0,0,0,0,0
2016,Sierra Leone,Bandajuma : Point,1,1,0,3,7,0,0,12,1,1,0,4,5,3,0,14
2016,Sierra Leone,Bo : District,1,3,0,5,16,3,0,28,3,4,0,4,5,2,0,18
2016,Sierra Leone,Freetown : Point,10,4,0,10,47,4,0,75,9,13,0,9,52,2,0,85
2016,Sierra Leone,Gerihun : Point,4,6,0,7,9,1,0,27,3,2,0,2,11,0,0,18
2016,Sierra Leone,Gondama : Point,9,12,0,21,42,2,0,86,3,9,0,18,27,1,0,58
2016,Sierra Leone,Jembe : Point,1,2,0,4,6,0,0,13,2,4,0,8,7,1,0,22
2016,Sierra Leone,Jimmi Bago,6,9,0,9,22,1,0,47,7,8,0,8,27,2,0,52
2016,Sierra Leone,Kenema : District,2,1,0,2,16,2,0,23,3,2,0,4,22,3,0,34
2016,Sierra Leone,Largo : Point,2,2,0,3,2,1,0,10,1,1,0,3,4,1,0,10
2016,Sierra Leone,Taiama : Point,3,3,0,2,10,2,0,20,1,2,0,3,6,1,0,13
2016,Sierra Leone,Tobanda : Point,1,3,0,2,7,1,0,14,2,3,0,1,4,1,0,11
2016,El Salvador,El Salvador : Dispersed in the country / territory,1,1,0,4,10,3,0,19,1,1,0,1,20,4,0,27
2016,Somalia,Awdal : Gobolka - Region,1989,1899,0,822,2525,265,0,7500,2613,2343,0,1135,2259,241,0,8591
2016,Somalia,Bakool : Gobolka - Region,2458,2330,0,1002,3091,325,0,9206,3223,2877,0,1396,2766,296,0,10558
2016,Somalia,Banaadir : Gobolka - Region,50513,48215,0,20950,64230,6656,0,190564,66088,59454,0,28989,57537,6116,0,218184
2016,Somalia,Bari : Gobolka - Region,7512,7653,0,3414,10567,1025,0,30171,9709,9238,0,4544,9706,985,0,34182
2016,Somalia,Bay : Gobolka - Region,10208,9960,0,4402,13009,1301,0,38880,13234,12243,0,6059,11528,1249,0,44313
2016,Somalia,Galgaduud : Gobolka - Region,14897,14116,0,6074,18722,1968,0,55777,19535,17442,0,8463,16755,1796,0,63991
2016,Somalia,Gedo : Gobolka - Region,13856,13299,0,5772,17558,1818,0,52303,18070,16340,0,8023,15655,1679,0,59767
2016,Somalia,Hiraan : Gobolka - Region,6579,6234,0,2682,8269,869,0,24633,8628,7704,0,3738,7401,794,0,28265
2016,Somalia,Juba Dhexe : Gobolka - Region,3358,3182,0,1369,4221,444,0,12574,4404,3932,0,1908,3777,405,0,14426
2016,Somalia,Juba Hoose : Gobolka - Region,19544,19542,0,8724,25384,2550,0,75744,25241,23747,0,11743,22156,2407,0,85294
2016,Somalia,Mudug : Gobolka - Region,9498,9033,0,3881,11988,1251,0,35651,12459,11147,0,5400,10706,1145,0,40857
2016,Somalia,Nugaal : Gobolka - Region,2425,2350,0,990,3187,319,0,9271,3174,2873,0,1378,2890,296,0,10611
2016,Somalia,Sanaag : Gobolka - Region,1103,1049,0,449,1396,146,0,4143,1445,1294,0,629,1251,135,0,4754
2016,Somalia,Shabelle Dhexe : Gobolka - Region,18297,17338,0,7461,22996,2416,0,68508,23994,21422,0,10394,20581,2205,0,78596
2016,Somalia,Shabelle Hoose : Gobolka - Region,19213,18205,0,7838,24146,2537,0,71939,25193,22499,0,10918,21616,2317,0,82543
2016,Somalia,Sool : Gobolka - Region,9365,8875,0,3819,11771,1239,0,35069,12281,10965,0,5321,10536,1129,0,40232
2016,Somalia,Togdheer : Gobolka - Region,3131,3001,0,1291,3975,413,0,11811,4104,3683,0,1799,3576,379,0,13541
2016,Somalia,Woqooyi Galbeed : Gobolka - Region,5352,5788,0,2639,9282,744,0,23805,6713,6840,0,3382,9258,731,0,26924
2016,Serbia and Kosovo (S/RES/1244 (1999)),Vojvodina : Autonomous province,2,491,0,977,7054,4279,0,12803,2,551,0,1071,7694,2509,0,11827
2016,Serbia and Kosovo (S/RES/1244 (1999)),Serbia : Dispersed in the country / territory,201,225,0,213,439,107,0,1185,202,226,0,214,439,107,0,1188
2016,Serbia and Kosovo (S/RES/1244 (1999)),Kosovo (S/RES/1244 (1999)) : Dispersed in the country / territory,1012,1117,0,1157,3397,1264,0,7947,1083,1108,0,1190,4554,1247,0,9182
2016,Serbia and Kosovo (S/RES/1244 (1999)),Central and Southern Serbia : Regional grouping,293,4899,0,6884,38424,13491,0,63991,313,5317,0,7997,40328,10936,0,64891
2016,Serbia and Kosovo (S/RES/1244 (1999)),Belgrade area,13,837,0,1425,8715,4101,0,15091,6,880,0,1597,9317,2660,0,14460
2016,Serbia and Kosovo (S/RES/1244 (1999)),Belgrade : Capital city,83,2083,0,3029,16955,6458,0,28608,77,2211,0,3388,17460,4956,0,28092
2016,South Sudan,Abyei Region,0,0,0,0,0,0,0,0,0,0,0,0,0,0,0,0
2016,South Sudan,Ajuong Thok,3724,4115,0,2420,7303,261,0,17823,3755,4164,0,2931,7629,228,0,18707
2016,South Sudan,Andari : Point,34,30,0,13,78,7,0,162,30,36,0,10,52,10,0,138
2016,South Sudan,Central Equatoria : Wilayat - State,0,0,0,0,0,0,0,0,0,0,0,0,0,0,0,0
2016,South Sudan,Doro : Point,5647,7073,0,3695,10142,646,0,27203,5987,7427,0,4004,7578,543,0,25539
2016,South Sudan,Eastern Equatoria : Wilayat - State,0,0,0,0,0,0,0,0,0,0,0,0,0,0,0,0
2016,South Sudan,Ezo : County,136,217,0,157,751,72,0,1333,136,221,0,169,460,61,0,1047
2016,South Sudan,Gendrassa,1796,2293,0,1123,3619,263,0,9094,1850,2324,0,1135,2840,341,0,8490
2016,South Sudan,Gorom : Point,161,242,0,149,461,21,0,1034,182,252,0,169,522,10,0,1135
2016,South Sudan,Jonglei : Wilayat - State,0,0,0,0,0,0,0,0,0,0,0,0,0,0,0,0
2016,South Sudan,Juba : County,179,211,0,101,672,4,0,1167,208,209,0,80,3081,78,0,3656
2016,South Sudan,Kaya,2554,3325,0,1667,5272,413,0,13231,2728,3320,0,1626,3935,536,0,12145
2016,South Sudan,Kodok,112,207,0,68,236,20,0,643,110,192,0,52,177,25,0,556
2016,South Sudan,Lakes,0,0,0,0,0,0,0,0,0,0,0,0,0,0,0,0
2016,South Sudan,Lasu : Point,873,1240,0,816,2029,201,0,5159,895,1243,0,801,1866,108,0,4913
2016,South Sudan,Makpandu : Point,353,482,0,215,770,51,0,1871,337,422,0,235,735,53,0,1782
2016,South Sudan,Maridi : County,6,44,0,17,50,0,0,117,11,35,0,17,66,1,0,130
2016,South Sudan,Morobo : County,29,43,0,25,60,3,0,160,25,57,0,29,42,5,0,158
2016,South Sudan,Naandi : Point,23,36,0,14,48,6,0,127,23,33,0,18,47,6,0,127
2016,South Sudan,Northern Bahr El Ghazal : Wilayat - State,0,0,0,0,0,0,0,0,0,0,0,0,0,0,0,0
2016,South Sudan,Pamir,766,926,0,457,1162,85,0,3396,760,999,0,515,802,57,0,3133
2016,South Sudan,Pochalla : County,156,289,0,328,623,34,0,1430,176,302,0,351,214,12,0,1055
2016,South Sudan,Source Yubu : Point,76,131,0,53,262,13,0,535,96,140,0,61,134,10,0,441
2016,South Sudan,Tambura : County,80,141,0,31,189,5,0,446,96,117,0,41,103,1,0,358
2016,South Sudan,Unity : Wilayat - State,0,0,0,0,0,0,0,0,0,0,0,0,0,0,0,0
2016,South Sudan,Upper Nile : Wilayat - State,0,0,0,0,0,0,0,0,0,0,0,0,0,0,0,0
2016,South Sudan,Warab : Wilayat - State,0,0,0,0,0,0,0,0,0,0,0,0,0,0,0,0
2016,South Sudan,Western Bahr El Ghazal : Wilayat - State,0,0,0,0,0,0,0,0,0,0,0,0,0,0,0,0
2016,South Sudan,Western Equatoria : Wilayat - State,0,0,0,0,0,0,0,0,0,0,0,0,0,0,0,0
2016,South Sudan,Yei : County,0,1,0,0,6,0,0,7,0,1,0,2,56,0,0,59
2016,South Sudan,Yida : Point,5840,8644,0,4791,11382,553,0,31210,5919,8711,0,3789,4599,337,0,23355
2016,South Sudan,Yusuf Batil,4039,5433,0,2890,8351,769,0,21482,4317,5482,0,2941,6104,954,0,19798
2016,Suriname,Suriname,1,1,0,1,14,0,0,17,2,1,0,1,27,0,0,31
2016,Slovakia,Slovakia : Dispersed in country / territory,4,35,0,39,792,0,0,870,0,69,0,70,1585,2,0,1726
2016,Slovenia,Ljubljana : Obcine - Municipality,0,0,0,0,68,0,0,68,0,0,0,35,216,0,0,251
2016,Slovenia,Slovenia : Dispersed in the country / territory,7,40,0,9,92,2,0,150,4,42,0,35,227,7,0,315
2016,Sweden,Sweden : Dispersed in the country / territory,0,0,0,0,0,0,0,0,0,0,0,0,0,0,0,0
2016,Swaziland,Swaziland : Dispersed in the country / territory,43,78,0,45,250,7,0,423,29,84,0,71,500,13,0,697
2016,Sint Maarten (Dutch part),Sint Maarten (Dutch part) : Dispersed in the country / territory,0,0,0,0,3,0,0,3,0,0,0,1,6,0,0,7
2016,Seychelles,Seychelles,0,0,0,0,1,0,0,1,1,0,0,0,0,0,0,1
2016,Syrian Arab Rep.,Al Qunaytirah : Mohafazah - Governorate,0,0,0,0,1,0,0,1,0,0,0,0,0,0,0,0
2016,Syrian Arab Rep.,As-Suweida : Mohafazah - Governorate,0,1,0,1,9,0,0,11,1,1,0,5,4,1,0,12
2016,Syrian Arab Rep.,Idleb : Mohafazah - Governorate,0,4,0,2,15,0,0,21,3,5,0,2,17,2,0,29
2016,Syrian Arab Rep.,Raqqa : Mohafazah - Governorate,1,5,0,3,9,3,0,21,1,2,0,4,7,0,0,14
2016,Syrian Arab Rep.,Syrian Arab Republic : Dispersed in the country / territory,0,0,0,0,0,0,0,0,0,0,0,0,0,0,0,0
2016,Syrian Arab Rep.,Tartous : Mohafazah - Governorate,14,34,0,22,124,14,0,208,12,25,0,36,116,17,0,206
2016,Syrian Arab Rep.,Rural Damascus : Mohafazah - Governorate,286,550,0,479,1826,234,0,3375,333,584,0,465,1787,370,0,3539
2016,Syrian Arab Rep.,Lattakia : Mohafazah - Governorate,6,19,0,31,99,16,0,171,19,36,0,38,139,18,0,250
2016,Syrian Arab Rep.,Homs : Mohafazah - Governorate,17,41,0,30,122,8,0,218,19,27,0,33,104,28,0,211
2016,Syrian Arab Rep.,Hassakeh : Mohafazah - Governorate,1439,1855,0,1118,3466,340,0,8218,1412,1816,0,1088,2405,210,0,6931
2016,Syrian Arab Rep.,Hama : Mohafazah - Governorate,5,6,0,8,25,6,0,50,6,8,0,3,19,4,0,40
2016,Syrian Arab Rep.,Dayr Az-Zor : Mohafazah - Governorate,15,39,0,27,85,4,0,170,12,32,0,21,45,5,0,115
2016,Syrian Arab Rep.,Dara : Mohafazah - Governorate,5,12,0,10,24,2,0,53,4,20,0,17,23,5,0,69
2016,Syrian Arab Rep.,Damascus : Mohafazah - Governorate,278,552,0,514,2213,289,0,3846,275,585,0,511,2091,477,0,3939
2016,Syrian Arab Rep.,Aleppo : Mohafazah - Governorate,23,38,0,33,162,10,0,266,36,54,0,32,172,25,0,319
2016,Turks and Caicos Islands,Turks and Caicos Islands : Dispersed in the country / territory,0,0,0,0,1,0,0,1,0,0,0,0,3,0,0,3
2016,Chad,Abgadam : Point,226,509,0,235,658,58,0,1686,220,479,0,177,242,32,0,1150
2016,Chad,Am Nabak : Point,1780,2377,0,2428,5993,574,0,13152,1723,2338,0,1972,1996,358,0,8387
2016,Chad,Amboko : Point,526,1022,0,795,2015,162,0,4520,494,950,0,826,1683,128,0,4081
2016,Chad,Bekourou : Point,229,290,0,107,416,15,0,1057,173,323,0,122,279,15,0,912
2016,Chad,Belome : Point,1585,2459,0,1550,4407,448,0,10449,1612,2379,0,1656,3141,266,0,9054
2016,Chad,Bohoma,13,17,0,7,24,1,0,62,9,10,0,4,15,2,0,40
2016,Chad,Bongor,43,81,0,36,119,5,0,284,43,80,0,35,106,11,0,275
2016,Chad,Bredjing : Point,3620,5151,0,3204,10077,1202,0,23254,3559,5271,0,3175,6855,856,0,19716
2016,Chad,Daha 1,23,53,0,28,96,7,0,207,29,32,0,15,38,7,0,121
2016,Chad,Daha 2,38,66,0,29,89,5,0,227,38,48,0,30,36,2,0,154
2016,Chad,Dar Es Salam : Point,624,775,0,337,1122,63,0,2921,636,730,0,331,1143,118,0,2958
2016,Chad,Dembo : Point,245,378,0,116,555,45,0,1339,268,378,0,132,350,26,0,1154
2016,Chad,Diba,59,93,0,26,153,10,0,341,86,86,0,35,165,4,0,376
2016,Chad,Djabal : Point,1913,2517,0,1643,4794,484,0,11351,2000,2582,0,1618,2999,371,0,9570
2016,Chad,Doholo : Point,207,323,0,177,546,41,0,1294,218,381,0,168,509,34,0,1310
2016,Chad,Dosseye : Point,907,1826,0,1032,2737,217,0,6719,954,1784,0,1083,1954,224,0,5999
2016,Chad,Farchana : Point,2183,3304,0,2380,6652,757,0,15276,2288,3308,0,2328,4009,462,0,12395
2016,Chad,Gaga : Point,2064,3017,0,2153,5405,408,0,13047,2082,2980,0,2094,3442,318,0,10916
2016,Chad,Gahoui: point,506,589,0,389,1133,148,0,2765,555,556,0,352,665,80,0,2208
2016,Chad,Gondje : Point,361,956,0,890,1924,127,0,4258,415,979,0,858,1343,65,0,3660
2016,Chad,Gore : Region,2751,3999,0,2569,7201,728,0,17248,2873,3879,0,2500,4812,457,0,14521
2016,Chad,Goz Amer : Point,2977,4152,0,2403,7061,968,0,17561,3180,4162,0,2396,4440,736,0,14914
2016,Chad,Guelendeng : Point,28,53,0,23,77,3,0,184,26,53,0,22,71,8,0,180
2016,Chad,Iridimi : Point,1663,2257,0,1805,4689,467,0,10881,1673,2159,0,1584,2178,253,0,7847
2016,Chad,Kaiga,89,111,0,46,156,7,0,409,56,64,0,30,102,11,0,263
2016,Chad,Kerfi,132,198,0,76,260,27,0,693,172,196,0,73,204,25,0,670
2016,Chad,Kounoungou : Point,1374,2312,0,1995,4692,375,0,10748,1365,2112,0,1733,1833,251,0,7294
2016,Chad,Lac Region,12643,14719,0,9720,28327,3698,0,69107,13871,13900,0,8799,16619,2046,0,55235
2016,Chad,Mile : Point,1507,2520,0,1852,4902,462,0,11243,1614,2429,0,1531,2098,272,0,7944
2016,Chad,Moissala : Point,89,148,0,48,188,7,0,480,93,147,0,50,121,8,0,419
2016,Chad,Moulkou : Point,11,20,0,8,29,1,0,69,11,19,0,8,27,3,0,68
2016,Chad,Moyo : Point,857,1022,0,634,1668,193,0,4374,799,1015,0,548,787,95,0,3244
2016,Chad,N'Djamena : Region,248,477,0,373,1055,44,0,2197,238,477,0,375,1088,64,0,2242
2016,Chad,Ngouboua : Point,74,202,0,87,309,17,0,689,74,198,0,89,180,26,0,567
2016,Chad,Oure Cassoni : Point,2085,3587,0,2932,7743,713,0,17060,2128,3497,0,2286,2631,237,0,10779
2016,Chad,Pont Carol : Point,21,40,0,17,57,2,0,137,20,39,0,17,55,6,0,137
2016,Chad,Tchoukoutalia : Point,29,52,0,33,73,1,0,188,22,51,0,11,34,3,0,121
2016,Chad,Touloum : Point,2107,2767,0,2200,5686,628,0,13388,2210,2733,0,1836,2515,323,0,9617
2016,Chad,Treguine : Point,2106,2832,0,1600,5133,598,0,12269,2036,2893,0,1668,3417,443,0,10457
2016,Chad,Vom,140,141,0,50,212,14,0,557,116,118,0,38,173,7,0,452
2016,Chad,Refugees located along the border : point,624,1191,0,845,2318,244,0,5222,627,1181,0,768,1196,155,0,3927
2016,Togo,Avepozo,89,110,0,57,338,11,0,605,99,95,0,64,434,7,0,699
2016,Togo,Dankpen : Prefecture,98,131,0,62,181,33,0,505,93,142,0,72,118,20,0,445
2016,Togo,Lome : Commune,104,142,0,130,611,25,0,1012,102,148,0,96,948,31,0,1325
2016,Togo,Site Tandjouare: Prefecture,41,43,0,14,83,10,0,191,35,46,0,17,20,3,0,121
2016,Togo,Sotouboua : Prefecture,363,468,0,138,713,76,0,1758,347,520,0,233,484,73,0,1657
2016,Togo,Tandjoare : Prefecture,661,746,0,326,1254,159,0,3146,632,789,0,252,117,25,0,1815
2016,Thailand,Ban Don Yang : Point,197,269,0,178,715,64,0,1423,197,280,0,196,678,63,0,1414
2016,Thailand,Ban Mae Surin : Point,194,223,0,179,573,52,0,1221,174,219,0,196,545,55,0,1189
2016,Thailand,Mae La : Point,2446,3306,0,2812,9462,962,0,18988,2655,3392,0,3009,8521,843,0,18420
2016,Thailand,Mae La Oon : Point,821,874,0,727,2273,227,0,4922,854,887,0,748,2197,247,0,4933
2016,Thailand,Mae Ra Ma Luang : Point,872,970,0,875,2579,260,0,5556,896,1083,0,886,2335,288,0,5488
2016,Thailand,Mae Sot,0,13,0,11,75,2,0,101,2,6,0,10,127,3,0,148
2016,Thailand,Mai Nai Soi : Point,609,903,0,674,2475,278,0,4939,596,950,0,668,2654,255,0,5123
2016,Thailand,Nu Po : Point,741,999,0,809,2884,252,0,5685,777,1001,0,752,2780,231,0,5541
2016,Thailand,Tham Hin : Point,478,613,0,384,1617,145,0,3237,510,593,0,379,1398,134,0,3014
2016,Thailand,Umpium : Point,800,987,0,821,3140,296,0,6044,864,1041,0,825,3067,245,0,6042
2016,Thailand,Thailand : Dispersed in the country / territory,6,28,0,42,25,0,0,101,3,36,0,95,26,0,0,160
2016,Thailand,Bangkok : Metropolitan administration,419,571,0,358,2098,127,0,3573,425,638,0,398,2869,126,0,4456
2016,Tajikistan,Dushanbe : Capital city,2,1,0,0,2,0,0,5,1,0,0,0,4,0,0,5
2016,Tajikistan,Dushanbe; Capital city,0,0,0,0,1,0,0,1,0,0,0,0,3,0,0,3
2016,Tajikistan,Khatlon : Province,0,0,0,0,0,0,0,0,0,0,0,0,0,0,0,0
2016,Tajikistan,Khatlon Province,465,1380,0,1198,4253,62,0,7358,479,1389,0,1210,886,44,0,4008
2016,Tajikistan,Khujand : City of provincial subordination,0,0,0,0,0,0,0,0,0,0,0,0,0,0,0,0
2016,Tajikistan,Sughd Province,17,117,0,154,799,34,0,1121,31,122,0,196,373,47,0,769
2016,Tajikistan,Tajikistan : Dispersed in the country / territory,0,0,0,0,0,0,0,0,0,0,0,0,2,0,0,2
2016,Tajikistan,Wahdat City,0,0,0,0,0,0,0,0,0,0,0,0,0,0,0,0
2016,Tajikistan,Districts of Republican Subordination,62,235,0,205,1405,32,0,1939,71,252,0,226,468,21,0,1038
2016,Turkmenistan,Turkmenistan : Dispersed in the country / territory,0,0,0,0,10,4,0,14,0,0,0,0,12,1,0,13
2016,Timor-Leste,Dili : District,0,0,0,0,0,0,0,0,0,0,0,0,2,0,0,2
2016,Trinidad and Tobago,Port of Spain : Municipality,4,12,0,6,76,0,0,98,6,15,0,11,196,0,0,228
2016,Tunisia,Bizerte : Wilayah - Governorate,3,1,0,1,6,0,0,11,0,2,0,1,10,0,0,13
2016,Tunisia,Gabes : Wilayah - Governorate,3,1,0,6,7,1,0,18,1,6,0,9,13,0,0,29
2016,Tunisia,Gafsa : Wilayah - Governorate,5,5,0,1,14,2,0,27,6,5,0,8,15,1,0,35
2016,Tunisia,Jendouba,0,1,0,0,0,0,0,1,0,1,0,0,1,0,0,2
2016,Tunisia,Kairouan,0,1,0,2,1,0,0,4,0,1,0,0,1,0,0,2
2016,Tunisia,Kasserine,0,1,0,0,1,0,0,2,0,2,0,0,2,0,0,4
2016,Tunisia,Kebili Governorate,0,0,0,1,2,0,0,3,1,2,0,1,3,0,0,7
2016,Tunisia,Medenine : Wilayah - Governorate,4,4,0,2,14,0,0,24,5,8,0,6,47,1,0,67
2016,Tunisia,Monastir : Mutamadiyah - Delegation,0,0,0,1,1,1,0,3,0,1,0,1,4,0,0,6
2016,Tunisia,Nabeul,1,0,0,0,1,1,0,3,0,0,0,0,2,2,0,4
2016,Tunisia,Sfax : Wilayah - Governorate,3,3,0,2,7,1,0,16,4,3,0,4,10,0,0,21
2016,Tunisia,Sidi Bouzid Governorate,0,1,0,0,6,1,0,8,0,1,0,1,4,0,0,6
2016,Tunisia,Sousse : Wilayah - Governorate,1,4,0,2,12,2,0,21,2,2,0,3,22,3,0,32
2016,Tunisia,Tunis : Wilayah - Governorate,10,14,0,8,85,8,0,125,9,26,0,12,138,6,0,191
2016,Turkey,Adana : Province,71,110,0,66,386,24,0,657,49,117,0,102,515,23,0,806
2016,Turkey,Adiyaman : Province,10,20,0,9,59,0,0,98,25,18,0,12,180,4,0,239
2016,Turkey,Adiyaman Merkez camp,0,0,0,0,0,0,0,0,0,0,0,0,0,0,0,0
2016,Turkey,AFYON : Province,0,0,0,0,0,0,0,0,0,0,0,0,0,0,0,0
2016,Turkey,Afyonkarahisar : Province,412,704,0,467,2349,134,0,4066,419,642,0,508,3558,126,0,5253
2016,Turkey,Agri : Province,17,21,0,25,93,3,0,159,7,33,0,104,243,4,0,391
2016,Turkey,Akcakale camp,0,0,0,0,0,0,0,0,0,0,0,0,0,0,0,0
2016,Turkey,Aksaray : Province,350,526,0,341,1418,100,0,2735,354,583,0,391,2276,96,0,3700
2016,Turkey,Altinozu camp 1,0,0,0,0,0,0,0,0,0,0,0,0,0,0,0,0
2016,Turkey,Altinozu camp 2,0,0,0,0,0,0,0,0,0,0,0,0,0,0,0,0
2016,Turkey,Amasya : Province,154,347,0,216,987,69,0,1773,192,355,0,265,1480,81,0,2373
2016,Turkey,Ankara : Province,66,111,0,84,442,31,0,734,81,173,0,128,599,28,0,1009
2016,Turkey,Antalya : Province,1,0,0,1,12,0,0,14,5,0,0,4,13,0,0,22
2016,Turkey,Apaydin camp,0,0,0,0,0,0,0,0,0,0,0,0,0,0,0,0
2016,Turkey,Ardahan : Province,1,4,0,2,13,0,0,20,3,5,0,3,58,0,0,69
2016,Turkey,Artvin,6,7,0,1,29,0,0,43,3,16,0,7,109,2,0,137
2016,Turkey,Aydin,0,0,0,0,2,0,0,2,0,0,0,0,4,1,0,5
2016,Turkey,Balikesir : Province,258,483,0,282,1713,73,0,2809,272,546,0,406,2816,67,0,4107
2016,Turkey,Bartin : Province,0,0,0,0,0,0,0,0,0,0,0,0,0,0,0,0
2016,Turkey,Batman : Province,67,120,0,89,295,19,0,590,61,134,0,121,331,14,0,661
2016,Turkey,Bayburt : Province,14,19,0,10,68,5,0,116,14,25,0,12,227,3,0,281
2016,Turkey,Beydagi camp,0,0,0,0,0,0,0,0,0,0,0,0,0,0,0,0
2016,Turkey,Bilecik : Province,376,626,0,373,2119,112,0,3606,414,697,0,504,4481,107,0,6203
2016,Turkey,Bingol : Province,0,0,0,0,0,0,0,0,0,0,0,0,1,0,0,1
2016,Turkey,Bitlis : Province,0,1,0,1,1,0,0,3,1,1,0,0,3,0,0,5
2016,Turkey,Bolu : Province,215,370,0,212,1193,63,0,2053,214,401,0,248,2029,67,0,2959
2016,Turkey,Burdur : Province,67,153,0,103,912,17,0,1252,102,176,0,121,1648,26,0,2073
2016,Turkey,Bursa : Province,0,2,0,2,13,1,0,18,2,1,0,2,11,1,0,17
2016,Turkey,Canakkale : Province,57,154,0,78,634,12,0,935,65,173,0,132,1931,14,0,2315
2016,Turkey,Cankiri : Province,340,582,0,342,1871,123,0,3258,383,699,0,436,3329,103,0,4950
2016,Turkey,Cevdetiye camp,0,0,0,0,0,0,0,0,0,0,0,0,0,0,0,0
2016,Turkey,Ceylanpinar camp,0,0,0,0,0,0,0,0,0,0,0,0,0,0,0,0
2016,Turkey,Corum : Province,618,871,0,505,1936,121,0,4051,593,996,0,610,2442,110,0,4751
2016,Turkey,Denizli : Province,141,314,0,197,1739,42,0,2433,161,385,0,260,3065,48,0,3919
2016,Turkey,Derik camp,0,0,0,0,0,0,0,0,0,0,0,0,0,0,0,0
2016,Turkey,Diyarbakir : Province,145,384,0,340,932,79,0,1880,200,452,0,351,919,52,0,1974
2016,Turkey,Duzce : Province,155,266,0,159,807,57,0,1444,160,305,0,202,1260,52,0,1979
2016,Turkey,Edirne : Province,4,4,0,3,21,1,0,33,7,7,0,6,38,0,0,58
2016,Turkey,Elazig,86,106,0,84,391,9,0,676,86,150,0,100,919,14,0,1269
2016,Turkey,Elbeyli camp,0,0,0,0,0,0,0,0,0,0,0,0,0,0,0,0
2016,Turkey,Erzincan : Province,102,157,0,111,448,17,0,835,80,180,0,184,1529,11,0,1984
2016,Turkey,Erzurum : Province,95,159,0,100,426,16,0,796,123,144,0,122,859,13,0,1261
2016,Turkey,Eskisehir : Province,289,526,0,316,1642,101,0,2874,352,603,0,401,2339,103,0,3798
2016,Turkey,Gaziantep : Province,56,113,0,68,262,19,0,518,54,87,0,76,398,22,0,637
2016,Turkey,Giresun,143,256,0,183,754,34,0,1370,146,262,0,243,1672,27,0,2350
2016,Turkey,Gumushane : Province,70,113,0,57,349,6,0,595,71,128,0,98,1230,8,0,1535
2016,Turkey,Guvecci camp,0,0,0,0,0,0,0,0,0,0,0,0,0,0,0,0
2016,Turkey,Hakkari : Province,0,1,0,0,1,0,0,2,0,2,0,1,13,0,0,16
2016,Turkey,Harran camp,0,0,0,0,0,0,0,0,0,0,0,0,0,0,0,0
2016,Turkey,Hatay : Province,20,24,0,17,45,5,0,111,8,18,0,11,44,4,0,85
2016,Turkey,Igdir : Province,3,5,0,2,13,0,0,23,2,4,0,3,32,1,0,42
2016,Turkey,Islahiye camp 1,0,0,0,0,0,0,0,0,0,0,0,0,0,0,0,0
2016,Turkey,Islahiye camp 2,0,0,0,0,0,0,0,0,0,0,0,0,0,0,0,0
2016,Turkey,Isparta : Province,212,358,0,240,1491,50,0,2351,232,432,0,288,2346,56,0,3354
2016,Turkey,Istanbul : Province,168,334,0,198,1410,75,0,2185,176,381,0,319,2971,102,0,3949
2016,Turkey,Izmir : Province,9,18,0,13,77,3,0,120,7,28,0,22,164,5,0,226
2016,Turkey,Kahramanmaras : Province,14,28,0,16,74,3,0,135,9,25,0,19,95,2,0,150
2016,Turkey,Kahramanmaras Merkez camp,0,0,0,0,0,0,0,0,0,0,0,0,0,0,0,0
2016,Turkey,Karabuk,301,493,0,278,1466,68,0,2606,314,542,0,400,3869,74,0,5199
2016,Turkey,Karaman : Province,296,439,0,256,1270,53,0,2314,319,537,0,363,3785,63,0,5067
2016,Turkey,Karkamis camp,0,0,0,0,0,0,0,0,0,0,0,0,0,0,0,0
2016,Turkey,Kars : Province,18,41,0,18,84,3,0,164,28,26,0,20,241,3,0,318
2016,Turkey,Kastamonu : Province,353,532,0,364,1910,62,0,3221,391,671,0,466,4450,80,0,6058
2016,Turkey,Kayseri : Province,122,240,0,159,949,51,0,1521,118,254,0,194,1325,48,0,1939
2016,Turkey,Kilis : Province,1,3,0,2,11,0,0,17,4,1,0,1,11,0,0,17
2016,Turkey,Kirikkale : Province,417,652,0,399,2056,92,0,3616,489,725,0,559,4037,95,0,5905
2016,Turkey,Kirklareli : Province,2,3,0,4,17,0,0,26,5,10,0,1,25,0,0,41
2016,Turkey,Kirsehir : Province,216,342,0,222,1080,108,0,1968,264,399,0,265,1689,97,0,2714
2016,Turkey,Kocaeli,3,1,0,0,9,0,0,13,3,3,0,1,10,3,0,20
2016,Turkey,Konya : Province,242,397,0,214,1080,64,0,1997,284,432,0,327,1893,54,0,2990
2016,Turkey,Kutahya : Province,433,644,0,395,1826,84,0,3382,446,702,0,472,3258,96,0,4974
2016,Turkey,Malatya : Province,59,112,0,71,297,8,0,547,63,131,0,87,433,17,0,731
2016,Turkey,Manisa : Province,375,696,0,400,2465,75,0,4011,400,831,0,589,6537,105,0,8462
2016,Turkey,Mardin : Province,239,495,0,402,1165,106,0,2407,249,505,0,419,1119,76,0,2368
2016,Turkey,Mersin : Province,70,147,0,92,483,59,0,851,73,145,0,101,558,63,0,940
2016,Turkey,Midyat camp,0,0,0,0,0,0,0,0,0,0,0,0,0,0,0,0
2016,Turkey,Mugla,0,0,0,0,1,0,0,1,1,1,0,0,2,2,0,6
2016,Turkey,Mus : Province,1,2,0,0,3,0,0,6,0,0,0,0,4,0,0,4
2016,Turkey,Nevsehir : Province,376,595,0,348,1907,59,0,3285,392,623,0,496,3871,63,0,5445
2016,Turkey,Nigde : Province,128,237,0,176,921,57,0,1519,147,318,0,182,1644,47,0,2338
2016,Turkey,Nizip camp 1,0,0,0,0,0,0,0,0,0,0,0,0,0,0,0,0
2016,Turkey,Nizip camp 2,0,0,0,0,0,0,0,0,0,0,0,0,0,0,0,0
2016,Turkey,Oncupinar camp,0,0,0,0,0,0,0,0,0,0,0,0,0,0,0,0
2016,Turkey,Ordu,309,416,0,213,1141,59,0,2138,286,450,0,272,1880,61,0,2949
2016,Turkey,OSMANIYE : Province,0,1,0,1,3,0,0,5,1,0,0,0,3,0,0,4
2016,Turkey,Rize : Province,0,0,0,0,0,0,0,0,0,0,0,0,0,0,0,0
2016,Turkey,Sakarya : Province,252,520,0,320,1570,111,0,2773,301,531,0,407,2546,99,0,3884
2016,Turkey,Samsun,431,850,0,497,2176,147,0,4101,474,906,0,584,3253,145,0,5362
2016,Turkey,Sanliurfa : Province,16,52,0,31,106,5,0,210,21,52,0,42,107,5,0,227
2016,Turkey,Saricam camp,0,0,0,0,0,0,0,0,0,0,0,0,0,0,0,0
2016,Turkey,Siirt : Province,34,82,0,68,195,18,0,397,48,75,0,77,222,12,0,434
2016,Turkey,Sinop : Province,247,385,0,285,1334,52,0,2303,259,470,0,375,2546,53,0,3703
2016,Turkey,Sirnak : Province,56,108,0,97,308,23,0,592,47,114,0,97,305,24,0,587
2016,Turkey,Sivas : Province,297,444,0,301,1428,32,0,2502,291,544,0,388,2649,60,0,3932
2016,Turkey,Suruc camp,0,0,0,0,0,0,0,0,0,0,0,0,0,0,0,0
2016,Turkey,Tekirdag : Province,0,3,0,0,5,1,0,9,2,1,0,2,9,0,0,14
2016,Turkey,Tokat : Province,418,679,0,463,2143,105,0,3808,443,764,0,599,4271,111,0,6188
2016,Turkey,Trabzon,337,515,0,314,1553,43,0,2762,331,617,0,460,2907,45,0,4360
2016,Turkey,Tunceli,0,0,0,0,0,0,0,0,0,0,0,0,0,0,0,0
2016,Turkey,Usak : Province,364,563,0,351,2148,64,0,3490,383,699,0,516,4297,61,0,5956
2016,Turkey,Van : Province,60,85,0,53,379,9,0,586,65,77,0,151,627,13,0,933
2016,Turkey,Viransehir camp,0,0,0,0,0,0,0,0,0,0,0,0,0,0,0,0
2016,Turkey,Yalova : Province,195,377,0,198,1473,101,0,2344,209,367,0,259,2176,88,0,3099
2016,Turkey,Yayladagi camp 1,0,0,0,0,0,0,0,0,0,0,0,0,0,0,0,0
2016,Turkey,Yayladagi camp 2,0,0,0,0,0,0,0,0,0,0,0,0,0,0,0,0
2016,Turkey,Yozgat : Province,317,435,0,252,1213,86,0,2303,293,489,0,376,2015,80,0,3253
2016,Turkey,Zondulak : Province,191,440,0,227,1340,46,0,2244,256,484,0,326,4237,71,0,5374
2016,Turkey,Turkey : Dispersed in the country / territory,27,52,0,39,192,14,0,324,36,45,0,214,634,16,0,945
2016,United Rep. of Tanzania,Chogo settlement,6,7,0,13,47,0,0,73,5,8,0,11,52,1,0,77
2016,United Rep. of Tanzania,Dar es Salaam,13,13,0,7,50,3,0,86,12,18,0,15,78,8,0,131
2016,United Rep. of Tanzania,Katumba settlement,205,4799,0,6536,20966,1938,0,34444,284,4943,0,6563,19870,2059,0,33719
2016,United Rep. of Tanzania,Kigoma villages,1929,2331,0,2101,4589,309,0,11259,1790,2293,0,2033,5186,486,0,11788
2016,United Rep. of Tanzania,Mishamo settlement,28,4355,0,5356,15772,1754,0,27265,40,4326,0,5297,14708,1775,0,26146
2016,United Rep. of Tanzania,Mtendeli camp,5566,5269,0,3791,10188,599,0,25413,5643,5282,0,4015,9844,539,0,25323
2016,United Rep. of Tanzania,Nduta camp,8797,8933,0,7342,14992,797,0,40861,9175,9286,0,8599,16951,847,0,44858
2016,United Rep. of Tanzania,Nyarugusu camp,11336,14470,0,10837,25739,2125,0,64507,11485,14880,0,11073,25137,1560,0,64135
2016,United Rep. of Tanzania,Ulyankulu settlement,60,3991,0,5073,14230,1628,0,24982,65,3780,0,4892,13465,1553,0,23755
2016,Uganda,Adjumani : District,18025,28025,0,17754,37172,3941,0,104917,18661,29108,0,19221,21103,1432,0,89525
2016,Uganda,Arua,7282,10760,0,7956,15795,1067,0,42860,7357,10775,0,8579,13106,424,0,40241
2016,Uganda,Bidibidi RC (Yumbe),0,0,0,0,0,0,0,0,0,0,0,0,0,0,0,0
2016,Uganda,Kampala : City,3495,7047,0,6462,24282,714,0,42000,3604,7092,0,6237,28432,614,0,45979
2016,Uganda,Kiryandongo : District,4271,7139,0,4885,9274,763,0,26332,4391,7614,0,5492,6062,264,0,23823
2016,Uganda,Kyaka II,2350,3662,0,2264,6420,480,0,15176,2364,3709,0,2287,6190,447,0,14997
2016,Uganda,Kyangwali : Point,3222,6008,0,3241,9447,780,0,22698,3173,6121,0,3292,9057,716,0,22359
2016,Uganda,Moyo,1001,1376,0,1056,1952,181,0,5566,1027,1484,0,969,1030,69,0,4579
2016,Uganda,Nakivale : Point,8425,13285,0,9018,27124,1387,0,59239,8620,13612,0,9244,30009,1263,0,62748
2016,Uganda,Nakivale RC (Nakivale),0,0,0,0,0,0,0,0,0,0,0,0,0,0,0,0
2016,Uganda,Nyakabande TC (Kisoro),0,0,0,0,0,0,0,0,0,0,0,0,0,0,0,0
2016,Uganda,Nyumanzi RC (Adjumani),0,0,0,0,0,0,0,0,0,0,0,0,0,0,0,0
2016,Uganda,Ocea RC (Rhino Camp),0,0,0,0,0,0,0,0,0,0,0,0,0,0,0,0
2016,Uganda,Oruchinga : Point,692,1038,0,603,1691,103,0,4127,713,1061,0,573,1484,106,0,3937
2016,Uganda,Palorinya RC (Moyo),0,0,0,0,0,0,0,0,0,0,0,0,0,0,0,0
2016,Uganda,Rwamanja : Point,7025,7978,0,3473,12016,620,0,31112,7031,7737,0,3675,10786,581,0,29810
2016,Uganda,Yumbe,8563,10435,0,7421,15895,2246,0,44560,8684,10467,0,7974,11576,879,0,39580
2016,Uganda,Uganda : Dispersed in the country / territory,18000,18000,0,18000,18000,18000,0,90000,18000,18000,0,18000,18000,18000,0,90000
2016,Ukraine,Ukraine : Dispersed in the country / territory,0,0,0,0,0,0,0,0,0,0,0,0,0,0,0,0
2016,Uruguay,Montevideo : Department,2,17,0,17,186,13,0,235,5,14,0,18,386,25,0,448
2016,United States of America,United States of America : Dispersed in the country / territory,0,0,0,0,0,0,0,0,0,0,0,0,0,0,0,0
2016,Uzbekistan,Uzbekistan: Dispersed in the country,0,2,0,1,4,3,0,10,0,0,0,2,14,1,0,17
2016,Venezuela (Bolivarian Republic of),Bolivar,1,3,0,5,12,0,0,21,2,6,0,4,9,2,0,23
2016,Venezuela (Bolivarian Republic of),Caracas : Point,0,2,0,2,14,0,0,18,1,1,0,3,17,0,0,22
2016,Venezuela (Bolivarian Republic of),Zulia : Point,25,45,0,35,60,0,0,165,22,12,0,47,95,3,0,179
2016,Venezuela (Bolivarian Republic of),Apure : Point,8,8,0,15,29,3,0,63,2,12,0,16,34,5,0,69
2016,Venezuela (Bolivarian Republic of),Tachira : Point,8,27,0,33,96,5,0,169,15,25,0,29,106,10,0,185
2016,Venezuela (Bolivarian Republic of),Venezuela : Dispersed in the country / territory,498,724,0,1024,1360,153,0,3759,125,166,0,264,3440,951,0,4946
2016,Viet Nam,Viet Nam : Dispersed in the country / territory,0,0,0,0,0,0,0,0,0,0,0,0,0,0,0,0
2016,Samoa,Apia,0,0,0,0,1,0,0,1,1,0,0,0,1,0,0,2
2016,Yemen,Abyan: Muhafazah - Governorate,8077,27262,0,17164,45436,3029,0,100968,6881,24083,0,17202,34404,3440,0,86010
2016,Yemen,Abyan: Muhafazah ?Çô Governorate,2,3,0,2,5,1,0,13,0,1,0,1,11,1,0,14
2016,Yemen,Aden: Muhafazah - Governorate,1218,4109,0,2587,6851,457,0,15222,1488,5209,0,3720,7441,744,0,18602
2016,Yemen,Aden: Muhafazah ?Çô Governorate,317,1805,0,2439,10968,409,0,15938,351,1869,0,2526,30515,436,0,35697
2016,Yemen,Al Bayda: Muhafazah - Governorate,7611,25690,0,16179,42840,2856,0,95176,6578,23033,0,16452,33046,3294,0,82403
2016,Yemen,Al Dali: Muhafazah - Governorate,6054,20430,0,12863,34052,2270,0,75669,5356,18745,0,13390,26780,2677,0,66948
2016,Yemen,Al Hudaydah: Muhafazah - Governorate,3974,13409,0,8460,22457,1504,0,49804,4302,15065,0,10783,21730,2175,0,54055
2016,Yemen,Al Jawf : Muhafazah - Governorate,0,4,0,3,9,1,0,17,2,3,0,2,10,1,0,18
2016,Yemen,Al Jawf: Muhafazah - Governorate,4492,15161,0,9546,25269,1685,0,56153,3769,13192,0,9423,18847,1884,0,47115
2016,Yemen,Al Maharah: Muhafazah ?Çô Governorate,7,212,0,89,446,12,0,766,1,213,0,93,1121,32,0,1460
2016,Yemen,Al Mahrah: Muhafazah - Governorate,170,573,0,361,954,64,0,2122,149,523,0,373,748,74,0,1867
2016,Yemen,Al Mahwit: Muhafazah - Governorate,1871,6315,0,3977,10529,702,0,23394,1727,6045,0,4318,8639,864,0,21593
2016,Yemen,Amran : Muhafazah - Governorate,0,2,0,2,7,0,0,11,1,4,0,2,13,0,0,20
2016,Yemen,Amran: Muhafazah - Governorate,12106,40855,0,25724,68092,4540,0,151317,10970,38393,0,27423,54848,5485,0,137119
2016,Yemen,Dhamar : Muhafazah - Governorate,1,7,0,13,68,10,0,99,0,9,0,8,135,26,0,178
2016,Yemen,Dhamar: Muhafazah - Governorate,5778,19502,0,12279,32504,2167,0,72230,6014,21050,0,15036,30071,3007,0,75178
2016,Yemen,Hadramawt: Muhafazah - Governorate,4407,15437,0,9753,26728,1803,0,58128,3837,13899,0,9954,23727,2147,0,53564
2016,Yemen,Hajjah : Muhafazah - Governorate,0,3,0,1,3,0,0,7,0,1,0,1,8,1,0,11
2016,Yemen,Hajjah: Muhafazah - Governorate,16585,55976,0,35244,93292,6220,0,207317,17262,60418,0,43156,86312,8631,0,215779
2016,Yemen,Ibb: Muhafazah - Governorate,5203,17558,0,11058,29311,1954,0,65084,5195,18176,0,12990,26025,2606,0,64992
2016,Yemen,Lahij: Muhafazah - Governorate,22,195,0,221,292,12,0,742,25,228,0,231,376,15,0,875
2016,Yemen,Lahij: Muhafazah ?Çô Governorate,2511,8911,0,5868,16244,952,0,34486,2942,10697,0,7615,16193,1434,0,38881
2016,Yemen,Ma'arib: Muhafazah - Governorate,1800,6078,0,3833,10143,676,0,22530,1867,6537,0,4666,9348,935,0,23353
2016,Yemen,Raymah: Muhafazah - Governorate,2145,7240,0,4559,12068,804,0,26816,1980,6931,0,4951,9902,990,0,24754
2016,Yemen,Sa'dah : Muhafazah - Governorate,0,5,0,9,32,8,0,54,1,4,0,8,60,5,0,78
2016,Yemen,Sa'dah': Muhafazah - Governorate,7402,24982,0,15729,41635,2776,0,92524,6456,22597,0,16141,32283,3228,0,80705
2016,Yemen,Sana?ÇÖa: Muhafazah ?Çô Governorate,1815,6070,0,3820,10228,676,0,22609,1558,5364,0,3835,7813,771,0,19341
2016,Yemen,Sanaa: Muhafazah - Governorate,6136,20710,0,13040,34518,2301,0,76705,5896,20635,0,14739,29479,2948,0,73697
2016,Yemen,Shabwah: Muhafazah - Governorate,629,2124,0,1337,3549,237,0,7876,681,2387,0,1705,3421,342,0,8536
2016,Yemen,Socotra: Muhafazah - Governorate,657,2216,0,1396,3693,247,0,8209,581,2032,0,1452,2904,291,0,7260
2016,Yemen,Taizz: Muhafazah - Governorate,15658,52924,0,33423,88842,5928,0,196775,15772,55312,0,39551,79380,7929,0,197944
2016,Yemen,Amanat Al Asimah: Muhafazah - Governorate,7468,25517,0,16201,52255,3300,0,104741,7583,26568,0,18865,49520,4192,0,106728
2016,Yemen,Yemen : Dispersed in the country / territory,1073,7888,0,6741,42334,2142,0,60178,1095,8507,0,6551,71298,2103,0,89554
2016,South Africa,South Africa : Dispersed in the country / territory,0,0,0,0,0,0,0,0,0,0,0,0,0,0,0,0
2016,Zambia,Lusaka : District,324,775,0,677,2669,109,0,4554,279,728,0,741,4670,207,0,6625
2016,Zambia,Mayukwayukwa : Point,983,1456,0,934,2878,157,0,6408,982,1416,0,903,3202,326,0,6829
2016,Zambia,Meheba : Point,1248,2364,0,1598,4182,300,0,9692,1205,2367,0,1693,4963,467,0,10695
2016,Zambia,Zambia : Dispersed in the country / territory,637,1444,0,979,2712,400,0,6172,602,1314,0,1018,2786,512,0,6232
2016,Zimbabwe,Harare : City,220,117,0,82,296,11,0,726,204,115,0,91,432,11,0,853
2016,Zimbabwe,Manicaland : Province,496,769,0,525,1450,58,0,3298,462,829,0,604,1688,42,0,3625
2017,Aruba,Aruba : Dispersed in the country / territory,0,*,0,*,5,0,0,10,*,*,0,*,6,0,0,10
2017,Afghanistan,Badakhshan : Wilayat -  Province,1424,1764,0,1082,2365,286,0,6921,1133,1495,0,1168,2365,384,0,6545
2017,Afghanistan,Badakhshan : Wilayat - Province,850,1030,0,646,1429,168,0,4123,684,888,0,698,1424,221,0,3915
2017,Afghanistan,Badghis : Wilayat - Province,2474,2452,0,3032,5197,809,0,13964,2443,2210,0,3469,5083,915,0,14120
2017,Afghanistan,Badghis : Wllayat - Province,4818,4765,0,5993,10184,1610,0,27370,4765,4285,0,6864,9956,1817,0,27687
2017,Afghanistan,Badghis:Wllayet - Province,*,0,0,*,8,*,0,13,*,*,0,*,8,0,0,16
2017,Afghanistan,Baghlan : Wilayat - Province,305,301,0,237,448,55,0,1346,242,311,0,276,453,61,0,1343
2017,Afghanistan,Baghlan : Wllayat - Province,8121,7583,0,5970,11811,1183,0,34668,6694,7841,0,6572,10947,1608,0,33662
2017,Afghanistan,Balkh : Wilayat - Province,3067,4328,0,4442,7550,1899,0,21286,3182,4234,0,4283,7116,2216,0,21031
2017,Afghanistan,Bamyan : Wilayat - Province,389,588,0,685,1138,101,0,2901,486,779,0,411,950,104,0,2730
2017,Afghanistan,Bamyan: Wilayat - Province,19,23,0,33,147,8,0,230,23,29,0,47,159,16,0,274
2017,Afghanistan,Daykundi : Wilayat - Province,309,675,0,378,789,126,0,2277,550,677,0,684,1059,64,0,3034
2017,Afghanistan,Farah : Wilayat - Province,3798,4522,0,6577,8039,754,0,23690,2459,4024,0,6100,8156,1136,0,21875
2017,Afghanistan,Faryab : Wilayat - Province,7286,8888,0,9613,17930,4702,0,48419,7403,8806,0,9466,17113,4540,0,47328
2017,Afghanistan,Ghazni : Wilayat - Province,4088,5041,0,4656,11160,935,0,25880,5189,7385,0,5965,14178,1469,0,34186
2017,Afghanistan,Ghor : Wilayat - Province,5944,6640,0,4535,10762,1016,0,28897,5366,6733,0,5130,10695,1108,0,29032
2017,Afghanistan,Helmand : Wilayat - Province,21702,22020,0,19708,52200,6245,0,121875,25280,23478,0,17817,50795,5595,0,122965
2017,Afghanistan,Herat : Wilayat - Province,14254,18510,0,9625,33541,1817,0,77747,11619,19780,0,15475,29059,1578,0,77511
2017,Afghanistan,Hilmand : Wilayat - Province,38,39,0,30,70,7,0,184,39,43,0,33,70,8,0,193
2017,Afghanistan,Hirat : Wilayat - Province,197,203,0,154,362,36,0,952,199,219,0,171,360,43,0,992
2017,Afghanistan,Jawzjan : Wilayat - Province,3368,3958,0,3942,6301,857,0,18426,3146,3406,0,3614,5661,1011,0,16838
2017,Afghanistan,Kabul : Wilayat - Province,16443,16913,0,13261,36007,2699,0,85323,17236,19231,0,15000,35396,4126,0,90989
2017,Afghanistan,Kandahar : Wilayat - Province,15497,12859,0,9888,22685,3184,0,64113,16608,13679,0,10628,24621,3541,0,69077
2017,Afghanistan,Kapisa : Wilayat - Province,1234,1473,0,1200,3010,229,0,7146,1467,1833,0,1502,3493,292,0,8587
2017,Afghanistan,Khost : Wilayat - Province,6665,11707,0,4692,9024,1006,0,33094,6373,13172,0,6491,11257,1335,0,38628
2017,Afghanistan,Kunar : Wilayat - Province,6328,6561,0,3445,9757,350,0,26441,6027,7016,0,4044,9679,412,0,27178
2017,Afghanistan,Kunduz : Wilayat - Province,17348,15664,0,11260,30989,3396,0,78657,16561,16842,0,13319,28850,3404,0,78976
2017,Afghanistan,Laghman : Wilayat - Province,5188,4898,0,3356,8235,346,0,22023,5352,5135,0,3691,7880,611,0,22669
2017,Afghanistan,Logar : Wilayat - Province,5426,5426,0,4680,11122,724,0,27378,6057,6576,0,5134,10776,1137,0,29680
2017,Afghanistan,Nangarhar : Wilayat - Province,48654,44825,0,30748,73938,2832,0,200997,49344,49151,0,34657,72573,4057,0,209782
2017,Afghanistan,Nimroz : Wilayat - Province,1073,1153,0,895,1776,204,0,5101,1230,1122,0,950,1753,251,0,5306
2017,Afghanistan,Nuristan : Wilayat - Province,1012,994,0,427,1744,5,0,4182,811,1214,0,735,1788,15,0,4563
2017,Afghanistan,Paktia : Wilayat - Province,99,103,0,78,183,18,0,481,100,111,0,86,181,21,0,499
2017,Afghanistan,Paktika : Walayat - Province,225,202,0,139,311,25,0,902,266,189,0,131,335,17,0,938
2017,Afghanistan,Paktika : Wilayat - Province,5700,9081,0,3053,6975,629,0,25438,6107,10206,0,4144,8371,876,0,29704
2017,Afghanistan,Paktya : Walayat - Province,3208,3067,0,2709,5285,515,0,14784,3435,3401,0,2554,4814,590,0,14794
2017,Afghanistan,Paktya : Wilayat - Province,1199,1130,0,960,2422,200,0,5911,1224,1186,0,1003,2052,276,0,5741
2017,Afghanistan,Panjsher : Wilayat - Province,144,171,0,131,382,41,0,869,193,239,0,180,472,51,0,1135
2017,Afghanistan,Panjshir : Walayat - Province,75,87,0,67,205,22,0,456,100,122,0,90,251,28,0,591
2017,Afghanistan,Panjshir : Wilayat - Province,34,48,0,43,107,6,0,238,41,32,0,36,111,12,0,232
2017,Afghanistan,Parwan : Wilayat - Province,1248,1313,0,1245,2977,199,0,6982,1429,1728,0,1385,3256,347,0,8145
2017,Afghanistan,Samangan : Wilayat - Province,676,755,0,649,1810,343,0,4233,621,649,0,736,1706,404,0,4116
2017,Afghanistan,Sar-e Pol : Wilayat - Province,75,77,0,58,137,14,0,361,76,83,0,65,137,16,0,377
2017,Afghanistan,Sar-e Pul : Wilayat - Province,4223,3930,0,3658,8405,1918,0,22134,4299,3815,0,3336,7276,2015,0,20741
2017,Afghanistan,Takhar : Wilayat - Province,5856,4639,0,3407,7802,814,0,22518,5154,4893,0,3411,7802,1152,0,22412
2017,Afghanistan,Uruzgan : Wilayat - Province,12783,10106,0,7602,17578,2635,0,50704,13567,10986,0,8123,18966,2787,0,54429
2017,Afghanistan,Uruzghon : Wilayat - Province,14,17,0,12,20,*,0,65,7,9,0,11,30,*,0,59
2017,Afghanistan,Wardak : Wilayat - Province,2228,2872,0,2950,7224,358,0,15632,3066,4315,0,3526,9159,683,0,20749
2017,Afghanistan,Zabul : Wilayat - Province,3556,2884,0,2173,5083,719,0,14415,3850,3119,0,2365,5481,787,0,15602
2017,Angola,Angola : Dispersed in the country / territory,0,0,0,0,0,0,0,0,0,0,0,0,0,0,0,0
2017,Angola,Lunda Norte,2851,2918,0,1496,5415,175,0,12855,2768,2782,0,1360,5544,263,0,12717
2017,Anguilla,"The Valley, Anguilla",0,0,0,0,0,0,0,0,0,0,0,0,0,0,0,0
2017,Albania,Mamurras : Bashki - Municipality,0,*,0,0,*,0,0,*,0,*,0,*,0,0,0,*
2017,Albania,Manez,0,0,0,0,584,136,0,720,0,0,0,0,1427,414,0,1841
2017,Albania,Peshkopi : Bashki - Municipality,0,0,0,0,0,*,0,*,0,0,0,0,0,0,0,0
2017,Albania,Saranda,0,0,0,0,*,0,0,*,0,0,0,0,0,0,0,0
2017,Albania,Tirana Urban : Point,*,8,0,*,33,*,0,48,6,7,0,*,181,10,0,208
2017,Albania,Vlora,0,0,0,0,*,0,0,*,0,0,0,0,0,0,0,0
2017,Albania,Albania : Dispersed in the country/territory,600,602,0,600,430,0,0,2232,600,601,0,600,431,0,0,2232
2017,Albania,Babrru Centre,*,0,0,0,*,*,0,6,*,*,0,*,41,*,0,48
2017,United Arab Emirates,"Abu Dhabi, Emirates",115,302,0,409,475,54,0,1355,144,316,0,428,474,62,0,1424
2017,Argentina,Argentina : Dispersed in the country / territory,24,85,0,105,1573,188,0,1975,28,124,0,111,3104,205,0,3572
2017,Armenia,Aragatsotn : Marz - Province,0,0,0,0,39,18,0,57,0,0,0,0,32,10,0,42
2017,Armenia,Ararat : Marz - Province,0,0,0,0,32,33,0,65,0,0,0,0,36,36,0,72
2017,Armenia,Armavir : Marz - Province,0,0,0,0,47,37,0,84,0,0,0,*,52,17,0,70
2017,Armenia,Gergharkunik : Marz - Province,0,0,0,0,34,12,0,46,0,0,0,0,36,12,0,48
2017,Armenia,Kotayk : Marz - Province,0,0,0,0,85,55,0,140,0,0,0,0,88,35,0,123
2017,Armenia,Lori : Marz - Province,0,0,0,0,43,14,0,57,0,0,0,0,38,10,0,48
2017,Armenia,Shirak : Marz - Province,0,0,0,0,14,*,0,17,0,0,0,0,11,*,0,14
2017,Armenia,Syunik : Marz - Province,0,0,0,0,54,17,0,71,0,0,0,0,47,6,0,53
2017,Armenia,Tavush : Marz - Province,0,0,0,0,*,17,0,19,0,0,0,*,0,*,0,*
2017,Armenia,Vayots Dzor : Marz - Province,0,0,0,0,*,0,0,*,0,0,0,0,*,0,0,*
2017,Armenia,Yerevan : City,66,101,0,101,1010,266,0,1544,66,99,0,121,1072,184,0,1542
2017,Antigua and Barbuda,St. John,0,0,0,0,0,0,0,0,0,0,0,0,*,0,0,*
2017,Australia,Australia : Dispersed in the country / territory,0,0,0,0,0,0,0,0,0,0,0,0,0,0,0,0
2017,Austria,Austria : Dispersed in the country / territory,0,0,0,0,0,0,0,0,0,0,0,0,0,0,0,0
2017,Azerbaijan,Absheron : Rayon,0,0,0,0,0,0,0,0,0,0,0,0,0,0,0,0
2017,Azerbaijan,Aghdam : Rayon,0,0,0,0,0,0,0,0,0,0,0,0,0,0,0,0
2017,Azerbaijan,Aghdash : Rayon,0,0,0,0,0,0,0,0,0,0,0,0,0,0,0,0
2017,Azerbaijan,Aghjabedi : Rayon,0,0,0,0,0,0,0,0,0,0,0,0,0,0,0,0
2017,Azerbaijan,Aghstafa : Rayon,0,0,0,0,0,0,0,0,0,0,0,0,0,0,0,0
2017,Azerbaijan,Aghsu : Rayon,0,0,0,0,0,0,0,0,0,0,0,0,0,0,0,0
2017,Azerbaijan,Astara : Rayon,0,0,0,0,0,0,0,0,0,0,0,0,0,0,0,0
2017,Azerbaijan,Baku : Municipality,46,72,0,72,255,18,0,463,49,87,0,76,442,32,0,686
2017,Azerbaijan,Balakan : Rayon,0,0,0,0,0,0,0,0,0,0,0,0,0,0,0,0
2017,Azerbaijan,Barda : Rayon,0,0,0,0,0,0,0,0,0,0,0,0,0,0,0,0
2017,Azerbaijan,Beylagan : Rayon,0,0,0,0,0,0,0,0,0,0,0,0,0,0,0,0
2017,Azerbaijan,Bilasuvar : Rayon,0,0,0,0,0,0,0,0,0,0,0,0,0,0,0,0
2017,Azerbaijan,Dashkasan : Rayon,0,0,0,0,0,0,0,0,0,0,0,0,0,0,0,0
2017,Azerbaijan,Fuzuli : Rayon,0,0,0,0,0,0,0,0,0,0,0,0,0,0,0,0
2017,Azerbaijan,Gabala : Point,0,0,0,0,0,0,0,0,0,0,0,0,0,0,0,0
2017,Azerbaijan,Gadabay : Rayon,0,0,0,0,0,0,0,0,0,0,0,0,0,0,0,0
2017,Azerbaijan,Gakh : Point,0,0,0,0,0,0,0,0,0,0,0,0,0,0,0,0
2017,Azerbaijan,Ganja : Municipality,0,0,0,0,0,0,0,0,0,0,0,0,0,0,0,0
2017,Azerbaijan,Gazakh : Point,0,0,0,0,0,0,0,0,0,0,0,0,0,0,0,0
2017,Azerbaijan,Gobustan : Point,0,0,0,0,0,0,0,0,0,0,0,0,0,0,0,0
2017,Azerbaijan,Goranboy : Rayon,0,0,0,0,0,0,0,0,0,0,0,0,0,0,0,0
2017,Azerbaijan,Goychay : Rayon,0,0,0,0,0,0,0,0,0,0,0,0,0,0,0,0
2017,Azerbaijan,Goygol : Rayon,0,0,0,0,0,0,0,0,0,0,0,0,0,0,0,0
2017,Azerbaijan,Guba : Point,0,0,0,0,0,0,0,0,0,0,0,0,0,0,0,0
2017,Azerbaijan,Gusar : Point,0,0,0,0,0,0,0,0,0,0,0,0,0,0,0,0
2017,Azerbaijan,Hajigabul : Rayon,0,0,0,0,0,0,0,0,0,0,0,0,0,0,0,0
2017,Azerbaijan,Imishli : Rayon,0,0,0,0,0,0,0,0,0,0,0,0,0,0,0,0
2017,Azerbaijan,Ismayilli : Rayon,0,0,0,0,0,0,0,0,0,0,0,0,0,0,0,0
2017,Azerbaijan,Jalilabad : Point,0,0,0,0,0,0,0,0,0,0,0,0,0,0,0,0
2017,Azerbaijan,Khachmaz : Point,0,0,0,0,0,0,0,0,0,0,0,0,0,0,0,0
2017,Azerbaijan,Khizi : Point,0,0,0,0,0,0,0,0,0,0,0,0,0,0,0,0
2017,Azerbaijan,Kurdamir : Rayon,0,0,0,0,0,0,0,0,0,0,0,0,0,0,0,0
2017,Azerbaijan,Lachin (Takhta Korpu) : Point,0,0,0,0,0,0,0,0,0,0,0,0,0,0,0,0
2017,Azerbaijan,Lankaran : Municipality,0,0,0,0,0,0,0,0,0,0,0,0,0,0,0,0
2017,Azerbaijan,Masalli : Rayon,0,0,0,0,0,0,0,0,0,0,0,0,0,0,0,0
2017,Azerbaijan,Mingechavir : Municipality,0,0,0,0,0,0,0,0,0,0,0,0,0,0,0,0
2017,Azerbaijan,Naftalan : Municipality,0,0,0,0,0,0,0,0,0,0,0,0,0,0,0,0
2017,Azerbaijan,Nakhchivan : Autonomous republic,0,0,0,0,0,0,0,0,0,0,0,0,0,0,0,0
2017,Azerbaijan,Neftchala : Rayon,0,0,0,0,0,0,0,0,0,0,0,0,0,0,0,0
2017,Azerbaijan,Oghuz : Rayon,0,0,0,0,0,0,0,0,0,0,0,0,0,0,0,0
2017,Azerbaijan,Saatli : Rayon,0,0,0,0,0,0,0,0,0,0,0,0,0,0,0,0
2017,Azerbaijan,Sabirabad : Rayon,0,0,0,0,0,0,0,0,0,0,0,0,0,0,0,0
2017,Azerbaijan,Salyan : Rayon,0,0,0,0,0,0,0,0,0,0,0,0,0,0,0,0
2017,Azerbaijan,Samukh : Rayon,0,0,0,0,0,0,0,0,0,0,0,0,0,0,0,0
2017,Azerbaijan,Shabran : Point,0,0,0,0,0,0,0,0,0,0,0,0,0,0,0,0
2017,Azerbaijan,Shaki : Municipality,0,0,0,0,0,0,0,0,0,0,0,0,0,0,0,0
2017,Azerbaijan,Shamakhi : Rayon,0,0,0,0,0,0,0,0,0,0,0,0,0,0,0,0
2017,Azerbaijan,Shamkir : Rayon,0,0,0,0,0,0,0,0,0,0,0,0,0,0,0,0
2017,Azerbaijan,Shirvan : Municipality,0,0,0,0,0,0,0,0,0,0,0,0,0,0,0,0
2017,Azerbaijan,Siyazan : Rayon,0,0,0,0,0,0,0,0,0,0,0,0,0,0,0,0
2017,Azerbaijan,Sumgayit : Municipality,0,0,0,0,0,0,0,0,0,0,0,0,0,0,0,0
2017,Azerbaijan,Tartar : Rayon,0,0,0,0,0,0,0,0,0,0,0,0,0,0,0,0
2017,Azerbaijan,Tovuz : Rayon,0,0,0,0,0,0,0,0,0,0,0,0,0,0,0,0
2017,Azerbaijan,Ujar : Rayon,0,0,0,0,0,0,0,0,0,0,0,0,0,0,0,0
2017,Azerbaijan,Yevlakh : Municipality,0,0,0,0,0,0,0,0,0,0,0,0,0,0,0,0
2017,Azerbaijan,Zagatala : Rayon,0,0,0,0,0,0,0,0,0,0,0,0,0,0,0,0
2017,Azerbaijan,Zardab : Rayon,0,0,0,0,0,0,0,0,0,0,0,0,0,0,0,0
2017,Burundi,Bwagiriza : Point,697,1126,0,715,1897,107,0,4542,759,1175,0,780,1584,85,0,4383
2017,Burundi,Kavumu: Point,1430,2281,0,1235,2976,111,0,8033,1548,2304,0,1214,2285,101,0,7452
2017,Burundi,Kinama: Point,673,900,0,656,1737,99,0,4065,645,891,0,706,1479,82,0,3803
2017,Burundi,Musasa : Point,512,805,0,617,1446,79,0,3459,567,798,0,675,1152,47,0,3239
2017,Burundi,Burundi : Dispersed in the country / territory,44,106,0,73,225,31501,0,31949,50,103,0,79,267,19,0,518
2017,Burundi,Burundi: Dispersed in the country/ Territory,1501,1435,0,877,2658,254,0,6725,1541,1366,0,802,2473,278,0,6460
2017,Burundi,Burundi: Dispersed in the Country/ Territory ( Urban Situation),1440,2712,0,2308,7217,399,0,14076,1431,2795,0,2270,6776,361,0,13633
2017,Belgium,Belgium : Dispersed in the country / territory,0,0,0,0,0,0,0,0,0,0,0,0,0,0,0,0
2017,Benin,Benin : Dispersed in the country / territory,52,76,0,71,375,15,0,589,64,85,0,77,500,13,0,739
2017,Burkina Faso,Bobo-Dioulasso : Department,24,65,0,53,97,6,0,245,23,54,0,29,56,8,0,170
2017,Burkina Faso,Commune de Djibo,272,336,0,149,509,17,0,1283,240,304,0,170,331,22,0,1067
2017,Burkina Faso,Goudebo : Point,715,966,0,538,1590,128,0,3937,718,1037,0,548,1082,157,0,3542
2017,Burkina Faso,Mentao : Point,510,839,0,357,1304,104,0,3114,552,789,0,425,826,124,0,2716
2017,Burkina Faso,Ouagadougou : Point,21,30,0,31,144,*,0,229,13,40,0,32,207,8,0,300
2017,Burkina Faso,Burkina Faso : Dispersed in the country / territory,1103,1300,0,725,1920,104,0,5152,1063,1392,0,843,1376,123,0,4797
2017,Bangladesh,Balukhali MS,1583,1968,0,1130,4085,326,0,9092,1599,1905,0,1119,3273,300,0,8196
2017,Bangladesh,Bandarban,0,0,0,*,6,*,0,10,0,0,0,0,7,*,0,8
2017,Bangladesh,Bangladesh : Dispersed in the country / territory,0,0,0,0,0,0,0,0,0,0,0,0,0,0,0,0
2017,Bangladesh,Barisal,0,*,0,0,0,0,0,*,0,0,0,0,*,0,0,*
2017,Bangladesh,Chakmarkul,1004,1207,0,698,2638,157,0,5704,1043,1246,0,768,2169,119,0,5345
2017,Bangladesh,Chittagong : Zila - District,*,*,0,0,5,0,0,7,*,*,0,0,*,0,0,7
2017,Bangladesh,Cox's Bazar : Zila - District,0,*,0,*,10,0,0,13,0,*,0,*,9,*,0,14
2017,Bangladesh,Dhaka : Zila - District,12,11,0,*,31,0,0,57,5,10,0,*,44,*,0,64
2017,Bangladesh,Dinajpur,0,0,0,0,0,0,0,0,0,0,0,0,*,0,0,*
2017,Bangladesh,Gazipur : Zila - District,0,0,0,0,0,0,0,0,0,0,0,0,*,0,0,*
2017,Bangladesh,Hakimpara,2546,3005,0,2040,6474,547,0,14612,2794,3320,0,2030,5248,492,0,13884
2017,Bangladesh,Jamtoli,4616,5414,0,3517,11824,923,0,26294,4703,5645,0,3706,9431,933,0,24418
2017,Bangladesh,Kutupalong : Point,798,1568,0,1175,3545,174,0,7260,972,1613,0,1196,2832,192,0,6805
2017,Bangladesh,Kutupalong MS,5539,6488,0,3756,13830,1070,0,30683,5752,7123,0,3770,10768,900,0,28313
2017,Bangladesh,Kutupalong RC,961,1111,0,827,2696,230,0,5825,980,1291,0,789,1987,192,0,5239
2017,Bangladesh,Leda MS,1756,2617,0,1410,4994,338,0,11115,1786,2679,0,1494,3843,230,0,10032
2017,Bangladesh,Leda MS Extension,1839,2429,0,1607,5035,376,0,11286,1997,2536,0,1571,3565,298,0,9967
2017,Bangladesh,Manikganj,0,0,0,0,0,0,0,0,0,0,0,0,*,0,0,*
2017,Bangladesh,Moynarghona,1861,2149,0,1398,4570,351,0,10329,1880,2342,0,1314,3690,306,0,9532
2017,Bangladesh,Nayapara : Point,1150,2108,0,1807,5206,261,0,10532,1197,2144,0,1827,3599,273,0,9040
2017,Bangladesh,Nayapara Extension,3345,4152,0,2725,8600,576,0,19398,3417,4550,0,2745,6292,520,0,17524
2017,Bangladesh,Nayapara RC,1557,2038,0,1382,4373,340,0,9690,1561,2276,0,1314,3013,263,0,8427
2017,Bangladesh,No Zone North,1154,1293,0,781,2939,236,0,6403,1150,1389,0,827,2398,208,0,5972
2017,Bangladesh,No Zone South,174,204,0,139,461,40,0,1018,163,223,0,152,368,32,0,938
2017,Bangladesh,North Eat No Zone,0,*,0,0,*,0,0,*,*,*,0,0,*,0,0,*
2017,Bangladesh,North No Zone,9,6,0,*,16,*,0,36,*,11,0,5,11,*,0,31
2017,Bangladesh,Rajshahi,0,0,0,0,*,0,0,*,*,0,0,0,*,0,0,*
2017,Bangladesh,Rangamati : Zila - District,0,0,0,*,*,0,0,*,0,*,0,0,*,*,0,*
2017,Bangladesh,Shamlapur,906,1319,0,601,2458,157,0,5441,958,1358,0,607,1602,148,0,4673
2017,Bangladesh,South No Zone,401,483,0,296,1044,84,0,2308,428,532,0,262,752,43,0,2017
2017,Bangladesh,Tangail,0,0,0,0,*,0,0,*,0,0,0,0,0,0,0,0
2017,Bangladesh,Thangkhali,3520,4162,0,2526,9041,678,0,19927,3661,4433,0,2611,7149,636,0,18490
2017,Bangladesh,Unchiprang,1992,2529,0,1669,4768,368,0,11326,2153,2584,0,1668,3929,331,0,10665
2017,Bangladesh,Zone AA,526,670,0,412,1457,107,0,3172,590,672,0,429,1124,89,0,2904
2017,Bangladesh,Zone BB,2692,3083,0,1817,6759,589,0,14940,2660,3180,0,1933,5446,539,0,13758
2017,Bangladesh,Zone CC,2686,3429,0,2185,7398,659,0,16357,2943,3520,0,2324,6305,570,0,15662
2017,Bangladesh,Zone DD,2620,3018,0,1827,6665,470,0,14600,2770,3241,0,1920,5153,444,0,13528
2017,Bangladesh,Zone EE,2853,3118,0,1802,6930,517,0,15220,2851,3294,0,1923,5475,449,0,13992
2017,Bangladesh,Zone FF,2754,3081,0,1768,6444,479,0,14526,2824,3157,0,1849,5176,471,0,13477
2017,Bangladesh,Zone GG,1552,1772,0,1147,3879,341,0,8691,1478,1828,0,1101,3054,271,0,7732
2017,Bangladesh,Zone HH,1650,1897,0,1182,4144,308,0,9181,1660,1953,0,1199,3353,300,0,8465
2017,Bangladesh,Zone II,1453,1790,0,1277,3823,301,0,8644,1493,1889,0,1218,3119,279,0,7998
2017,Bangladesh,Zone JJ,2462,2485,0,1544,5629,483,0,12603,2332,2647,0,1570,4306,450,0,11305
2017,Bangladesh,Zone KK,1009,1174,0,816,2675,224,0,5898,1034,1229,0,791,2155,227,0,5436
2017,Bangladesh,Zone LL,560,741,0,544,1564,137,0,3546,601,729,0,545,1354,129,0,3358
2017,Bangladesh,Zone MM,1777,1979,0,1237,4565,333,0,9891,1938,2253,0,1298,3631,317,0,9437
2017,Bangladesh,Zone NN,2957,3425,0,2159,7311,574,0,16426,3030,3675,0,2229,5988,494,0,15416
2017,Bangladesh,Zone OO,926,1091,0,648,2197,153,0,5015,943,1108,0,606,1647,99,0,4403
2017,Bangladesh,Zone PP,709,817,0,445,1818,146,0,3935,773,853,0,499,1440,122,0,3687
2017,Bangladesh,Zone QQ,277,326,0,170,624,42,0,1439,268,330,0,176,475,32,0,1281
2017,Bangladesh,Zone RR,58,62,0,24,158,10,0,312,69,66,0,42,119,15,0,311
2017,Bangladesh,Zone SS,1213,1301,0,871,3066,170,0,6621,1324,1436,0,848,2354,197,0,6159
2017,Bangladesh,Zone TT,1827,2157,0,1407,4590,333,0,10314,1889,2407,0,1421,3661,328,0,9706
2017,Bangladesh,Zone UU,97,138,0,57,235,13,0,540,111,131,0,52,173,9,0,476
2017,Bangladesh,Zone WW,128,131,0,75,227,14,0,575,105,118,0,66,192,8,0,489
2017,Bangladesh,Zone XX,1050,1128,0,714,2515,140,0,5547,1032,1155,0,661,1965,145,0,4958
2017,Bangladesh,Zone YY,1213,1467,0,963,3122,239,0,7004,1281,1539,0,937,2454,197,0,6408
2017,Bangladesh,Zone ZA,553,608,0,397,1382,95,0,3035,553,693,0,418,1109,82,0,2855
2017,Bangladesh,Zone ZZ,7,9,0,*,14,0,0,34,5,5,0,*,13,0,0,26
2017,Bulgaria,Bulgaria : Dispersed in the country / territory,0,0,0,0,0,0,0,0,0,0,0,0,0,0,0,0
2017,Bahrain,Bahrain : Dispersed in the country / territory,6,26,0,*,21,115,0,172,12,28,0,7,36,112,0,195
2017,Bahamas,Bahamas : Dispersed in the country / territory,0,0,0,0,5,0,0,5,0,0,0,0,22,*,0,24
2017,Bosnia and Herzegovina,Brcko : District,0,0,0,0,0,0,0,0,0,0,0,0,0,0,0,0
2017,Bosnia and Herzegovina,Republika Srpska : Entity,0,9,0,148,1980,825,0,2962,0,*,0,133,1673,351,0,2158
2017,Bosnia and Herzegovina,Bosnia and Herzegovina : Dispersed in the country / territory,11,*,0,*,*,0,0,19,24,8,0,*,11,0,0,46
2017,Bosnia and Herzegovina,Federation of Bosnia and Herzegovina : Entity,7,14,0,7,52,*,0,82,8,9,0,16,225,6,0,264
2017,Belarus,Belarus : Dispersed in the country / territory,0,0,0,0,0,0,0,0,0,0,0,0,0,0,0,0
2017,Belarus,Brest : Oblast - Region,*,0,0,0,*,0,0,*,0,0,0,0,*,0,0,*
2017,Belarus,Brest Oblast - Region,*,0,0,0,*,0,0,*,*,0,0,0,*,0,0,*
2017,Belarus,Gomel : Oblast - Region,0,0,0,0,0,0,0,0,0,0,0,0,*,0,0,*
2017,Belarus,Gomel: Oblast - Region,*,*,0,*,9,*,0,16,*,*,0,0,29,0,0,31
2017,Belarus,Grodno : Oblast - Region,0,0,0,*,*,0,0,*,0,0,0,0,0,0,0,0
2017,Belarus,Grodno: Oblast - Region,0,0,0,0,*,0,0,*,0,0,0,0,10,0,0,10
2017,Belarus,Horad Minsk : City,0,0,0,0,0,0,0,0,0,0,0,0,*,0,0,*
2017,Belarus,Horad Minsk: City,0,*,0,*,12,*,0,18,*,*,0,*,52,0,0,56
2017,Belarus,Minsk: Oblast - Region,0,0,0,0,7,0,0,7,0,0,0,*,10,0,0,11
2017,Belarus,Mogilev : Oblast - Region,0,0,0,*,9,0,0,11,*,*,0,0,6,0,0,8
2017,Belarus,Vitebsk : Oblast - Region,0,*,0,0,*,0,0,5,*,0,0,0,5,0,0,6
2017,Belarus,Vitebsk: Oblast - Region,0,0,0,0,*,*,0,*,0,0,0,0,10,0,0,10
2017,Belize,Belize : Dispersed in the country / territory,0,0,0,0,0,0,0,0,0,0,0,0,0,0,0,0
2017,Bolivia (Plurinational State of),Bolivia (Plurinational State of) : Dispersed in the country / territory,0,0,0,0,0,0,0,0,0,0,0,0,0,0,0,0
2017,Brazil,Brazil : Dispersed in the country / territory,17,20,0,13,117,6,0,173,69,27,0,32,276,10,0,414
2017,Barbados,Barbados : Dispersed in the country / territory,0,0,0,0,*,0,0,*,0,0,0,0,*,0,0,*
2017,Brunei Darussalam,Brunei Darussalam : Dispersed in the country / territory,0,0,0,0,0,0,0,0,0,0,0,0,0,0,0,0
2017,Botswana,Dukwi : Point,107,158,0,117,385,12,0,779,130,183,0,121,794,42,0,1270
2017,Botswana,Gaborone & Other areas,11,11,0,9,36,*,0,68,8,15,0,7,179,5,0,214
2017,Botswana,Francistown Center for Illegal Immigrants (FCII),8,18,0,13,29,*,0,70,8,9,0,9,53,0,0,79
2017,Central African Rep.,Bambari: Pladama-Ouaka,22,21,0,13,40,*,0,99,16,32,0,17,41,0,0,106
2017,Central African Rep.,Bamingui-Bangoran : Prefecture,0,0,0,0,0,0,0,0,0,0,0,0,0,0,0,0
2017,Central African Rep.,Bangui : Commune,148,214,0,158,528,21,0,1069,124,220,0,171,612,43,0,1170
2017,Central African Rep.,Basse Kotto,0,0,0,0,0,0,0,0,0,0,0,0,0,0,0,0
2017,Central African Rep.,Haut-Mbomou : Prefecture,0,0,0,0,0,0,0,0,0,0,0,0,0,0,0,0
2017,Central African Rep.,Haute-Kotto : Prefecture,0,0,0,0,0,0,0,0,0,0,0,0,0,0,0,0
2017,Central African Rep.,Kemo,0,0,0,0,0,0,0,0,0,0,0,0,0,0,0,0
2017,Central African Rep.,Lobaye,0,0,0,0,0,0,0,0,0,0,0,0,0,0,0,0
2017,Central African Rep.,Mambere Kadei,0,0,0,0,0,0,0,0,0,0,0,0,0,0,0,0
2017,Central African Rep.,Mboki,13,34,0,15,107,7,0,176,16,36,0,22,102,7,0,183
2017,Central African Rep.,Mbomou : Prefecture,0,0,0,0,0,0,0,0,0,0,0,0,0,0,0,0
2017,Central African Rep.,Nana Mambere,0,0,0,0,0,0,0,0,0,0,0,0,0,0,0,0
2017,Central African Rep.,Nana-Gribizi : Economic prefecture,0,0,0,0,0,0,0,0,0,0,0,0,0,0,0,0
2017,Central African Rep.,Ndele,326,316,0,111,748,57,0,1558,343,307,0,118,608,36,0,1412
2017,Central African Rep.,Obo,223,216,0,76,513,39,0,1067,235,210,0,81,419,25,0,970
2017,Central African Rep.,Ombella M'Poko : Prefecture,0,0,0,0,0,0,0,0,0,0,0,0,0,0,0,0
2017,Central African Rep.,Ouaka,0,0,0,0,0,0,0,0,0,0,0,0,0,0,0,0
2017,Central African Rep.,Ouham : Prefecture,0,0,0,0,0,0,0,0,0,0,0,0,0,0,0,0
2017,Central African Rep.,Ouham-Pende : Prefecture,0,0,0,0,0,0,0,0,0,0,0,0,0,0,0,0
2017,Central African Rep.,Rafai,*,*,0,0,11,0,0,13,0,*,0,0,17,*,0,19
2017,Central African Rep.,Sangha Mbaere,0,0,0,0,0,0,0,0,0,0,0,0,0,0,0,0
2017,Central African Rep.,Vakaga : Prefecture,0,0,0,0,0,0,0,0,0,0,0,0,0,0,0,0
2017,Central African Rep.,Various : Rural areas,0,0,0,0,0,0,0,0,0,0,0,0,0,0,0,0
2017,Central African Rep.,Zemio : Sous-prefecture,243,257,0,133,673,80,0,1386,294,304,0,131,584,70,0,1383
2017,Canada,Canada : Dispersed in the country / territory,0,0,0,0,0,0,0,0,0,0,0,0,0,0,0,0
2017,Switzerland,Switzerland : Dispersed in the country / territory,3000,3336,0,2255,15621,914,0,25126,3184,3580,0,3994,28706,693,0,40157
2017,Chile,Chile : Dispersed in the country / territory,73,97,0,83,1242,27,0,1522,86,113,0,89,1878,28,0,2194
2017,China,Anhui: Province,0,0,0,0,0,0,0,0,0,0,0,0,*,0,0,*
2017,China,Beijing : Municipality,*,*,0,0,34,0,0,36,*,*,0,0,47,0,0,53
2017,China,Chongqing : Municipality,0,0,0,0,*,0,0,*,0,0,0,0,7,0,0,7
2017,China,Fujian : Province,0,0,0,*,5,0,0,6,*,0,0,0,15,0,0,16
2017,China,Gansu : Province,*,0,0,0,*,0,0,*,0,0,0,*,*,0,0,*
2017,China,Guangdong : Province,11,8,0,*,46,0,0,68,8,5,0,8,66,*,0,88
2017,China,Guangxi : Autonomous Region,0,0,0,0,0,0,0,0,0,0,0,0,*,0,0,*
2017,China,Guizhou: Province,0,0,0,0,0,0,0,0,0,0,0,0,*,0,0,*
2017,China,Hainan : Province,0,0,0,0,0,0,0,0,0,0,0,0,*,0,0,*
2017,China,Hebei : Province,*,*,0,*,59,*,0,72,*,5,0,*,147,*,0,159
2017,China,Heilongjiang: Province,0,0,0,0,0,0,0,0,0,0,0,0,*,0,0,*
2017,China,Henan : Province,0,0,0,0,*,0,0,*,0,0,0,0,0,0,0,0
2017,China,Hubei : Province,*,0,0,0,20,0,0,23,*,0,0,0,41,0,0,43
2017,China,Hunan : Province,0,0,0,0,*,0,0,*,0,0,0,0,*,0,0,*
2017,China,Ji Lin : Province,0,0,0,0,*,0,0,*,0,0,0,0,*,0,0,*
2017,China,Jiangsu : Province,7,*,0,*,15,*,0,29,*,7,0,*,28,0,0,38
2017,China,Jiangxi : Province,0,0,0,0,0,0,0,0,0,0,0,0,0,0,0,0
2017,China,Liaoning : Province,*,0,0,0,6,0,0,7,0,0,0,0,11,0,0,11
2017,China,Neimenggu : Autonomous Region,0,0,0,0,*,0,0,*,0,0,0,0,*,0,0,*
2017,China,Shaanxi : Province,*,0,0,0,*,*,0,6,0,0,0,0,11,0,0,11
2017,China,Shandong : Province,0,*,0,0,5,0,0,6,0,*,0,0,8,0,0,9
2017,China,Shanghai : Municipality,*,0,0,0,5,0,0,6,0,*,0,0,23,0,0,24
2017,China,Shanxi : Province,0,0,0,0,*,0,0,*,0,0,0,0,*,0,0,*
2017,China,Sichuan : Province,0,0,0,0,*,0,0,*,0,0,0,0,8,0,0,8
2017,China,Tianjin : Municipality,0,0,0,0,*,0,0,*,0,0,0,0,6,0,0,6
2017,China,Unknown,0,0,0,0,14,0,0,14,0,0,0,0,60,0,0,60
2017,China,Xinjiang : Autonomous Region,*,*,0,0,*,0,0,7,*,*,0,0,*,0,0,5
2017,China,Yunnan : Province,0,0,0,0,0,0,0,0,0,0,0,0,0,0,0,0
2017,China,Zhejiang : Province,*,*,0,0,14,*,0,20,*,*,0,0,56,0,0,61
2017,Côte d'Ivoire,Abidjan : Departement,50,73,0,54,257,19,0,453,35,81,0,64,449,19,0,648
2017,Côte d'Ivoire,Cote d'Ivoire : Dispersed in the country / territory,0,0,0,0,0,0,0,0,0,0,0,0,0,0,0,0
2017,Côte d'Ivoire,Guiglo : Departement,13,9,0,14,37,*,0,77,9,15,0,23,27,*,0,75
2017,Côte d'Ivoire,Tabou : Departement,61,87,0,79,223,12,0,462,69,86,0,52,183,6,0,396
2017,Cameroon,Yola,20,16,0,5,35,*,0,78,23,27,0,*,49,*,0,105
2017,Cameroon,Zamboi,15,22,0,5,23,*,0,66,12,16,0,10,15,5,0,58
2017,Cameroon,Zembe Borongo : Point,134,193,0,105,337,31,0,800,144,190,0,106,169,49,0,658
2017,Cameroon,Ntui,0,*,0,0,0,0,0,*,0,0,0,0,0,0,0,0
2017,Cameroon,Nyambaka,11,25,0,17,34,5,0,92,15,32,0,22,12,8,0,89
2017,Cameroon,Nyabi : Point,156,199,0,128,392,34,0,909,156,220,0,133,314,48,0,871
2017,Cameroon,Ouli,18,17,0,5,40,*,0,81,20,32,0,9,40,*,0,102
2017,Cameroon,Obala,*,*,0,5,8,0,0,18,*,8,0,0,14,0,0,25
2017,Cameroon,Ouro Idje,6,13,0,*,16,0,0,39,13,6,0,*,11,0,0,33
2017,Cameroon,Oundjiki,*,6,0,0,*,*,0,13,*,*,0,*,10,*,0,21
2017,Cameroon,Ouro-Adde : Point,84,137,0,68,211,23,0,523,77,155,0,50,104,15,0,401
2017,Cameroon,Ouro Souley,134,140,0,57,244,9,0,584,104,148,0,54,114,11,0,431
2017,Cameroon,Penja,0,0,0,0,0,0,0,0,0,0,0,0,*,0,0,*
2017,Cameroon,Pana,6,13,0,7,17,*,0,44,10,12,0,*,16,*,0,43
2017,Cameroon,Roblin,8,15,0,10,22,*,0,57,9,17,0,5,7,*,0,39
2017,Cameroon,Petit Ngaoundere,24,52,0,27,69,*,0,175,31,49,0,25,34,*,0,142
2017,Cameroon,Samba : Point,17,58,0,38,78,11,0,202,27,56,0,24,32,11,0,150
2017,Cameroon,Roma,15,17,0,11,25,*,0,70,16,23,0,17,24,0,0,80
2017,Cameroon,Sandji,20,23,0,14,49,*,0,110,17,34,0,21,51,5,0,128
2017,Cameroon,Sandaye : Point,9,15,0,9,26,*,0,61,17,24,0,*,16,*,0,63
2017,Cameroon,Simi,14,19,0,17,22,6,0,78,8,15,0,10,7,5,0,45
2017,Cameroon,Sandji II,16,21,0,11,45,*,0,96,20,27,0,12,48,*,0,110
2017,Cameroon,Sodenou,25,34,0,18,46,5,0,128,20,24,0,17,36,5,0,102
2017,Cameroon,Soa,31,22,0,23,81,*,0,158,35,18,0,10,122,*,0,186
2017,Cameroon,Sourma,*,*,0,*,*,0,0,12,*,*,0,0,*,0,0,*
2017,Cameroon,Sodepa,0,*,0,0,*,0,0,7,*,*,0,*,*,0,0,9
2017,Cameroon,Tibati,15,18,0,5,14,0,0,52,11,15,0,5,5,*,0,38
2017,Cameroon,Tapare : Point,30,37,0,20,50,*,0,141,21,28,0,20,29,8,0,106
2017,Cameroon,Timangolo,747,842,0,505,1561,81,0,3736,733,880,0,507,1399,123,0,3642
2017,Cameroon,Tikolo,16,26,0,14,36,*,0,93,20,28,0,8,23,*,0,83
2017,Cameroon,Tongo Gandima : Point,245,390,0,196,653,73,0,1557,236,423,0,196,382,93,0,1330
2017,Cameroon,Tocktoyo,204,271,0,138,437,33,0,1083,182,269,0,156,289,59,0,955
2017,Cameroon,Wissambo,0,0,0,0,0,0,0,0,0,0,0,0,*,0,0,*
2017,Cameroon,Touboro,49,59,0,33,105,10,0,256,47,52,0,22,90,*,0,215
2017,Cameroon,Yamba : Point,139,259,0,140,392,34,0,964,151,284,0,160,243,44,0,882
2017,Cameroon,Woumbou : Point,169,209,0,95,391,27,0,891,199,200,0,83,372,25,0,879
2017,Cameroon,Yarmbang : Point,71,138,0,65,174,20,0,468,100,144,0,55,81,11,0,391
2017,Cameroon,Yaounde : Point,1123,1321,0,881,3395,118,0,6838,1114,1256,0,772,4577,106,0,7825
2017,Cameroon,Yokosire : Point,40,51,0,34,90,16,0,231,32,42,0,38,67,15,0,194
2017,Cameroon,Yokadouma,82,118,0,78,245,11,0,534,88,111,0,74,305,21,0,599
2017,Cameroon,Adinkol : Point,35,49,0,27,66,7,0,184,23,50,0,31,43,12,0,159
2017,Cameroon,Akonolinga,0,0,0,0,0,0,0,0,0,0,0,0,*,0,0,*
2017,Cameroon,Akwaya,44,81,0,35,207,20,0,387,44,92,0,27,62,9,0,234
2017,Cameroon,Alhamdou,121,157,0,77,270,12,0,637,120,147,0,72,227,28,0,594
2017,Cameroon,Awae,*,*,0,0,5,0,0,12,0,*,0,0,9,0,0,11
2017,Cameroon,Ayos,0,0,0,0,0,0,0,0,0,0,0,0,*,0,0,*
2017,Cameroon,Babongo : Point,22,11,0,7,26,*,0,68,13,19,0,*,10,*,0,48
2017,Cameroon,Bafia,0,0,0,0,*,0,0,*,*,0,0,*,*,0,0,5
2017,Cameroon,Bafouck : Point,62,82,0,34,125,16,0,319,63,81,0,39,125,19,0,327
2017,Cameroon,Bafoussam,0,0,0,0,*,0,0,*,0,0,0,0,5,0,0,5
2017,Cameroon,Bagodo : Point,*,9,0,7,11,*,0,33,8,12,0,11,6,*,0,40
2017,Cameroon,Bakombo,0,*,0,0,*,0,0,*,*,*,0,*,0,0,0,6
2017,Cameroon,Bana,0,0,0,0,0,0,0,0,*,0,0,0,*,0,0,*
2017,Cameroon,Bandongoue,5,8,0,*,6,0,0,22,*,6,0,*,6,0,0,16
2017,Cameroon,Banyo,95,146,0,80,322,26,0,669,95,177,0,85,202,32,0,591
2017,Cameroon,Barka Lamou,45,70,0,37,96,5,0,253,30,58,0,38,73,6,0,205
2017,Cameroon,Batchenga,0,0,0,0,0,0,0,0,0,0,0,0,*,0,0,*
2017,Cameroon,Batouri,17,26,0,20,75,5,0,143,32,29,0,18,135,9,0,223
2017,Cameroon,Bazzama : Point,19,49,0,40,71,6,0,185,22,51,0,31,36,16,0,156
2017,Cameroon,Bebarang,*,*,0,0,*,*,0,9,0,*,0,0,*,0,0,*
2017,Cameroon,Bedobo : Point,54,59,0,32,118,5,0,268,54,77,0,28,111,6,0,276
2017,Cameroon,Beka,19,35,0,15,45,*,0,116,18,36,0,10,14,*,0,81
2017,Cameroon,Beke Chantier,62,81,0,25,120,*,0,291,39,84,0,41,146,13,0,323
2017,Cameroon,Bela,58,67,0,46,109,*,0,284,39,76,0,41,102,10,0,268
2017,Cameroon,Belebina,*,*,0,0,*,0,0,5,0,*,0,*,*,0,0,6
2017,Cameroon,Belel,0,0,0,0,*,0,0,*,*,0,0,0,0,0,0,*
2017,Cameroon,Belimbam,41,65,0,28,99,*,0,236,49,75,0,28,89,9,0,250
2017,Cameroon,Belita II,20,27,0,20,46,*,0,116,17,32,0,17,29,*,0,98
2017,Cameroon,Bertoua,15,13,0,13,65,*,0,108,19,25,0,6,150,5,0,205
2017,Cameroon,Betare Oya,372,366,0,179,992,17,0,1926,373,309,0,186,1091,21,0,1980
2017,Cameroon,Bigoro,24,38,0,21,62,7,0,152,24,32,0,22,23,11,0,112
2017,Cameroon,Bimbappe,*,*,0,0,*,*,0,6,*,0,0,0,0,0,0,*
2017,Cameroon,Bindiba,29,61,0,12,57,9,0,168,30,49,0,14,22,8,0,123
2017,Cameroon,Boforo,24,22,0,17,46,7,0,116,21,38,0,21,19,7,0,106
2017,Cameroon,Bombe Bakari,26,28,0,15,60,*,0,132,22,34,0,12,100,8,0,176
2017,Cameroon,Bombe Chateau,20,14,0,8,41,*,0,84,16,23,0,9,45,*,0,95
2017,Cameroon,Bombe Pana,9,11,0,*,21,*,0,46,12,13,0,6,32,*,0,67
2017,Cameroon,Borgop,1241,1526,0,754,2476,198,0,6195,1341,1470,0,785,1725,213,0,5534
2017,Cameroon,Borgop : Point,7,14,0,15,28,7,0,71,7,14,0,11,28,6,0,66
2017,Cameroon,Bot-Makak,0,0,0,0,0,0,0,0,0,0,0,0,*,0,0,*
2017,Cameroon,Boubara : Point,81,116,0,45,203,18,0,463,73,96,0,68,134,18,0,389
2017,Cameroon,Bougogo,*,6,0,*,8,0,0,20,*,7,0,6,7,*,0,23
2017,Cameroon,Boulembe : Point,73,102,0,64,180,18,0,437,62,127,0,70,136,19,0,414
2017,Cameroon,Bouli : Point,53,82,0,41,119,7,0,302,58,77,0,40,74,10,0,259
2017,Cameroon,Buea,0,0,0,0,*,0,0,*,0,0,0,0,*,0,0,*
2017,Cameroon,Colomine,51,81,0,43,144,5,0,324,65,80,0,35,121,10,0,311
2017,Cameroon,Dakere Babongo : Point,42,70,0,27,92,7,0,238,54,61,0,31,71,6,0,223
2017,Cameroon,Damissa,54,82,0,34,114,7,0,291,61,78,0,40,103,9,0,291
2017,Cameroon,Dang Patou : Point,18,37,0,16,40,*,0,114,23,22,0,15,21,*,0,84
2017,Cameroon,Dibamba,0,0,0,0,0,0,0,0,0,0,0,0,*,0,0,*
2017,Cameroon,Diel,69,94,0,44,146,21,0,374,68,80,0,65,93,21,0,327
2017,Cameroon,Digou Adamou : Point,*,*,0,*,6,0,0,15,*,*,0,*,5,*,0,14
2017,Cameroon,Dip,8,16,0,13,23,*,0,62,13,12,0,5,22,*,0,54
2017,Cameroon,Dir : Point,21,22,0,9,26,*,0,80,16,19,0,7,14,*,0,57
2017,Cameroon,Djakone,241,293,0,124,487,23,0,1168,218,255,0,102,231,26,0,832
2017,Cameroon,Djalingo : Point,5,13,0,12,17,*,0,51,9,15,0,12,11,*,0,49
2017,Cameroon,Djallo,15,18,0,9,30,*,0,74,18,13,0,8,13,*,0,56
2017,Cameroon,Djaoro Mone,28,48,0,22,71,7,0,176,22,39,0,23,25,6,0,115
2017,Cameroon,Djohong : Point,8,17,0,17,36,*,0,80,14,22,0,13,33,5,0,87
2017,Cameroon,Dompla,146,256,0,102,365,17,0,886,159,264,0,107,300,16,0,846
2017,Cameroon,Dompta,85,118,0,62,221,10,0,496,85,154,0,56,145,9,0,449
2017,Cameroon,Dondoube,15,28,0,13,36,*,0,94,16,14,0,8,32,*,0,74
2017,Cameroon,Douala : Point,670,926,0,590,2590,74,0,4850,672,889,0,530,3004,50,0,5145
2017,Cameroon,Dschang,*,*,0,*,*,0,0,*,*,0,0,0,0,0,0,*
2017,Cameroon,Edea,*,0,0,0,*,0,0,*,*,*,0,0,*,0,0,5
2017,Cameroon,Eseka,0,0,0,0,0,0,0,0,*,*,0,0,*,0,0,*
2017,Cameroon,Esse,0,0,0,0,0,0,0,0,0,0,0,0,*,0,0,*
2017,Cameroon,Evodoula,0,0,0,0,0,0,0,0,0,0,0,0,*,0,0,*
2017,Cameroon,Fada : Point,20,43,0,31,74,5,0,173,30,49,0,35,30,13,0,157
2017,Cameroon,Fokoue,0,0,0,0,0,0,0,0,0,0,0,0,*,0,0,*
2017,Cameroon,Gadji Foulbe,*,*,0,*,*,0,0,8,*,*,0,0,*,0,0,8
2017,Cameroon,Gado Badzere,2512,3110,0,1505,5506,337,0,12970,2576,3059,0,1532,4026,423,0,11616
2017,Cameroon,Gado Badzere : Point,45,67,0,35,104,14,0,265,55,60,0,45,58,16,0,234
2017,Cameroon,Gaina,60,79,0,36,126,11,0,312,52,84,0,30,97,17,0,280
2017,Cameroon,Gandinang : Point,0,0,0,0,*,0,0,*,0,*,0,*,*,0,0,5
2017,Cameroon,Gandong,43,56,0,24,100,*,0,226,47,42,0,31,53,11,0,184
2017,Cameroon,Garga Libona : Point,60,84,0,50,132,17,0,343,49,89,0,50,68,14,0,270
2017,Cameroon,Garga Sarali : Point,110,156,0,74,243,22,0,605,100,189,0,68,136,19,0,512
2017,Cameroon,Gargapela : Point,114,168,0,67,230,28,0,607,92,189,0,84,162,22,0,549
2017,Cameroon,Gari Gombo,79,92,0,61,172,14,0,418,77,114,0,58,177,15,0,441
2017,Cameroon,Garoua,*,13,0,8,22,*,0,49,6,16,0,7,77,5,0,111
2017,Cameroon,Garoua-Boulai : Point,1432,2088,0,1316,4374,353,0,9563,1595,2005,0,1294,2485,343,0,7722
2017,Cameroon,Gbabio,59,49,0,21,102,5,0,236,51,67,0,26,72,12,0,228
2017,Cameroon,Gbakim : Point,12,18,0,15,30,*,0,76,14,25,0,9,41,6,0,95
2017,Cameroon,Gbata,12,17,0,9,31,*,0,71,11,18,0,14,12,*,0,57
2017,Cameroon,Gbatoua Godole,285,463,0,241,604,64,0,1657,278,432,0,219,392,57,0,1378
2017,Cameroon,Gbiti : Point,1068,1343,0,707,2380,137,0,5635,1108,1315,0,708,1886,225,0,5242
2017,Cameroon,Gomana,24,37,0,21,46,6,0,134,28,43,0,20,27,*,0,121
2017,Cameroon,Goro,33,56,0,34,57,5,0,185,27,49,0,23,19,8,0,126
2017,Cameroon,Gribi,*,6,0,*,7,0,0,18,0,*,0,0,6,*,0,12
2017,Cameroon,Guiwa Yangamo : Point,172,259,0,149,463,38,0,1081,204,287,0,152,421,37,0,1101
2017,Cameroon,Helbao,168,225,0,85,292,42,0,812,181,234,0,60,119,18,0,612
2017,Cameroon,Jericho,21,22,0,18,40,*,0,104,17,29,0,14,35,*,0,99
2017,Cameroon,Kambele,48,69,0,33,94,6,0,250,52,58,0,41,99,15,0,265
2017,Cameroon,Kela Sami,15,25,0,9,23,*,0,75,14,14,0,*,5,*,0,39
2017,Cameroon,Kenzou : Point,905,1225,0,652,2334,160,0,5276,909,1215,0,585,1958,193,0,4860
2017,Cameroon,Kette : Point,333,407,0,230,700,38,0,1708,318,449,0,227,567,57,0,1618
2017,Cameroon,Kombo Laka : Point,145,174,0,91,405,22,0,837,182,201,0,102,440,32,0,957
2017,Cameroon,Komboul,19,33,0,17,45,*,0,115,28,31,0,18,22,*,0,103
2017,Cameroon,Kouba : Point,15,28,0,15,48,*,0,109,23,23,0,17,21,9,0,93
2017,Cameroon,Kounde,*,15,0,7,9,*,0,36,7,5,0,*,*,*,0,20
2017,Cameroon,Kribi,*,*,0,0,*,0,0,*,0,0,0,0,*,0,0,*
2017,Cameroon,Kwele,93,131,0,65,240,15,0,544,100,127,0,90,149,24,0,490
2017,Cameroon,Lamou,21,22,0,8,39,*,0,92,17,32,0,8,23,*,0,81
2017,Cameroon,Libongo,121,171,0,89,273,11,0,665,131,158,0,73,250,22,0,634
2017,Cameroon,Limbe,*,0,0,0,0,0,0,*,0,0,0,0,*,0,0,*
2017,Cameroon,Lokoti : Point,57,104,0,41,149,9,0,360,63,98,0,48,101,24,0,334
2017,Cameroon,Lolo,1346,1481,0,807,2772,194,0,6600,1285,1466,0,816,2544,250,0,6361
2017,Cameroon,Makak,0,0,0,0,*,0,0,*,0,0,0,0,0,0,0,0
2017,Cameroon,Man Regara,76,128,0,73,186,8,0,471,75,107,0,53,129,6,0,370
2017,Cameroon,Mandjou : Point,715,1051,0,671,2026,144,0,4607,700,1051,0,612,1481,144,0,3988
2017,Cameroon,Mbai-Mboum,992,1325,0,667,2339,166,0,5489,1083,1372,0,646,1694,153,0,4948
2017,Cameroon,Mbale,*,5,0,*,5,0,0,17,*,5,0,0,0,0,0,7
2017,Cameroon,Mbalmayo,*,8,0,*,10,0,0,21,*,*,0,*,9,0,0,13
2017,Cameroon,Mbanga,*,*,0,0,*,0,0,5,0,*,0,*,*,0,0,*
2017,Cameroon,Mbankomo,*,*,0,*,*,0,0,5,0,0,0,0,0,*,0,*
2017,Cameroon,Mbarang : Point,43,75,0,52,107,7,0,284,45,84,0,43,67,13,0,252
2017,Cameroon,Mbewe : Point,15,18,0,11,31,6,0,81,11,17,0,11,17,*,0,59
2017,Cameroon,Mbile,1258,1429,0,691,2740,154,0,6272,1325,1471,0,722,2597,212,0,6327
2017,Cameroon,Mbile : Point,31,44,0,28,106,8,0,217,33,28,0,24,68,8,0,161
2017,Cameroon,Mbodo,26,32,0,14,51,6,0,129,25,30,0,11,31,*,0,101
2017,Cameroon,Mbomba,*,*,0,5,7,*,0,17,*,6,0,*,*,*,0,16
2017,Cameroon,Mbombete,35,61,0,29,85,6,0,216,46,60,0,26,106,14,0,252
2017,Cameroon,Mbondo : Point,10,18,0,12,24,*,0,67,6,19,0,11,15,7,0,58
2017,Cameroon,Mbonga : Point,32,20,0,12,52,*,0,118,16,35,0,18,29,9,0,107
2017,Cameroon,Mborguene : Point,*,*,0,*,7,0,0,15,5,6,0,*,*,0,0,14
2017,Cameroon,Mboula : Point,10,9,0,12,16,*,0,48,8,15,0,6,7,*,0,39
2017,Cameroon,Mbouma,18,30,0,14,38,*,0,103,13,21,0,7,46,*,0,89
2017,Cameroon,Mboumama : Point,55,78,0,46,124,8,0,311,52,87,0,37,90,16,0,282
2017,Cameroon,Mboy,10,12,0,9,20,0,0,51,11,7,0,*,41,*,0,66
2017,Cameroon,Meidougou : Point,181,300,0,188,483,46,0,1198,177,302,0,177,237,58,0,951
2017,Cameroon,Meiganga : Point,381,624,0,344,1002,89,0,2440,369,601,0,331,465,85,0,1851
2017,Cameroon,Mengang,0,0,0,0,0,0,0,0,0,0,0,0,*,0,0,*
2017,Cameroon,Mfou,18,22,0,10,28,*,0,79,10,14,0,9,29,*,0,63
2017,Cameroon,Mikila : Point,29,56,0,37,81,*,0,207,37,66,0,36,34,8,0,181
2017,Cameroon,Minawao,6074,8266,0,4285,12220,1487,0,32332,6238,8261,0,4328,8018,1267,0,28112
2017,Cameroon,Mobe : Point,30,44,0,29,65,6,0,174,25,54,0,22,23,9,0,133
2017,Cameroon,Moinam,*,0,0,0,*,0,0,5,0,0,0,0,0,0,0,0
2017,Cameroon,Moloundou,0,0,0,0,0,0,0,0,0,0,0,0,*,0,0,*
2017,Cameroon,Mombal,19,27,0,15,33,5,0,99,17,33,0,13,15,*,0,79
2017,Cameroon,Monatele,0,0,0,0,0,0,0,0,0,0,0,0,*,0,0,*
2017,Cameroon,Muyuka,0,0,0,0,0,0,0,0,0,0,0,0,*,0,0,*
2017,Cameroon,Nabemo : Point,54,71,0,44,131,9,0,309,61,88,0,46,117,13,0,325
2017,Cameroon,Nandoungue : Point,50,73,0,41,114,21,0,299,44,57,0,36,73,15,0,225
2017,Cameroon,Nanga-Eboko,*,0,0,*,*,0,0,5,0,*,0,0,*,0,0,*
2017,Cameroon,Nd??l??l??,*,9,0,6,8,0,0,25,6,*,0,5,6,0,0,21
2017,Cameroon,Ndanga Gandima : Point,81,161,0,72,216,18,0,548,87,140,0,87,108,19,0,441
2017,Cameroon,Ndokayo : Point,821,967,0,514,1619,145,0,4066,866,977,0,481,1103,158,0,3585
2017,Cameroon,Ngam,778,952,0,450,1454,85,0,3719,803,970,0,431,1049,111,0,3364
2017,Cameroon,Ngaoui : Point,757,1101,0,655,1813,179,0,4505,838,1145,0,635,973,160,0,3751
2017,Cameroon,Ngaoundal,48,71,0,40,103,7,0,269,34,67,0,37,24,*,0,166
2017,Cameroon,Ngaoundere,61,142,0,105,289,29,0,626,51,145,0,101,155,15,0,467
2017,Cameroon,Ngarisingo,96,144,0,74,206,14,0,534,95,133,0,81,218,32,0,559
2017,Cameroon,Ngazi : Point,8,18,0,*,17,0,0,47,5,8,0,*,8,0,0,24
2017,Cameroon,Ngong,0,0,0,0,0,0,0,0,0,0,0,0,*,0,0,*
2017,Cameroon,Ngoumou,0,*,0,0,0,0,0,*,0,0,0,0,0,0,0,0
2017,Cameroon,Ngoura,*,*,0,0,*,0,0,7,*,0,0,0,*,0,0,5
2017,Cameroon,Nguindi : Point,30,49,0,21,79,*,0,183,35,50,0,18,34,11,0,148
2017,Cameroon,Ngunbela : Point,36,36,0,21,56,8,0,157,21,45,0,25,31,6,0,128
2017,Cameroon,Nkolafamba,13,19,0,10,43,*,0,86,17,21,0,9,63,0,0,110
2017,Cameroon,Nkolmetet,0,*,0,*,0,0,0,*,*,0,0,0,*,0,0,*
2017,Cameroon,Nkondjock,0,0,0,*,*,0,0,*,0,0,0,0,*,0,0,*
2017,Cameroon,Nkongsamba,0,*,0,0,*,0,0,*,*,0,0,0,*,0,0,*
2017,Cameroon,Nkoteng,*,*,0,0,*,0,0,5,0,*,0,*,*,0,0,*
2017,Cameroon,Far-North : Dispersed in the territory,2533,3218,0,1124,5209,615,0,12699,2526,2996,0,917,3298,546,0,10283
2017,Dem. Rep. of the Congo,Aba : Point,17,8,0,8,37,7,0,77,12,9,0,11,37,*,0,72
2017,Dem. Rep. of the Congo,Aga,1875,2162,0,1114,2695,138,0,7984,1753,2167,0,1117,1758,95,0,6890
2017,Dem. Rep. of the Congo,Ariwara : Point,66,111,0,54,138,10,0,379,57,93,0,34,110,16,0,310
2017,Dem. Rep. of the Congo,Aru-Centre,0,*,0,*,*,0,0,9,*,*,0,*,6,*,0,16
2017,Dem. Rep. of the Congo,Bangalu,82,90,0,53,213,16,0,454,80,83,0,49,162,13,0,387
2017,Dem. Rep. of the Congo,Bas -Fleuve,33,34,0,35,71,*,0,177,21,38,0,28,96,40,0,223
2017,Dem. Rep. of the Congo,Baye,135,177,0,70,303,17,0,702,122,160,0,61,236,22,0,601
2017,Dem. Rep. of the Congo,Bikoro,0,0,0,0,0,0,0,0,*,*,0,*,*,0,0,6
2017,Dem. Rep. of the Congo,BILI(camp),1104,1348,0,448,1611,116,0,4627,1121,1388,0,605,1737,97,0,4948
2017,Dem. Rep. of the Congo,Biringi,383,378,0,200,646,38,0,1645,394,392,0,220,920,39,0,1965
2017,Dem. Rep. of the Congo,Bitima,220,195,0,95,354,24,0,888,230,196,0,93,209,21,0,749
2017,Dem. Rep. of the Congo,Bokungu,*,*,0,0,*,0,0,7,*,*,0,0,*,0,0,7
2017,Dem. Rep. of the Congo,Bolomba,*,*,0,*,*,0,0,7,*,*,0,*,*,0,0,8
2017,Dem. Rep. of the Congo,Bomongo,0,0,0,0,0,0,0,0,0,0,0,0,*,0,0,*
2017,Dem. Rep. of the Congo,Bondo : Point,4459,4151,0,2184,7416,685,0,18895,4167,4131,0,2322,6112,684,0,17416
2017,Dem. Rep. of the Congo,Bosobolo,1250,1241,0,403,2562,139,0,5595,1135,1076,0,220,1180,53,0,3664
2017,Dem. Rep. of the Congo,Boyabu(Camp),1879,2832,0,1304,3980,230,0,10225,1921,2725,0,1253,2131,78,0,8108
2017,Dem. Rep. of the Congo,Bukavu : Point,91,128,0,56,248,9,0,532,87,139,0,86,189,13,0,514
2017,Dem. Rep. of the Congo,Buta : Point,*,*,0,5,7,0,0,17,*,*,0,*,6,*,0,17
2017,Dem. Rep. of the Congo,Dilolo : Point,58,70,0,46,78,7,0,259,54,86,0,62,69,5,0,276
2017,Dem. Rep. of the Congo,Doruma : Point,865,714,0,412,1303,102,0,3396,793,769,0,374,698,71,0,2705
2017,Dem. Rep. of the Congo,Dungu : Point,214,188,0,101,345,10,0,858,220,183,0,106,283,12,0,804
2017,Dem. Rep. of the Congo,Duru,69,56,0,26,111,8,0,270,57,58,0,25,75,5,0,220
2017,Dem. Rep. of the Congo,Fizi : Point,333,353,0,145,711,38,0,1580,313,373,0,152,845,76,0,1759
2017,Dem. Rep. of the Congo,Fungurume,*,*,0,*,6,0,0,14,*,*,0,*,9,0,0,19
2017,Dem. Rep. of the Congo,Gangala,126,117,0,59,206,19,0,527,119,116,0,62,120,17,0,434
2017,Dem. Rep. of the Congo,Gemena,101,122,0,64,183,9,0,479,106,125,0,40,130,*,0,403
2017,Dem. Rep. of the Congo,Goma : Point,66,123,0,76,210,*,0,477,62,84,0,90,182,*,0,422
2017,Dem. Rep. of the Congo,Hamba,*,*,0,*,0,0,0,5,0,*,0,5,*,*,0,8
2017,Dem. Rep. of the Congo,Haut Katanga,17425,22749,0,11236,31052,4682,0,87144,17380,20194,0,12047,25374,3366,0,78361
2017,Dem. Rep. of the Congo,Haut Lomami,11213,13364,0,7081,22287,1999,0,55944,11320,13478,0,7256,17999,1264,0,51317
2017,Dem. Rep. of the Congo,Haut-Uele : District,128,260,0,208,358,28,0,982,140,202,0,184,344,18,0,888
2017,Dem. Rep. of the Congo,Idjwi: Territoire,112,122,0,64,229,23,0,550,114,153,0,61,78,23,0,429
2017,Dem. Rep. of the Congo,Ingbokolo : Point,349,366,0,190,606,30,0,1541,322,311,0,142,265,15,0,1055
2017,Dem. Rep. of the Congo,Inke,1774,2328,0,1125,3016,217,0,8460,1782,2305,0,1300,2466,121,0,7974
2017,Dem. Rep. of the Congo,Isiro : Point,*,*,0,7,14,*,0,29,*,5,0,5,18,0,0,30
2017,Dem. Rep. of the Congo,Ituri : District,35640,45005,0,24509,64968,8486,0,178608,33963,47369,0,24689,52439,6081,0,164541
2017,Dem. Rep. of the Congo,Kabalo,38,42,0,13,49,0,0,142,37,52,0,14,49,*,0,154
2017,Dem. Rep. of the Congo,Kailo,*,*,0,5,11,0,0,18,*,0,0,0,*,0,0,5
2017,Dem. Rep. of the Congo,Kakanda,0,*,0,*,*,0,0,6,0,*,0,0,*,0,0,*
2017,Dem. Rep. of the Congo,Kalehe : Point,1004,1247,0,714,1503,49,0,4517,862,1216,0,681,1325,69,0,4153
2017,Dem. Rep. of the Congo,Kalemie : Point,56,76,0,27,87,*,0,249,38,65,0,32,109,*,0,245
2017,Dem. Rep. of the Congo,Kambove : Territoire,5,9,0,*,9,0,0,25,*,*,0,*,11,*,0,22
2017,Dem. Rep. of the Congo,Kapata,7,10,0,*,15,*,0,38,7,6,0,7,20,*,0,43
2017,Dem. Rep. of the Congo,Kasai,29030,47010,0,18046,78000,3460,0,175546,35030,41010,0,19970,58700,3650,0,158360
2017,Dem. Rep. of the Congo,Kasai-Central,38850,49498,0,26472,69184,9364,0,193368,38760,45988,0,28094,56778,7195,0,176815
2017,Dem. Rep. of the Congo,Kasai-Oriental,5194,6168,0,5250,8005,424,0,25041,4268,6088,0,4390,7749,509,0,23004
2017,Dem. Rep. of the Congo,Kasaji,*,5,0,5,*,0,0,13,*,*,0,5,*,0,0,11
2017,Dem. Rep. of the Congo,Kasongo,10,13,0,8,37,*,0,70,16,16,0,7,39,*,0,80
2017,Dem. Rep. of the Congo,Kasumabalesa,*,5,0,5,6,0,0,17,6,*,0,*,5,0,0,17
2017,Dem. Rep. of the Congo,Katanda,*,*,0,*,*,0,0,12,*,*,0,*,7,*,0,11
2017,Dem. Rep. of the Congo,Katshia : Point,24,28,0,51,50,*,0,157,25,34,0,47,35,13,0,154
2017,Dem. Rep. of the Congo,Kendriyo,2420,3254,0,1697,4240,219,0,11830,2400,3398,0,1697,2636,139,0,10270
2017,Dem. Rep. of the Congo,Kimaza : Point,15,16,0,13,40,*,0,86,8,20,0,19,65,11,0,123
2017,Dem. Rep. of the Congo,Kinshasa : Province,68,110,0,91,186,10,0,465,48,92,0,111,269,21,0,541
2017,Dem. Rep. of the Congo,Kipushi,*,11,0,8,20,5,0,47,7,15,0,*,18,6,0,50
2017,Dem. Rep. of the Congo,Kisenge,10,14,0,12,21,0,0,57,14,14,0,11,6,0,0,45
2017,Dem. Rep. of the Congo,Kolwezi,6,9,0,*,11,0,0,29,*,7,0,*,17,0,0,31
2017,Dem. Rep. of the Congo,Kongolo,15,12,0,5,31,*,0,64,10,16,0,9,30,*,0,66
2017,Dem. Rep. of the Congo,Kwango,128,250,0,208,308,28,0,922,140,202,0,184,349,18,0,893
2017,Dem. Rep. of the Congo,Kwilu,3010,3850,0,1500,6700,801,0,15861,3083,4084,0,1650,5081,291,0,14189
2017,Dem. Rep. of the Congo,Libenge,567,546,0,244,805,48,0,2210,570,541,0,228,542,30,0,1911
2017,Dem. Rep. of the Congo,Likasi : City,0,0,0,0,0,*,0,*,0,0,0,0,0,0,0,0
2017,Dem. Rep. of the Congo,Lomami,12851,17053,0,7545,23650,2343,0,63442,12701,16510,0,8536,20053,1451,0,59251
2017,Dem. Rep. of the Congo,Loukolela,17,18,0,7,26,0,0,68,18,24,0,13,44,0,0,99
2017,Dem. Rep. of the Congo,Lualaba,5121,6060,0,2615,9072,552,0,23420,5091,5877,0,2741,5930,211,0,19850
2017,Dem. Rep. of the Congo,Lubero : Point,838,1008,0,694,1233,71,0,3844,731,1041,0,752,1156,87,0,3767
2017,Dem. Rep. of the Congo,Lubumbashi : Point,141,176,0,79,304,11,0,711,145,155,0,104,340,24,0,768
2017,Dem. Rep. of the Congo,Lukolo,25,16,0,6,60,*,0,108,31,15,0,6,102,*,0,157
2017,Dem. Rep. of the Congo,Luputa,5,10,0,13,6,*,0,35,6,7,0,9,12,*,0,35
2017,Dem. Rep. of the Congo,Lusenda (camp),3876,4282,0,1972,6421,262,0,16813,4009,4410,0,1915,5480,185,0,15999
2017,Dem. Rep. of the Congo,Lusuku : Point,6,12,0,32,14,0,0,64,17,13,0,27,28,*,0,87
2017,Dem. Rep. of the Congo,Mahola,22,18,0,30,27,*,0,98,13,14,0,41,30,*,0,99
2017,Dem. Rep. of the Congo,Makanza,0,0,0,0,0,0,0,0,0,0,0,0,*,0,0,*
2017,Dem. Rep. of the Congo,Maniema : Province,32901,43563,0,20499,55585,7366,0,159914,32798,40051,0,22124,46851,5150,0,146974
2017,Dem. Rep. of the Congo,Manono,24,31,0,6,40,0,0,101,28,28,0,6,43,0,0,105
2017,Dem. Rep. of the Congo,Masisi : Point,7027,8977,0,5662,11254,589,0,33509,5844,9341,0,6310,10664,760,0,32919
2017,Dem. Rep. of the Congo,Mbandaka,14,15,0,10,22,0,0,61,16,25,0,10,38,*,0,90
2017,Dem. Rep. of the Congo,Mbanza Ngungu,25,27,0,26,41,*,0,123,29,43,0,31,94,11,0,208
2017,Dem. Rep. of the Congo,Mboti,109,56,0,37,116,5,0,323,103,64,0,45,173,10,0,395
2017,Dem. Rep. of the Congo,Meri,2864,4022,0,2116,5757,622,0,15381,2910,4093,0,2389,4991,399,0,14782
2017,Dem. Rep. of the Congo,Mobayi Mbongo,4621,4320,0,2009,7842,484,0,19276,4595,4452,0,2021,5327,349,0,16744
2017,Dem. Rep. of the Congo,Mogoroko,22,13,0,9,39,*,0,85,17,13,0,11,27,*,0,70
2017,Dem. Rep. of the Congo,Mogoroko1,*,*,0,*,10,0,0,16,*,*,0,*,5,*,0,13
2017,Dem. Rep. of the Congo,Mokambo,*,0,0,0,5,0,0,7,*,*,0,*,*,0,0,11
2017,Dem. Rep. of the Congo,Mole,1923,2383,0,1069,3379,139,0,8893,1847,2072,0,1093,2159,74,0,7245
2017,Dem. Rep. of the Congo,Mosombo,110,95,0,31,227,30,0,493,98,75,0,43,169,45,0,430
2017,Dem. Rep. of the Congo,Musonoie,*,*,0,*,*,*,0,11,*,*,0,*,5,*,0,9
2017,Dem. Rep. of the Congo,Mwene Ditu : Point,*,*,0,6,5,0,0,16,*,*,0,8,10,*,0,23
2017,Dem. Rep. of the Congo,Mwenga : Point,2505,2909,0,2200,4012,408,0,12034,2406,2906,0,1707,3689,497,0,11205
2017,Dem. Rep. of the Congo,Ndu,1074,1305,0,546,2604,153,0,5682,1131,1269,0,511,1241,52,0,4204
2017,Dem. Rep. of the Congo,Niangara,5,6,0,*,15,*,0,31,*,11,0,*,15,*,0,34
2017,Dem. Rep. of the Congo,Nord-Kivu : Province,152805,189159,0,110347,260338,55105,0,767754,153154,48449,0,113871,214490,45880,0,575844
2017,Dem. Rep. of the Congo,Nyunzu,*,*,0,7,9,0,0,24,*,*,0,*,6,0,0,15
2017,Dem. Rep. of the Congo,Pangi,*,*,0,*,5,0,0,13,*,9,0,*,6,0,0,21
2017,Dem. Rep. of the Congo,Rutshuru : Point,6043,7734,0,5062,9050,501,0,28390,5069,8009,0,6041,9041,601,0,28761
2017,Dem. Rep. of the Congo,Sakania,0,*,0,*,*,0,0,*,0,*,0,*,*,0,0,6
2017,Dem. Rep. of the Congo,Sandoa,6,15,0,8,14,0,0,43,12,15,0,7,20,0,0,54
2017,Dem. Rep. of the Congo,Sankuru,1735,2177,0,1164,5524,613,0,11213,1830,2234,0,1389,3993,341,0,9787
2017,Dem. Rep. of the Congo,Sud-Kivu : Province,64627,83675,0,44676,110445,15998,0,319421,62406,87048,0,44956,90108,12030,0,296548
2017,Dem. Rep. of the Congo,Sugba,228,219,0,119,468,35,0,1069,235,207,0,103,283,14,0,842
2017,Dem. Rep. of the Congo,Tanganyika,83109,89953,0,49257,135090,16319,0,373728,83951,88929,0,50792,109489,9978,0,343139
2017,Dem. Rep. of the Congo,Territoire de Yakoma,971,1263,0,448,1991,118,0,4791,980,1289,0,413,1123,73,0,3878
2017,Dem. Rep. of the Congo,Tshabobo : Point,20,35,0,66,52,*,0,175,32,36,0,61,47,12,0,188
2017,Dem. Rep. of the Congo,Tshopo : District,4040,5850,0,2504,8505,916,0,21815,4083,6084,0,2657,7081,402,0,20307
2017,Dem. Rep. of the Congo,Uvira : Point,594,765,0,431,975,45,0,2810,516,742,0,402,831,59,0,2550
2017,Dem. Rep. of the Congo,Ville de Gbadolite,1290,1378,0,585,2254,134,0,5641,1215,1432,0,600,1707,96,0,5050
2017,Dem. Rep. of the Congo,Walikale : Point,4894,5888,0,4050,7195,422,0,22449,4268,6088,0,4390,6749,509,0,22004
2017,Dem. Rep. of the Congo,Wikong,6,9,0,16,17,0,0,48,5,7,0,13,7,*,0,33
2017,Dem. Rep. of the Congo,Zongo Villages,462,472,0,171,765,33,0,1903,457,458,0,157,508,19,0,1599
2017,Congo,Betou : Point,2262,2789,0,1501,5408,285,0,12245,2190,2696,0,1464,5027,246,0,11623
2017,Congo,Bouenza,0,0,0,*,*,0,0,*,0,*,0,0,8,0,0,10
2017,Congo,Brazzaville : Capital,798,1246,0,971,3709,94,0,6818,866,1305,0,906,5692,99,0,8868
2017,Congo,Dolisie: Point,5,11,0,7,9,*,0,36,8,10,0,*,15,*,0,39
2017,Congo,Ewo,*,*,0,*,*,0,0,7,0,*,0,0,14,0,0,15
2017,Congo,Impfondo : Point,613,995,0,764,2256,214,0,4842,628,1075,0,788,2257,151,0,4899
2017,Congo,Lekoumou,0,0,0,0,0,0,0,0,0,0,0,0,0,0,0,0
2017,Congo,Loukolela : Point,103,297,0,223,576,26,0,1225,98,313,0,233,694,50,0,1388
2017,Congo,Ngo : Point,36,64,0,47,85,*,0,233,42,85,0,45,215,7,0,394
2017,Congo,Niari : Departement,*,15,0,12,44,7,0,80,5,14,0,21,36,8,0,84
2017,Congo,Oyo : Point,31,50,0,43,86,*,0,212,23,61,0,46,179,6,0,315
2017,Congo,Pointe Noire : Point,160,209,0,125,565,18,0,1077,145,201,0,98,1394,33,0,1871
2017,Congo,Pool : Departement,75,119,0,76,207,8,0,485,75,132,0,100,396,8,0,711
2017,Congo,Sangha : Departement,124,193,0,157,431,11,0,916,114,166,0,145,633,17,0,1075
2017,Colombia,Arauca,*,*,0,*,*,0,0,5,*,*,0,0,*,0,0,5
2017,Colombia,Barcelona : Point,0,0,0,0,0,0,0,0,0,0,0,0,*,0,0,*
2017,Colombia,Barranquilla,0,*,0,0,6,0,0,9,0,*,0,0,*,*,0,5
2017,Colombia,Bogota : Capital district,*,*,0,*,24,21,0,56,6,*,0,8,115,16,0,149
2017,Colombia,Bosconia,0,0,0,0,0,0,0,0,0,0,0,0,*,0,0,*
2017,Colombia,Buenaventura : Point,0,0,0,0,0,0,0,0,0,0,0,0,*,*,0,*
2017,Colombia,C??cuta : Point,*,*,0,*,*,0,0,7,12,0,0,*,*,0,0,15
2017,Colombia,Cali : Point,0,0,0,*,*,0,0,*,0,0,0,0,*,*,0,5
2017,Colombia,Cartagena : Point,0,0,0,0,*,*,0,*,0,0,0,0,9,0,0,9
2017,Colombia,Colombia : Dispersed in the country / territory,0,0,0,0,0,0,0,0,0,0,0,0,0,0,0,0
2017,Colombia,Duitama : Point,0,0,0,0,0,*,0,*,0,0,0,0,0,0,0,0
2017,Colombia,Ibagu?? : Point,0,0,0,0,*,0,0,*,0,0,0,0,*,0,0,*
2017,Colombia,La Ceja,0,0,0,0,*,0,0,*,*,*,0,0,*,0,0,*
2017,Colombia,La Paz,*,*,0,*,*,0,0,*,0,0,0,*,*,0,0,*
2017,Colombia,Maicao : Point,0,*,0,0,*,0,0,*,0,*,0,*,*,0,0,*
2017,Colombia,Malambo,*,0,0,0,*,0,0,*,*,0,0,0,*,0,0,*
2017,Colombia,Medell?¡n : Point,0,0,0,0,*,*,0,*,0,*,0,*,5,0,0,7
2017,Colombia,Pacho,0,0,0,*,*,0,0,*,*,0,0,0,0,0,0,*
2017,Colombia,Palmira,0,0,0,*,*,0,0,*,*,*,0,0,0,0,0,*
2017,Colombia,Pasto,*,0,0,0,*,0,0,*,0,0,0,0,*,0,0,*
2017,Colombia,Pereira : Municipality,0,0,0,0,0,*,0,*,0,0,0,0,*,0,0,*
2017,Colombia,Riohacha,*,*,0,0,*,0,0,6,0,0,0,0,*,0,0,*
2017,Colombia,Rionegro,0,0,0,0,*,0,0,*,0,*,0,*,*,0,0,6
2017,Colombia,San Andres Islas : Department,0,0,0,0,*,*,0,*,0,0,0,0,*,*,0,*
2017,Colombia,Soledad,0,*,0,0,*,0,0,*,0,*,0,0,*,0,0,*
2017,Colombia,Tulu?í : Point,0,*,0,0,*,0,0,*,0,*,0,0,*,0,0,*
2017,Colombia,Tumaco : Municipality,0,0,0,*,*,0,0,*,0,0,0,*,*,0,0,*
2017,Colombia,Valledupar,0,*,0,0,*,*,0,*,0,*,0,0,*,*,0,*
2017,Cabo Verde,Cabo Verde : Dispersed in the country/territory,0,0,0,0,0,0,0,0,0,0,0,0,0,0,0,0
2017,Costa Rica,Costa Rica : Dispersed in the country / territory,0,0,0,0,0,0,0,0,0,0,0,0,0,0,0,0
2017,Cuba,Artemisa : Provincia,0,0,0,0,0,0,0,0,0,0,0,0,*,0,0,*
2017,Cuba,Camaguey : Provincia,0,0,0,0,*,0,0,*,0,0,0,*,9,0,0,10
2017,Cuba,Ciego de Avila : Provincia,0,0,0,0,0,0,0,0,0,0,0,0,7,0,0,7
2017,Cuba,Cienfuegos : Provincia,0,0,0,0,0,0,0,0,0,0,0,0,32,0,0,32
2017,Cuba,Granma : Provincia,0,0,0,0,0,0,0,0,0,0,0,0,*,0,0,*
2017,Cuba,Guant?â?ínamo : Provincia,0,0,0,0,0,0,0,0,0,0,0,0,*,0,0,*
2017,Cuba,Guant?ínamo : Provincia,0,0,0,0,0,0,0,0,0,0,0,0,13,0,0,13
2017,Cuba,Holguin : Provincia,0,0,0,0,*,0,0,*,0,0,0,0,19,0,0,19
2017,Cuba,La Habana : Provincia,*,*,0,*,41,*,0,51,*,13,0,*,114,*,0,136
2017,Cuba,Las Tunas : Provincia,0,0,0,0,0,0,0,0,0,0,0,0,5,0,0,5
2017,Cuba,Matanzas : Provincia,0,0,0,0,*,0,0,*,0,0,0,0,11,0,0,11
2017,Cuba,Mayabeque : Provincia,0,0,0,0,0,0,0,0,0,0,0,0,*,0,0,*
2017,Cuba,Pinar del Rio : Provincia,0,*,0,*,*,0,0,6,0,0,0,0,23,0,0,23
2017,Cuba,Sancti Spiritus : Provincia,0,0,0,0,0,0,0,0,0,0,0,0,9,0,0,9
2017,Cuba,Santiago de Cuba : Provincia,0,0,0,0,*,0,0,*,0,0,0,0,*,0,0,*
2017,Cuba,Villaclara : Provincia,0,0,0,0,0,0,0,0,0,0,0,0,17,0,0,17
2017,Curaçao,Curacao : Dispersed in the country / territory,0,0,0,0,0,0,0,0,0,0,0,0,0,0,0,0
2017,Cayman Islands,Cayman Islands : Dispersed in the country / territory,0,0,0,0,9,0,0,9,0,0,0,0,20,0,0,20
2017,Cyprus,Cyprus : Dispersed in the country / territory,0,0,0,0,0,0,0,0,0,0,0,0,0,0,0,0
2017,Czech Rep.,Czech Republic : Dispersed in the country / territory,0,0,0,0,0,0,0,0,0,0,0,0,0,0,0,0
2017,Germany,Germany : Dispersed in the country / territory,65777,75357,0,45609,289782,21029,0,497554,70042,85503,0,76826,661227,21975,0,915573
2017,Djibouti,Ali-Addeh : Point,1278,1597,0,1069,3926,250,0,8120,1225,1723,0,1158,3361,249,0,7716
2017,Djibouti,Djibouti : Point,130,386,0,288,1236,80,0,2120,153,380,0,319,1982,103,0,2937
2017,Djibouti,Hol-Hol : Point,288,572,0,393,1071,59,0,2383,336,562,0,398,1055,55,0,2406
2017,Djibouti,Obock : Pont,71,191,0,292,36,0,0,590,84,193,0,327,39,0,0,643
2017,Denmark,Denmark : Dispersed in the country / territory,0,0,0,0,0,0,0,0,0,0,0,0,0,0,0,0
2017,Dominican Rep.,Dominican Republic : Dispersed in the country / territory,12,114,0,105,446,33,0,710,21,103,0,100,453,63,0,740
2017,Algeria,Algiers : Wilaya - Province,14,13,0,13,41,0,0,81,12,15,0,15,127,*,0,172
2017,Algeria,Tindouf : Wilaya - Province,0,0,0,0,0,0,0,0,0,0,0,0,0,0,0,0
2017,Algeria,Algeria : Dispersed in the country / territory,407,480,0,282,1187,44,0,2400,444,538,0,309,2608,57,0,3956
2017,Ecuador,Ecuador : Dispersed in the country / territory,339,1631,0,3253,20995,1734,0,27952,348,1711,0,3283,23700,2339,0,31381
2017,Egypt,6th October : Muhafazah - Governorate,2104,3496,0,2166,10032,956,0,18754,2287,3742,0,2625,12004,984,0,21642
2017,Egypt,Alexandria : Muhafazah - Governorate,1202,2157,0,1383,6029,603,0,11374,1209,2207,0,1540,6230,658,0,11844
2017,Egypt,Assiut : Muhafazah - Governorate,26,40,0,29,84,*,0,181,28,48,0,14,92,*,0,186
2017,Egypt,Aswan : Muhafazah - Governorate,0,*,0,*,12,0,0,16,*,5,0,*,30,*,0,41
2017,Egypt,Bani Souwaif : Muhafazah - Governorate,16,20,0,14,47,*,0,98,18,13,0,8,55,*,0,97
2017,Egypt,Cairo : Muhafazah - Governorate,3292,5194,0,4103,20435,917,0,33941,3473,5365,0,4606,21830,866,0,36140
2017,Egypt,Dakahliya : Muhafazah - Governorate,178,373,0,223,910,61,0,1745,206,424,0,231,915,78,0,1854
2017,Egypt,Damietta : Muhafazah - Governorate,434,856,0,529,2255,211,0,4285,507,918,0,609,2236,182,0,4452
2017,Egypt,El-Beheira : Muhafazah - Governorate,57,93,0,48,207,15,0,420,57,95,0,54,198,20,0,424
2017,Egypt,Fayoum : Muhafazah - Governorate,21,42,0,22,81,6,0,172,15,28,0,26,94,5,0,168
2017,Egypt,Gharbeya : Muhafazah - Governorate,44,83,0,58,244,29,0,458,59,100,0,65,251,29,0,504
2017,Egypt,Giza : Muhafazah - Governorate,1228,1801,0,1834,8063,374,0,13300,1400,1897,0,2523,9768,415,0,16003
2017,Egypt,Helwan : Muhafazah - Governorate,234,357,0,328,2433,36,0,3388,263,372,0,302,2081,38,0,3056
2017,Egypt,Ismailia : Muhafazah - Governorate,55,82,0,47,235,14,0,433,65,107,0,44,290,15,0,521
2017,Egypt,Luxor : Muhafazah - Governorate,7,7,0,*,26,*,0,46,10,8,0,7,24,0,0,49
2017,Egypt,Matrouh : Muhafazah - Governorate,61,77,0,54,209,12,0,413,63,94,0,49,233,19,0,458
2017,Egypt,Menia : Muhafazah - Governorate,29,37,0,17,70,*,0,157,22,30,0,15,99,*,0,169
2017,Egypt,Monofiya : Muhafazah - Governorate,131,217,0,139,584,57,0,1128,113,254,0,179,567,52,0,1165
2017,Egypt,New Valley : Muhafazah - Governorate,0,*,0,*,*,0,0,*,0,0,0,0,*,0,0,*
2017,Egypt,North Sinai : Muhafazah - Governorate,*,7,0,*,6,0,0,17,*,*,0,*,12,*,0,19
2017,Egypt,Port-Said : Muhafazah - Governorate,20,61,0,29,152,13,0,275,27,51,0,29,140,16,0,263
2017,Egypt,Qalyubia : Muhafazah - Governorate,1016,1670,0,944,4137,341,0,8108,995,1758,0,1083,4773,326,0,8935
2017,Egypt,Qena : Muhafazah - Governorate,6,5,0,7,22,*,0,41,*,8,0,9,27,*,0,49
2017,Egypt,Sharkia : Muhafazah - Governorate,614,1025,0,583,2426,183,0,4831,618,1031,0,690,2754,221,0,5314
2017,Egypt,Sohag : Muhafazah - Governorate,8,15,0,18,49,6,0,96,9,9,0,8,46,*,0,75
2017,Egypt,South Sinai : Muhafazah - Governorate,*,11,0,*,16,*,0,34,*,*,0,*,27,*,0,35
2017,Egypt,Suez : Muhafazah - Governorate,39,58,0,60,236,13,0,406,49,68,0,68,205,11,0,401
2017,Egypt,The Red Sea : Muhafazah - Governorate,31,82,0,43,168,20,0,344,36,62,0,41,162,17,0,318
2017,Egypt,Egypt : Dispersed in the country / territory,6300,8001,0,4951,12953,840,0,33045,7000,5050,0,10000,14352,562,0,36964
2017,Egypt,Kafr El Shiekh : Muhafazah - Governorate,38,59,0,26,138,11,0,272,34,49,0,45,157,16,0,301
2017,Eritrea,Asmara : Point,*,*,0,*,7,0,0,13,*,*,0,*,9,0,0,16
2017,Eritrea,Emkulu : Point,184,264,0,180,435,15,0,1078,227,281,0,205,470,29,0,1212
2017,Eritrea,Gash Barka : Zoba - Region,*,15,0,*,18,0,0,39,*,13,0,8,29,*,0,53
2017,Spain,Spain : Dispersed in the country / territory,0,0,0,0,0,0,0,0,0,0,0,0,0,0,0,0
2017,Estonia,Estonia : Dispersed in the country / territory,0,0,0,0,0,0,0,0,0,0,0,0,0,0,0,0
2017,Ethiopia,Ad-Damazin Transit Centre : Point,36,367,0,170,614,66,0,1253,40,365,0,195,586,97,0,1283
2017,Ethiopia,Adiharush : Point,500,541,0,528,2256,16,0,3841,464,616,0,951,3688,46,0,5765
2017,Ethiopia,Akula Community : Point,157,234,0,101,405,20,0,917,167,238,0,139,205,14,0,763
2017,Ethiopia,Asaita : Point,1196,1563,0,806,2962,224,0,6751,1353,1739,0,1025,2650,280,0,7047
2017,Ethiopia,Awbarre : Point,911,1853,0,2033,1521,67,0,6385,864,1876,0,1709,1126,57,0,5632
2017,Ethiopia,Bambasi Camp : Point,2063,2011,0,1084,3113,307,0,8578,2113,2083,0,1258,2856,314,0,8624
2017,Ethiopia,Berhale : Point,1176,3646,0,2310,5251,242,0,12625,1161,3776,0,2365,2937,346,0,10585
2017,Ethiopia,Bokolmanyo : Point,2463,6480,0,4568,8779,499,0,22789,2462,6527,0,4847,5911,576,0,20323
2017,Ethiopia,Border areas (Gambella),0,0,0,0,0,0,0,0,0,0,0,0,0,0,0,0
2017,Ethiopia,Borena : Awrajja - Zone,397,379,0,316,808,146,0,2046,446,404,0,310,596,122,0,1878
2017,Ethiopia,Buramino : Point,1560,7832,0,4200,8266,487,0,22345,1703,7671,0,4347,4537,482,0,18740
2017,Ethiopia,Burbiey,0,0,0,0,0,0,0,0,0,0,0,0,0,0,0,0
2017,Ethiopia,Gure-Shembola : Point,427,403,0,183,596,8,0,1617,464,614,0,436,523,17,0,2054
2017,Ethiopia,Hilaweyn : Point,3671,8668,0,4607,9291,499,0,26736,3807,8591,0,4750,5315,589,0,23052
2017,Ethiopia,Hitsats,502,544,0,471,2254,15,0,3786,508,642,0,1378,4000,33,0,6561
2017,Ethiopia,Jewi,6209,9633,0,5004,12326,672,0,33844,6263,9906,0,5764,4047,234,0,26214
2017,Ethiopia,Kebribeyah : Point,1374,1208,0,1673,2842,231,0,7328,1388,1265,0,1619,2544,269,0,7085
2017,Ethiopia,Kobe Camp : Point,3231,8075,0,4240,8661,663,0,24870,3283,7983,0,4674,5907,774,0,22621
2017,Ethiopia,Kule Camp,5008,7758,0,3667,11612,763,0,28808,5297,7664,0,4290,6960,323,0,24534
2017,Ethiopia,Mai-Ayni : Point,704,825,0,550,2636,29,0,4744,747,881,0,1092,4002,92,0,6814
2017,Ethiopia,Matar,0,0,0,0,0,0,0,0,0,0,0,0,0,0,0,0
2017,Ethiopia,Melkadida : Point,2603,5041,0,3622,6260,339,0,17865,2659,5226,0,3874,4112,442,0,16313
2017,Ethiopia,Nguenyyiel : Point,10678,9484,0,5082,20001,933,0,46178,9414,12743,0,4850,9885,588,0,37480
2017,Ethiopia,NyingNyang : Point,0,0,0,0,0,0,0,0,0,0,0,0,0,0,0,0
2017,Ethiopia,Okugo:Point,1086,1942,0,969,3366,261,0,7624,1116,1973,0,1079,1754,83,0,6005
2017,Ethiopia,Pagak:Point,0,0,0,0,0,0,0,0,0,0,0,0,0,0,0,0
2017,Ethiopia,Pamdong:Point,0,0,0,0,0,0,0,0,0,0,0,0,0,0,0,0
2017,Ethiopia,Pugnido : Point,5490,9637,0,5627,14750,949,0,36453,5778,9804,0,6287,7851,256,0,29976
2017,Ethiopia,Pugnido2,1747,2850,0,1133,3686,205,0,9621,1795,2856,0,1503,1416,73,0,7643
2017,Ethiopia,Sheder : Point,743,1674,0,1680,1686,97,0,5880,729,1721,0,1384,1119,41,0,4994
2017,Ethiopia,Sherkole : Point,999,1403,0,884,2132,99,0,5517,1060,1501,0,1007,2606,104,0,6278
2017,Ethiopia,Shimelba (Shire/Shiraro) : Point,396,459,0,314,1178,183,0,2530,385,502,0,429,1908,176,0,3400
2017,Ethiopia,South Omo - Kangaten,244,328,0,149,674,59,0,1454,267,272,0,187,564,43,0,1333
2017,Ethiopia,Tierkidi:Point,6768,10937,0,5329,15545,950,0,39529,6949,10929,0,6455,6881,350,0,31564
2017,Ethiopia,Tongo Camp : Point,1297,1462,0,904,2331,201,0,6195,1385,1527,0,1049,2309,209,0,6479
2017,Ethiopia,Tsore: Point,1322,1393,0,980,2257,109,0,6061,1411,1606,0,2010,2874,123,0,8024
2017,Ethiopia,Addis Ababa : Astedader akabibi - Chartered city,891,1726,0,1036,7256,189,0,11098,871,1739,0,1096,6033,272,0,10011
2017,Ethiopia,Ethiopia : Dispersed in the country / territory,405,1184,0,1237,15248,121,0,18195,535,1212,0,2572,51018,169,0,55506
2017,Finland,Finland : Dispersed in the country / territory,0,0,0,0,0,0,0,0,0,0,0,0,0,0,0,0
2017,Fiji,Fiji : Dispersed in the country / territory,*,*,0,0,7,0,0,11,0,*,0,*,6,0,0,8
2017,France,France : Dispersed in the country / territory,0,0,0,0,0,0,0,0,0,0,0,0,0,0,0,0
2017,Gabon,Akieni : Point,0,0,0,0,0,0,0,0,0,0,0,0,*,0,0,*
2017,Gabon,Franceville : Point,*,*,0,8,25,0,0,39,0,7,0,*,31,9,0,51
2017,Gabon,Koulamoutou : Point,0,*,0,*,9,0,0,14,*,*,0,*,19,*,0,27
2017,Gabon,Lastoursville : Point,0,0,0,0,0,0,0,0,0,0,0,0,*,0,0,*
2017,Gabon,Leconi,0,0,0,0,0,0,0,0,0,0,0,0,*,0,0,*
2017,Gabon,Libreville : Point,6,27,0,32,195,12,0,272,9,43,0,51,184,36,0,323
2017,Gabon,Makokou : Point,*,*,0,0,*,0,0,*,0,*,0,*,*,0,0,*
2017,Gabon,Medouneu,0,0,0,0,0,0,0,0,0,0,0,0,*,0,0,*
2017,Gabon,Mitzic : Point,0,0,0,0,0,0,0,0,0,0,0,0,*,0,0,*
2017,Gabon,Moanda : Point,*,*,0,*,6,0,0,12,*,*,0,*,15,0,0,23
2017,Gabon,Mouila : Point,0,0,0,*,*,0,0,*,0,0,0,0,*,0,0,*
2017,Gabon,Mounana : Point,0,0,0,0,*,0,0,*,0,0,0,0,*,*,0,*
2017,Gabon,Ndjole : Point,0,0,0,0,0,0,0,0,0,0,0,0,*,0,0,*
2017,Gabon,Ntoum : Point,0,0,0,0,*,0,0,*,0,*,0,0,*,0,0,*
2017,Gabon,Okondja : Point,0,*,0,0,*,0,0,*,0,0,0,0,5,*,0,6
2017,Gabon,Oyem : Point,0,0,0,0,0,0,0,0,0,0,0,0,*,0,0,*
2017,Gabon,Pana/Dienga : Point,0,0,0,0,0,0,0,0,0,0,0,0,*,0,0,*
2017,Gabon,Port-Gentil : Point,*,*,0,*,11,*,0,16,*,*,0,0,14,6,0,26
2017,United Kingdom,United Kingdom of Great Britain and Northern Ireland : Dispersed in the country / territory,0,0,0,0,0,0,0,0,0,0,0,0,0,0,0,0
2017,Georgia,Abkhazia : Autonomous republic,18,36,0,31,173,41,0,299,11,41,0,25,197,41,0,315
2017,Georgia,Georgia : Dispersed in the country / territory,11416,16171,0,10421,79425,31918,0,149351,11893,17385,0,11611,70285,20182,0,131356
2017,Ghana,Accra : District,72,119,0,79,454,15,0,739,68,123,0,81,958,36,0,1266
2017,Ghana,Ampain : Point,180,283,0,237,1064,58,0,1822,177,315,0,242,920,29,0,1683
2017,Ghana,Asanti Region,0,0,0,0,14,*,0,15,*,*,0,0,36,0,0,42
2017,Ghana,Brong Ahafo,*,*,0,*,14,0,0,19,*,0,0,0,7,0,0,10
2017,Ghana,Buduburam : Point,17,35,0,62,578,34,0,726,24,50,0,61,493,24,0,652
2017,Ghana,Central Region and its environs,6,19,0,15,50,*,0,93,*,11,0,13,62,*,0,93
2017,Ghana,Eastern region environa,*,5,0,*,11,*,0,19,*,*,0,*,10,*,0,19
2017,Ghana,Egyeikroum : Point,102,117,0,92,412,19,0,742,93,140,0,80,412,14,0,739
2017,Ghana,Fetentaa : Point,68,86,0,55,286,17,0,512,60,89,0,58,251,5,0,463
2017,Ghana,Krisan : Point,35,54,0,37,139,8,0,273,38,62,0,33,319,6,0,458
2017,Ghana,Northen Region,0,0,0,0,0,0,0,0,0,0,0,0,*,0,0,*
2017,Ghana,Volta : Region,102,222,0,182,725,71,0,1302,104,231,0,200,967,72,0,1574
2017,Ghana,Western region environa,15,15,0,15,52,*,0,98,6,17,0,7,76,*,0,109
2017,Guinea,Conakry : Special zone,32,61,0,77,301,17,0,488,45,77,0,83,395,16,0,616
2017,Guinea,Kouankan : Point,325,389,0,373,1031,51,0,2169,301,404,0,321,937,37,0,2000
2017,Gambia,Gambia : Dispersed in the country / territory,520,863,0,616,1920,224,0,4143,492,886,0,623,1668,270,0,3939
2017,Guinea-Bissau,Arame,*,*,0,0,8,0,0,14,*,*,0,6,*,0,0,14
2017,Guinea-Bissau,Asselem,7,18,0,14,41,14,0,94,7,18,0,16,37,7,0,85
2017,Guinea-Bissau,Bachil,19,64,0,38,115,20,0,256,13,63,0,55,79,5,0,215
2017,Guinea-Bissau,Barraca Banana,*,*,0,0,8,*,0,16,*,*,0,*,9,0,0,14
2017,Guinea-Bissau,Barraca Batata,0,0,0,0,0,0,0,0,0,0,0,0,*,0,0,*
2017,Guinea-Bissau,Barraca Biro,*,11,0,6,23,6,0,48,*,12,0,*,12,*,0,32
2017,Guinea-Bissau,Barraca Fronteira,0,*,0,0,*,0,0,*,0,0,0,0,*,0,0,*
2017,Guinea-Bissau,Barraca Lugar,5,22,0,14,48,13,0,102,7,21,0,12,29,*,0,72
2017,Guinea-Bissau,Barraca Mandioca,10,22,0,12,52,8,0,104,6,21,0,9,37,8,0,81
2017,Guinea-Bissau,Barraca Poilao,0,*,0,*,*,0,0,6,0,0,0,*,*,0,0,*
2017,Guinea-Bissau,Barraca Tara,*,*,0,6,11,*,0,23,*,6,0,*,12,0,0,25
2017,Guinea-Bissau,Barro,0,*,0,0,13,0,0,14,*,*,0,*,5,0,0,10
2017,Guinea-Bissau,Becaur,*,5,0,5,21,0,0,32,*,6,0,6,15,*,0,30
2017,Guinea-Bissau,Beguingue,11,27,0,26,108,21,0,193,12,42,0,32,62,7,0,155
2017,Guinea-Bissau,Beguingue II,0,0,0,0,*,0,0,*,*,0,0,0,0,0,0,*
2017,Guinea-Bissau,Bigene : Point,30,52,0,49,132,22,0,285,18,60,0,42,80,11,0,211
2017,Guinea-Bissau,Binhan,*,*,0,*,*,0,0,8,0,*,0,0,*,*,0,*
2017,Guinea-Bissau,Bissary,0,0,0,0,0,*,0,*,0,0,0,0,0,0,0,0
2017,Guinea-Bissau,Bissau : Autonomous sector,*,5,0,*,7,0,0,18,*,*,0,*,47,0,0,55
2017,Guinea-Bissau,Bucaur,*,*,0,0,*,0,0,*,0,0,0,0,0,0,0,0
2017,Guinea-Bissau,Bufa,15,20,0,15,38,7,0,95,*,18,0,18,16,*,0,59
2017,Guinea-Bissau,Buguim,0,0,0,0,*,0,0,*,0,*,0,0,0,0,0,*
2017,Guinea-Bissau,Bugul,0,*,0,0,0,*,0,*,0,0,0,*,*,0,0,*
2017,Guinea-Bissau,Buniack,*,*,0,0,*,0,0,*,0,0,0,0,*,0,0,*
2017,Guinea-Bissau,Cacheu,*,*,0,*,*,*,0,8,0,*,0,0,6,*,0,8
2017,Guinea-Bissau,Caitoto,*,*,0,*,6,*,0,11,*,*,0,*,6,0,0,12
2017,Guinea-Bissau,Campada-Nema,*,10,0,14,35,7,0,69,6,10,0,10,32,*,0,61
2017,Guinea-Bissau,Canjandi,7,27,0,19,54,13,0,120,16,27,0,20,58,7,0,128
2017,Guinea-Bissau,Capal,6,15,0,14,32,*,0,70,11,11,0,9,14,*,0,47
2017,Guinea-Bissau,Carabane Balanta,8,19,0,17,66,9,0,119,11,22,0,14,55,7,0,109
2017,Guinea-Bissau,Carabane Manjaco,*,*,0,*,*,0,0,*,*,*,0,*,*,0,0,*
2017,Guinea-Bissau,Caruai,*,16,0,8,20,10,0,55,*,20,0,9,16,5,0,54
2017,Guinea-Bissau,Cassolol,*,13,0,6,23,6,0,49,*,8,0,6,20,6,0,42
2017,Guinea-Bissau,Cassou,*,0,0,0,*,0,0,6,*,*,0,0,*,*,0,8
2017,Guinea-Bissau,Catel,9,17,0,9,39,*,0,77,9,14,0,16,34,5,0,78
2017,Guinea-Bissau,Copa,*,0,0,0,*,0,0,*,0,*,0,0,0,0,0,*
2017,Guinea-Bissau,Danhaba,0,*,0,0,7,0,0,8,0,*,0,*,*,0,0,5
2017,Guinea-Bissau,Djacumundo,13,52,0,32,94,34,0,225,15,38,0,36,74,9,0,172
2017,Guinea-Bissau,Djambam,*,*,0,*,8,0,0,16,0,5,0,7,9,0,0,21
2017,Guinea-Bissau,Djatacunda,0,0,0,0,*,0,0,*,0,0,0,0,0,0,0,0
2017,Guinea-Bissau,Djendem,5,16,0,6,18,*,0,48,6,12,0,6,20,*,0,48
2017,Guinea-Bissau,Edjaten,0,7,0,*,12,7,0,29,*,*,0,*,17,*,0,27
2017,Guinea-Bissau,Faradjanto,*,*,0,*,*,*,0,6,0,0,0,0,5,*,0,6
2017,Guinea-Bissau,Hafia,*,*,0,0,*,0,0,6,*,0,0,0,*,*,0,*
2017,Guinea-Bissau,Ingore,11,29,0,20,82,11,0,153,0,*,0,25,64,16,0,108
2017,Guinea-Bissau,Ingorezinho,20,37,0,21,83,10,0,171,7,44,0,26,74,9,0,160
2017,Guinea-Bissau,Jegue,10,35,0,27,77,24,0,173,6,32,0,30,74,8,0,150
2017,Guinea-Bissau,Jolmete : Point,19,69,0,34,144,16,0,282,28,57,0,45,119,13,0,262
2017,Guinea-Bissau,Jugul,*,8,0,*,17,*,0,33,5,*,0,6,5,*,0,23
2017,Guinea-Bissau,Liman,*,6,0,0,17,*,0,25,5,7,0,*,13,*,0,29
2017,Guinea-Bissau,Make,16,25,0,18,57,*,0,118,17,13,0,14,39,*,0,85
2017,Guinea-Bissau,Mandina,5,13,0,8,50,11,0,87,10,11,0,12,27,6,0,66
2017,Guinea-Bissau,Mandina Beguingue,0,0,0,0,*,0,0,*,0,0,0,0,*,0,0,*
2017,Guinea-Bissau,Mapatas,0,7,0,13,29,*,0,50,6,12,0,12,15,*,0,46
2017,Guinea-Bissau,Mbaiam,19,37,0,22,80,10,0,168,11,34,0,26,53,*,0,128
2017,Guinea-Bissau,Metade,*,9,0,*,16,*,0,32,*,*,0,*,20,*,0,32
2017,Guinea-Bissau,Nbanaya,0,*,0,0,*,*,0,5,*,*,0,0,*,*,0,*
2017,Guinea-Bissau,Ndodja,*,*,0,7,8,*,0,25,*,6,0,0,8,*,0,20
2017,Guinea-Bissau,Nema,0,0,0,0,*,0,0,*,0,0,0,0,*,0,0,*
2017,Guinea-Bissau,Nhafena,0,0,0,0,0,0,0,0,*,0,0,0,0,0,0,*
2017,Guinea-Bissau,Nhalom,5,7,0,0,9,*,0,24,*,6,0,*,8,*,0,21
2017,Guinea-Bissau,Nhambala,*,*,0,*,9,*,0,19,*,6,0,*,11,*,0,24
2017,Guinea-Bissau,Nhataba,0,0,0,0,*,0,0,*,0,0,0,0,*,0,0,*
2017,Guinea-Bissau,Ntableck,*,5,0,5,26,*,0,41,*,9,0,*,18,0,0,31
2017,Guinea-Bissau,Ntchof,0,0,0,0,0,0,0,0,*,0,0,0,*,0,0,*
2017,Guinea-Bissau,Pantam grande,0,*,0,*,*,*,0,6,*,*,0,*,*,0,0,8
2017,Guinea-Bissau,Pantazinho,*,*,0,*,12,*,0,19,*,*,0,5,5,*,0,16
2017,Guinea-Bissau,Papia,8,31,0,24,58,9,0,130,5,30,0,26,49,*,0,112
2017,Guinea-Bissau,Pelundo,14,46,0,40,80,17,0,197,12,29,0,34,87,15,0,177
2017,Guinea-Bissau,Poilao de Leao,0,*,0,*,6,*,0,9,0,*,0,*,6,0,0,10
2017,Guinea-Bissau,Ponta  Cristovao,*,*,0,*,*,0,0,7,*,*,0,*,6,0,0,11
2017,Guinea-Bissau,Pubosse,0,0,0,0,*,0,0,*,0,*,0,0,*,0,0,*
2017,Guinea-Bissau,Quetiba,*,9,0,5,13,*,0,30,*,5,0,6,7,*,0,22
2017,Guinea-Bissau,Saiam Mandinga,17,29,0,10,53,5,0,114,12,17,0,16,30,6,0,81
2017,Guinea-Bissau,Samugi,*,*,0,0,*,*,0,10,*,*,0,0,5,0,0,9
2017,Guinea-Bissau,Sancoma,9,27,0,16,71,12,0,135,10,20,0,22,36,10,0,98
2017,Guinea-Bissau,Sano,0,*,0,*,*,0,0,*,*,0,0,*,*,0,0,*
2017,Guinea-Bissau,Sano Sidif,7,8,0,10,13,*,0,39,*,12,0,6,14,*,0,34
2017,Guinea-Bissau,Sao Domingos : Point,0,*,0,*,10,*,0,15,*,0,0,*,13,0,0,15
2017,Guinea-Bissau,Sedengal,10,22,0,22,54,8,0,116,10,30,0,26,48,9,0,123
2017,Guinea-Bissau,Senquer Darsalam,*,*,0,*,*,0,0,10,*,0,0,0,*,0,0,*
2017,Guinea-Bissau,Sidif,7,5,0,*,*,0,0,16,*,*,0,*,*,0,0,10
2017,Guinea-Bissau,Sidimentocunca,*,0,0,*,5,0,0,10,*,*,0,*,6,0,0,10
2017,Guinea-Bissau,Sindina,10,25,0,23,57,5,0,120,12,30,0,30,40,7,0,119
2017,Guinea-Bissau,Suar,0,*,0,*,*,0,0,5,0,*,0,0,*,0,0,*
2017,Guinea-Bissau,Sungutoto,10,50,0,28,112,20,0,220,19,39,0,37,88,10,0,193
2017,Guinea-Bissau,Tabanca Novo,0,0,0,0,0,0,0,0,0,0,0,0,*,0,0,*
2017,Guinea-Bissau,Tanzania,0,*,0,*,14,*,0,23,0,*,0,*,11,*,0,15
2017,Guinea-Bissau,Tarrero,11,31,0,13,87,13,0,155,20,35,0,13,66,6,0,140
2017,Guinea-Bissau,Tchur,0,0,0,0,0,0,0,0,0,0,0,0,*,0,0,*
2017,Guinea-Bissau,Tenhate,*,11,0,*,20,6,0,45,*,15,0,17,11,9,0,53
2017,Guinea-Bissau,Varela,*,17,0,11,40,*,0,73,6,19,0,15,38,6,0,84
2017,Guinea-Bissau,Guinea-Bissau : Dispersed In the country/territory,102,68,0,30,131,6,0,337,91,67,0,34,83,*,0,277
2017,Greece,Greece : Dispersed in the country / territory,0,0,0,0,0,0,0,0,0,0,0,0,0,0,0,0
2017,Grenada,St. George's,0,0,0,0,*,0,0,*,*,0,0,0,*,0,0,*
2017,Guatemala,Guatemala : Dispersed in the country / territory,0,0,0,0,0,0,0,0,0,0,0,0,0,0,0,0
2017,Guyana,Guyana : Dispersed in the country / territory,0,0,0,*,6,0,0,8,0,*,0,*,9,0,0,11
2017,"China, Hong Kong SAR","Hong Kong SAR, China : Dispersed in the country / territory",5,6,0,*,28,0,0,42,*,*,0,*,49,*,0,62
2017,Honduras,Honduras : Dispersed in the country / territory,10000,12700,0,13708,48611,4300,0,89319,11100,15900,0,12507,41614,3600,0,84721
2017,Croatia,Bjelovar : Point,0,0,0,0,0,0,0,0,0,0,0,0,*,0,0,*
2017,Croatia,Croatia : Dispersed in the country / territory,0,0,0,0,0,0,0,0,0,0,0,0,0,0,0,0
2017,Croatia,Grad Zagreb : Grad - City,12,9,0,8,45,0,0,74,14,13,0,23,287,*,0,341
2017,Croatia,Kutina : Point,0,0,0,0,0,0,0,0,0,0,0,0,*,0,0,*
2017,Croatia,Rijeka : Point,0,0,0,0,0,0,0,0,0,0,0,0,*,0,0,*
2017,Croatia,Vinkovci : Point,0,0,0,0,*,0,0,*,0,0,0,0,0,0,0,0
2017,Croatia,Zagreb,17,29,0,12,103,*,0,162,18,25,0,27,229,0,0,299
2017,Haiti,Haiti : Dispersed in the country / territory,0,541,0,307,268,*,0,1119,0,546,0,347,289,*,0,1183
2017,Hungary,F??t,0,0,0,0,0,0,0,0,0,0,0,0,0,0,0,0
2017,Hungary,Hungary : Dispersed in the country / territory,0,0,0,0,0,0,0,0,0,0,0,0,0,0,0,0
2017,Hungary,Kiskunhalas,0,0,0,0,0,0,0,0,0,0,0,0,0,0,0,0
2017,Hungary,Nyirbator,0,0,0,0,0,0,0,0,0,0,0,0,0,0,0,0
2017,Hungary,Roszke and Tompa,0,0,0,0,0,0,0,0,0,0,0,0,0,0,0,0
2017,Hungary,Vamosszabadi,0,0,0,0,0,0,0,0,0,0,0,0,0,0,0,0
2017,Indonesia,Bali : Provinsi - Province,*,5,0,5,13,0,0,25,*,*,0,5,37,0,0,47
2017,Indonesia,Banten,34,60,0,31,177,5,0,307,44,51,0,38,580,5,0,718
2017,Indonesia,Irian Jaya Tengah,0,0,0,0,0,0,0,0,0,0,0,0,*,0,0,*
2017,Indonesia,Jakarta,87,130,0,97,537,22,0,873,119,135,0,265,1098,18,0,1635
2017,Indonesia,Jambi,0,0,0,0,*,0,0,*,0,0,0,0,0,0,0,0
2017,Indonesia,Jawa Barat : Provinsi - Province,100,145,0,110,533,38,0,926,121,187,0,166,1480,31,0,1985
2017,Indonesia,Jawa Tengah : Provinsi - Province,7,15,0,13,35,0,0,70,14,18,0,10,32,0,0,74
2017,Indonesia,Jawa Timur : Provinsi - Province,*,*,0,*,5,0,0,9,0,*,0,*,436,0,0,442
2017,Indonesia,Kalimantan Barat : Provinsi - Province,0,0,0,0,*,0,0,*,0,*,0,*,140,0,0,143
2017,Indonesia,Kalimantan Selatan,*,0,0,0,0,0,0,*,*,0,0,0,0,0,0,*
2017,Indonesia,Kalimantan Timur : Provinsi - Province,0,0,0,0,0,0,0,0,0,0,0,*,182,*,0,184
2017,Indonesia,Kepulauan Riau : Provinsi - Province,28,21,0,5,67,0,0,121,28,11,0,15,506,*,0,561
2017,Indonesia,Lampung,0,0,0,0,0,0,0,0,0,0,0,0,*,0,0,*
2017,Indonesia,Nanggroe Aceh Darussalam,*,0,0,0,0,0,0,*,*,0,0,0,*,0,0,*
2017,Indonesia,Other,0,0,0,*,*,0,0,5,*,*,0,0,14,0,0,17
2017,Indonesia,Riau : Provinsi - Province,52,65,0,34,171,8,0,330,59,87,0,46,629,6,0,827
2017,Indonesia,Sulawesi Utara : Provinsi - Province,*,*,0,*,7,0,0,14,0,*,0,*,114,0,0,117
2017,Indonesia,Sumatera Barat : Provinsi - Province,0,0,0,0,0,0,0,0,0,0,0,0,*,0,0,*
2017,Indonesia,Yogyakarta,0,*,0,0,0,0,0,*,0,*,0,*,*,0,0,5
2017,Indonesia,Nusa Tenggara Timur : Provinsi - Province,15,7,0,11,35,*,0,69,13,9,0,9,237,*,0,269
2017,Indonesia,Sulawesi Selatan : Provinsi - Province,75,80,0,47,265,9,0,476,93,79,0,70,1114,6,0,1362
2017,Indonesia,Sumatera Utara : Provinsi - Province,150,144,0,89,494,12,0,889,163,144,0,131,869,15,0,1322
2017,India,Delhi : Union territory,2296,2989,0,2098,10068,590,0,18041,2585,3164,0,2388,11001,639,0,19777
2017,India,India : Dispersed in the country / territory,0,0,0,0,0,0,0,0,0,0,0,0,0,0,0,0
2017,India,Tamil Nadu : State,0,0,0,0,0,0,0,0,0,0,0,0,0,0,0,0
2017,Ireland,Ireland : Dispersed in the country / territory,302,393,0,260,3297,147,0,4399,335,394,0,314,6467,173,0,7683
2017,Iran (Islamic Rep. of),Abazar : Point,*,6,0,9,32,6,0,54,5,8,0,12,49,*,0,78
2017,Iran (Islamic Rep. of),Ansar,*,*,0,*,18,*,0,29,*,*,0,*,17,5,0,27
2017,Iran (Islamic Rep. of),Bani Najjar : Point,102,109,0,169,614,12,0,1006,122,104,0,154,599,20,0,999
2017,Iran (Islamic Rep. of),Bezileh : Point,*,*,0,*,12,*,0,17,*,*,0,*,11,*,0,19
2017,Iran (Islamic Rep. of),Dalaki : Point,33,14,0,16,35,7,0,105,28,14,0,14,22,8,0,86
2017,Iran (Islamic Rep. of),Dilzeh : Point,*,*,0,*,6,*,0,11,*,*,0,*,6,*,0,10
2017,Iran (Islamic Rep. of),Ebrahim Abad,7,9,0,*,20,*,0,41,5,7,0,6,21,*,0,43
2017,Iran (Islamic Rep. of),Islamic Republic of Iran : Dispersed in the country / territory,0,0,0,0,0,0,0,0,0,0,0,0,0,0,0,0
2017,Iran (Islamic Rep. of),Mohajerin : Point,225,248,0,319,913,92,0,1797,207,295,0,279,865,112,0,1758
2017,Iran (Islamic Rep. of),Sultanieh : Point,*,0,0,*,*,*,0,8,*,0,0,*,*,*,0,6
2017,Iran (Islamic Rep. of),Varmahang : Point,*,*,0,*,*,0,0,6,0,0,0,*,0,0,0,*
2017,Iran (Islamic Rep. of),Ziveh : Point,6,18,0,32,99,5,0,160,5,15,0,16,82,9,0,127
2017,Iran (Islamic Rep. of),Ardakan : Shahrestan - County,159,242,0,295,628,38,0,1362,190,258,0,269,709,60,0,1486
2017,Iran (Islamic Rep. of),Bardsir : Shahrestan - County,261,262,0,295,612,35,0,1465,248,265,0,301,624,29,0,1467
2017,Iran (Islamic Rep. of),Jahrom : Shahrestan - County,5,9,0,12,42,7,0,75,5,8,0,12,43,*,0,70
2017,Iran (Islamic Rep. of),Khuzestan : Ostan - Province,0,*,0,0,*,0,0,*,*,0,0,0,*,0,0,*
2017,Iran (Islamic Rep. of),Meybod : Shahrestan - County,74,68,0,84,332,14,0,572,65,68,0,100,338,14,0,585
2017,Iran (Islamic Rep. of),Rafsanjan : Shahrestan - County,352,580,0,607,657,220,0,2416,393,540,0,695,622,292,0,2542
2017,Iran (Islamic Rep. of),Sarvestan : Shahrestan - County,47,70,0,48,129,10,0,304,37,51,0,58,135,25,0,306
2017,Iran (Islamic Rep. of),Saveh : Shahrestan - County,395,609,0,495,870,55,0,2424,470,574,0,545,805,154,0,2548
2017,Iran (Islamic Rep. of),Sonqor : Shahrestan - County,*,*,0,*,7,*,0,14,*,*,0,*,*,*,0,13
2017,Iran (Islamic Rep. of),Taft : Shahrestan - County,41,37,0,112,208,24,0,422,31,77,0,99,251,14,0,472
2017,Iran (Islamic Rep. of),Tehran : Shahrestan - County,*,0,0,*,5,0,0,7,*,*,0,*,*,0,0,10
2017,Iran (Islamic Rep. of),Torbat e jam : Shahrestan - County,131,252,0,291,1190,105,0,1969,140,262,0,330,1197,161,0,2090
2017,Iraq,Al-hasakeh: Muhafazah - Province,0,0,0,0,*,*,0,*,0,*,0,0,*,0,0,*
2017,Iraq,Anbar : Muhafazah - Province,0,0,0,0,0,0,0,0,0,0,0,0,0,0,0,0
2017,Iraq,Anbar: Muhafazah - Province,160,643,0,400,1078,134,0,2415,126,656,0,413,767,88,0,2050
2017,Iraq,Babylon : Muhafazah - Province,0,0,0,0,0,0,0,0,0,0,0,0,0,0,0,0
2017,Iraq,Babylon: Muhafazah - Province,*,*,0,0,5,*,0,8,0,*,0,*,8,0,0,15
2017,Iraq,Baghdad : Muhafazah - Province,221,430,0,344,2191,477,0,3663,240,474,0,330,2381,677,0,4102
2017,Iraq,Basrah : Muhafazah - Province,25,36,0,19,82,10,0,172,20,34,0,25,108,6,0,193
2017,Iraq,Dahuk,0,0,0,0,0,0,0,0,0,0,0,0,0,0,0,0
2017,Iraq,Diyala : Muhafazah - Province,*,12,0,10,62,8,0,94,*,16,0,11,52,6,0,86
2017,Iraq,Duhok: Muhafazah - Province,7474,8472,0,4598,22518,1440,0,44502,7912,8762,0,5045,25120,1208,0,48047
2017,Iraq,Erbil : Muhafazah - Province,6494,6890,0,4789,27956,1930,0,48059,7085,7291,0,5485,37772,1764,0,59397
2017,Iraq,Erbil: Muhafazah - Province,3023,3268,0,1890,8514,559,0,17254,3176,3399,0,1999,8859,413,0,17846
2017,Iraq,Kerbala : Muhafazah - Province,14,18,0,5,66,8,0,111,*,18,0,12,125,9,0,168
2017,Iraq,Kirkuk : Muhafazah - Province,0,0,0,0,0,0,0,0,0,0,0,0,0,0,0,0
2017,Iraq,Kirkuk: Muhafazah - Province,48,76,0,50,180,12,0,366,53,94,0,56,298,18,0,519
2017,Iraq,Missan : Muhafazah - Province,0,0,0,0,0,0,0,0,0,0,0,0,0,0,0,0
2017,Iraq,Missan: Muhafazah - Province,0,*,0,0,7,0,0,8,0,*,0,*,16,*,0,20
2017,Iraq,Muthanna : Muhafazah - Province,0,0,0,0,0,0,0,0,0,0,0,0,0,0,0,0
2017,Iraq,Muthanna: Muhafazah - Province,0,0,0,0,0,0,0,0,0,0,0,0,0,*,0,*
2017,Iraq,Najaf : Muhafazah - Province,11,15,0,13,85,5,0,129,18,17,0,20,244,5,0,304
2017,Iraq,Ninewa,0,0,0,0,0,0,0,0,0,0,0,0,0,0,0,0
2017,Iraq,Ninewa: Muhafazah - Province,41,229,0,151,763,87,0,1271,39,219,0,187,664,86,0,1195
2017,Iraq,Qadissiya: Muhafazah - Province,0,6,0,7,15,*,0,29,*,5,0,*,10,*,0,21
2017,Iraq,Qadissyah,0,0,0,0,0,0,0,0,0,0,0,0,0,0,0,0
2017,Iraq,Salah al-Din : Muhafazah - Province,0,0,0,0,0,0,0,0,0,0,0,0,0,0,0,0
2017,Iraq,Salah al-Din: Muhafazah - Province,*,*,0,5,13,*,0,28,*,*,0,*,22,8,0,36
2017,Iraq,Sulaymaniyah : Muhafazah - Province,2850,2808,0,1700,9315,597,0,17270,2912,2963,0,1964,12520,550,0,20909
2017,Iraq,Sulaymanyah,0,0,0,0,0,0,0,0,0,0,0,0,0,0,0,0
2017,Iraq,Thi-Qar : Muhafazah - Province,0,0,0,0,0,0,0,0,0,0,0,0,0,0,0,0
2017,Iraq,Thi-Qar: Muhafazah - Province,12,26,0,21,47,*,0,109,13,15,0,17,35,0,0,80
2017,Iraq,Wassit : Muhafazah - Province,0,0,0,0,0,0,0,0,0,0,0,0,0,0,0,0
2017,Iraq,Wassit: Muhafazah - Province,*,*,0,0,10,*,0,14,*,*,0,*,7,*,0,14
2017,Iraq,Iraq : Dispersed in the country / territory,16,10,0,8,51,*,0,89,16,14,0,*,75,*,0,111
2017,Iceland,Iceland : Dispersed in the country / territory,0,0,0,0,0,0,0,0,0,0,0,0,0,0,0,0
2017,Israel,Israel : Dispersed in the country / territory,0,0,0,0,0,0,0,0,0,0,0,0,0,0,0,0
2017,Italy,Italy : Dispersed in the country / territory,0,0,0,0,0,0,0,0,0,0,0,0,0,0,0,0
2017,Jamaica,Jamaica : Dispersed in the country / territory,0,0,0,0,6,0,0,6,*,0,0,0,17,0,0,18
2017,Jordan,Ajlun : Governorate,511,839,0,560,1627,163,0,3700,604,930,0,548,1243,109,0,3434
2017,Jordan,Amman : Governorate,14278,22249,0,13368,61007,7795,0,118697,15165,23580,0,14289,69793,6358,0,129185
2017,Jordan,Aqabah : Governorate,264,323,0,189,862,76,0,1714,284,358,0,187,1064,56,0,1949
2017,Jordan,Balqa : Governorate,1480,2093,0,1225,4916,436,0,10150,1595,2259,0,1338,4856,367,0,10415
2017,Jordan,Irbid : Governorate,8632,14473,0,9344,30969,3282,0,66700,9133,15274,0,9585,24917,2242,0,61151
2017,Jordan,Jarash : Governorate,699,1027,0,641,2152,212,0,4731,741,1071,0,647,1843,143,0,4445
2017,Jordan,Karak : Governorate,684,874,0,490,1838,186,0,4072,682,986,0,561,1899,136,0,4264
2017,Jordan,Maan : Governorate,608,724,0,403,1606,129,0,3470,574,742,0,448,2027,100,0,3891
2017,Jordan,Madaba : Governorate,931,1205,0,716,2703,228,0,5783,1035,1279,0,776,2739,164,0,5993
2017,Jordan,Mafraq : Governorate,7478,10711,0,6981,22436,2127,0,49733,8011,11020,0,7245,19218,1385,0,46879
2017,Jordan,Mafraq : Zataari Camp,7556,8430,0,5442,16394,1206,0,39028,8005,8870,0,5775,14738,869,0,38257
2017,Jordan,Tafilah : Governorate,122,172,0,93,354,24,0,765,142,184,0,94,434,21,0,875
2017,Jordan,Zarqa : Emirates Jordanian Camp (EJC),617,912,0,576,1361,87,0,3553,693,928,0,546,1190,71,0,3428
2017,Jordan,Zarqa : Governorate,3301,5361,0,3478,12270,1168,0,25578,3399,5815,0,3550,11203,804,0,24771
2017,Jordan,Zarqa: Azraq Camp,5501,6270,0,3170,11493,686,0,27120,5725,6660,0,3592,9692,468,0,26137
2017,Jordan,Jordan : Dispersed in the country / territory,137,455,0,275,1370,181,0,2418,196,486,0,331,1399,143,0,2555
2017,Japan,Japan : Dispersed in the country / territory,0,0,0,0,0,0,0,0,0,0,0,0,0,0,0,0
2017,Kazakhstan,Almaty : City,14,33,0,25,145,14,0,231,18,36,0,33,178,14,0,279
2017,Kazakhstan,Almaty : Oblast - Province,0,*,0,*,17,*,0,25,0,*,0,*,18,*,0,26
2017,Kazakhstan,Astana : City,0,0,0,*,0,0,0,*,0,0,0,*,*,0,0,*
2017,Kazakhstan,Karaganda,0,0,0,*,0,0,0,*,0,*,0,*,*,0,0,5
2017,Kazakhstan,Kazakhstan : Dispersed in the country / territory,0,0,0,0,0,0,0,0,0,0,0,0,0,0,0,0
2017,Kazakhstan,Kostanai,0,0,0,0,0,0,0,0,0,0,0,0,*,0,0,*
2017,Kazakhstan,Pavlodar,0,*,0,*,*,0,0,7,*,*,0,*,*,0,0,8
2017,Kazakhstan,Zhambyl : Oblast - Province,0,0,0,0,0,0,0,0,0,0,0,0,*,0,0,*
2017,Kazakhstan,South Kazakhstan : Oblast - Province,12,16,0,15,53,*,0,98,16,22,0,17,75,*,0,131
2017,Kenya,Dagahaley : Point,5344,8014,0,6048,14318,1277,0,35001,5446,8267,0,6597,11823,1204,0,33337
2017,Kenya,Hagadera : Point,5473,9380,0,7093,18618,1531,0,42095,5841,9890,0,7910,16108,1515,0,41264
2017,Kenya,Ifo 2 : Point,2053,2698,0,2073,3844,294,0,10962,2169,2808,0,2480,3520,324,0,11301
2017,Kenya,Ifo : Point,4566,7047,0,5544,14112,1312,0,32581,4920,7263,0,6054,12096,1278,0,31611
2017,Kenya,Kakuma : Point,14497,21704,0,14956,34013,1408,0,86578,15074,24289,0,21543,36961,709,0,98576
2017,Kenya,Kenya: Dispersed in the country / territory,0,0,0,0,0,0,0,0,0,0,0,0,0,0,0,0
2017,Kenya,Nairobi : Province,2996,4844,0,4916,18243,794,0,31793,3263,5198,0,4855,19430,570,0,33316
2017,Kyrgyzstan,Bishkek city,21,23,0,22,110,*,0,180,21,31,0,21,186,7,0,266
2017,Kyrgyzstan,Kyrgyzstan : Dispersed in the country / territory,0,0,0,0,0,0,0,0,0,0,0,0,0,0,0,0
2017,Kyrgyzstan,Osh City : Shaar - City,0,0,0,0,0,0,0,0,0,0,0,0,*,0,0,*
2017,Cambodia,Phnom Penh : Autonomous municipality,*,*,0,*,16,5,0,28,*,7,0,7,57,5,0,77
2017,Saint Kitts and Nevis,Saint Kitts and Nevis : Dispersed in the country / territory,0,0,0,0,*,0,0,*,*,0,0,0,*,0,0,*
2017,Rep. of Korea,Ansan,0,*,0,0,19,*,0,21,0,*,0,*,93,0,0,95
2017,Rep. of Korea,Busan: Gwangyeoksi - Metropolitan City,*,12,0,*,33,0,0,51,10,10,0,10,153,*,0,184
2017,Rep. of Korea,Changwon,*,*,0,0,*,0,0,5,*,*,0,0,14,0,0,16
2017,Rep. of Korea,Cheonan,0,0,0,*,10,0,0,11,0,0,0,0,43,0,0,43
2017,Rep. of Korea,Cheongju,*,0,0,0,14,0,0,15,*,0,0,0,39,0,0,42
2017,Rep. of Korea,Cheongju Detention,0,0,0,*,*,0,0,*,0,0,0,0,*,0,0,*
2017,Rep. of Korea,Chuncheon,0,0,0,0,6,0,0,6,0,0,0,0,6,0,0,6
2017,Rep. of Korea,Daegu : Gwangyeoksi - Metropolitan city,*,*,0,*,14,0,0,22,*,*,0,*,129,0,0,133
2017,Rep. of Korea,Daejeon : Gwangyeoksi - Metropolitan city,*,*,0,0,9,*,0,16,0,0,0,0,17,*,0,18
2017,Rep. of Korea,Dangjin,0,0,0,0,0,0,0,0,0,0,0,0,22,0,0,22
2017,Rep. of Korea,Donghae,0,0,0,0,0,0,0,0,0,0,0,*,22,0,0,23
2017,Rep. of Korea,Gimhae,0,0,0,0,0,0,0,0,0,0,0,0,*,0,0,*
2017,Rep. of Korea,Goyang,0,0,0,0,61,0,0,61,0,*,0,0,62,0,0,63
2017,Rep. of Korea,Gunsan,0,0,0,0,*,0,0,*,*,0,0,0,6,0,0,7
2017,Rep. of Korea,Gwangju,6,9,0,*,64,0,0,81,8,*,0,*,267,*,0,284
2017,Rep. of Korea,Incheon Airport,21,39,0,15,102,5,0,182,22,21,0,23,114,*,0,181
2017,Rep. of Korea,Jeju - Do (Province),*,*,0,*,111,*,0,118,*,*,0,0,142,0,0,148
2017,Rep. of Korea,Jeonju,0,0,0,0,12,0,0,12,*,0,0,0,51,0,0,53
2017,Rep. of Korea,Mokpo,0,0,0,0,0,0,0,0,0,0,0,0,*,0,0,*
2017,Rep. of Korea,Pohang,0,0,0,0,0,0,0,0,0,0,0,0,*,0,0,*
2017,Rep. of Korea,Pyeongtaek,*,*,0,0,50,0,0,52,*,0,0,0,153,*,0,155
2017,Rep. of Korea,Republic of Korea : Dispersed in the country / territory,0,0,0,0,0,0,0,0,0,0,0,0,0,0,0,0
2017,Rep. of Korea,Sacheon,0,0,0,0,0,0,0,0,0,0,0,0,*,0,0,*
2017,Rep. of Korea,Seosan,0,0,0,0,*,0,0,*,0,0,0,0,7,0,0,7
2017,Rep. of Korea,Suwon,*,0,0,0,111,0,0,115,5,*,0,*,496,*,0,507
2017,Rep. of Korea,Ulsan,*,*,0,0,9,0,0,13,*,*,0,0,96,0,0,102
2017,Rep. of Korea,Whasung Detention,0,0,0,0,*,*,0,5,0,0,0,0,15,*,0,18
2017,Rep. of Korea,Yangju,6,*,0,*,187,0,0,196,22,*,0,10,1050,*,0,1085
2017,Rep. of Korea,Yeosu,0,0,0,0,*,0,0,*,0,*,0,0,5,0,0,7
2017,Rep. of Korea,Inchon: Gwangyeoksi - Metropolitan,47,16,0,14,519,*,0,597,32,20,0,22,1686,5,0,1765
2017,Rep. of Korea,Seoul : Teukbyeolsi - Capital metropolitan city,77,56,0,29,884,15,0,1061,61,74,0,38,4029,14,0,4216
2017,Kuwait,Kuwait : Dispersed in the country / territory,28,95,0,92,502,54,0,771,30,108,0,118,489,50,0,795
2017,Lebanon,Beirut : Mohafazah - Governorate,1506,2502,0,1279,5352,311,0,10950,1521,2717,0,1468,5301,305,0,11312
2017,Lebanon,Beqaa : Mohafazah - Governorate,29647,44054,0,26794,87576,5768,0,193839,30869,46089,0,27355,54872,4455,0,163640
2017,Lebanon,North : Mohafazah - Governorate,21650,29114,0,16731,59954,4162,0,131611,22539,30406,0,17407,48382,3172,0,121906
2017,Lebanon,South : Mohafazah - Governorate,10530,15211,0,7933,27851,1362,0,62887,11197,16027,0,8294,21727,1035,0,58280
2017,Lebanon,Mount Lebanon : Mohafazah - Governorate,20060,31863,0,16070,61822,3536,0,133351,21118,33649,0,17326,55477,3070,0,130640
2017,Liberia,Bahn Refugee Camp,116,209,0,124,338,15,0,802,133,195,0,139,282,14,0,763
2017,Liberia,Grand Gedeh : County,30,154,0,89,357,69,0,699,39,147,0,115,373,46,0,720
2017,Liberia,Little Wlebbo : Point,62,124,0,88,215,6,0,495,57,112,0,70,263,10,0,512
2017,Liberia,Maryland : County,*,48,0,34,116,19,0,219,6,53,0,47,149,10,0,265
2017,Liberia,Montserrado : County,8,47,0,137,68,*,0,261,7,49,0,142,131,15,0,344
2017,Liberia,Nimba : County,*,27,0,14,58,9,0,110,*,15,0,18,42,*,0,83
2017,Liberia,PTP : Point,434,679,0,389,1171,87,0,2760,455,644,0,433,1326,79,0,2937
2017,Liberia,River Ghee : County,*,113,0,63,109,9,0,295,*,119,0,74,70,*,0,268
2017,Libya,Al Jabal Al Akhdar,0,0,0,0,0,0,0,0,0,0,0,0,0,0,0,0
2017,Libya,Al Jabal Al Gharbi,0,0,0,0,0,0,0,0,0,0,0,0,0,0,0,0
2017,Libya,Aljfara,0,0,0,0,0,0,0,0,0,0,0,0,0,0,0,0
2017,Libya,Aljufra,0,0,0,0,0,0,0,0,0,0,0,0,0,0,0,0
2017,Libya,Alkufra,0,0,0,0,0,0,0,0,0,0,0,0,0,0,0,0
2017,Libya,Almargeb,0,0,0,0,0,0,0,0,0,0,0,0,0,0,0,0
2017,Libya,Almarj,0,0,0,0,0,0,0,0,0,0,0,0,0,0,0,0
2017,Libya,Azzawya,0,0,0,0,0,0,0,0,0,0,0,0,0,0,0,0
2017,Libya,Benghazi,0,0,0,0,0,0,0,0,0,0,0,0,0,0,0,0
2017,Libya,Derna,0,0,0,0,0,0,0,0,0,0,0,0,0,0,0,0
2017,Libya,Ejdabia,0,0,0,0,0,0,0,0,0,0,0,0,0,0,0,0
2017,Libya,Ghat,0,0,0,0,0,0,0,0,0,0,0,0,0,0,0,0
2017,Libya,Misrata,0,0,0,0,0,0,0,0,0,0,0,0,0,0,0,0
2017,Libya,Murzuq,0,0,0,0,0,0,0,0,0,0,0,0,0,0,0,0
2017,Libya,Nalut,0,0,0,0,0,0,0,0,0,0,0,0,0,0,0,0
2017,Libya,Sebha,0,0,0,0,0,0,0,0,0,0,0,0,0,0,0,0
2017,Libya,Sirt,0,0,0,0,0,0,0,0,0,0,0,0,0,0,0,0
2017,Libya,Tobruk,0,0,0,0,0,0,0,0,0,0,0,0,0,0,0,0
2017,Libya,Tripoli,0,0,0,0,0,0,0,0,0,0,0,0,0,0,0,0
2017,Libya,Ubari,0,0,0,0,0,0,0,0,0,0,0,0,0,0,0,0
2017,Libya,Wadi Ashshati,0,0,0,0,0,0,0,0,0,0,0,0,0,0,0,0
2017,Libya,Zwara,0,0,0,0,0,0,0,0,0,0,0,0,0,0,0,0
2017,Libya,Libya : Dispersed in the country / territory,765,3421,0,2204,11788,820,0,18998,789,3577,0,2382,17996,1277,0,26021
2017,Saint Lucia,Saint Lucia : Dispersed in the country / territory,0,0,0,0,0,0,0,0,0,0,0,0,*,0,0,*
2017,Liechtenstein,Liechtenstein : Dispersed in the country / territory,0,0,0,0,0,0,0,0,0,0,0,0,0,0,0,0
2017,Sri Lanka,Colombo : District,14,16,0,9,51,*,0,92,11,17,0,*,78,*,0,113
2017,Sri Lanka,Gampaha : District,61,75,0,43,296,17,0,492,70,86,0,57,489,18,0,720
2017,Sri Lanka,Jaffna : District,8,21,0,11,135,36,0,211,11,13,0,19,94,33,0,170
2017,Sri Lanka,Kaluthara,*,*,0,*,6,0,0,12,*,*,0,0,12,0,0,17
2017,Sri Lanka,Kegalle,0,0,0,0,0,0,0,0,0,0,0,0,*,0,0,*
2017,Sri Lanka,Kilinochchi : District,*,5,0,*,25,7,0,44,*,8,0,8,30,9,0,57
2017,Sri Lanka,Mannar : District,10,26,0,15,109,23,0,183,17,21,0,18,112,14,0,182
2017,Sri Lanka,Mullaitivu : District,0,9,0,5,29,8,0,51,*,7,0,11,16,11,0,46
2017,Sri Lanka,Trincomalee : District,*,19,0,12,95,16,0,145,8,20,0,18,98,18,0,162
2017,Sri Lanka,Vavuniya : District,*,12,0,22,83,12,0,133,*,16,0,25,85,8,0,138
2017,Sri Lanka,Sri Lanka : Dispersed in the country / territory,*,*,0,*,15,*,0,27,6,*,0,*,16,*,0,30
2017,Lesotho,Lesotho : Dispersed in the country / territory,*,5,0,5,15,0,0,27,*,*,0,8,48,*,0,60
2017,Lithuania,Lithuania : Dispersed in the country / territory,0,0,0,0,0,0,0,0,0,0,0,0,0,0,0,0
2017,Luxembourg,Luxembourg : Dispersed in the country / territory,0,0,0,0,0,0,0,0,0,0,0,0,0,0,0,0
2017,Latvia,Latvia : Dispersed in the country / territory,0,0,0,0,0,0,0,0,0,0,0,0,0,0,0,0
2017,"China, Macao SAR","Macao SAR, China : Dispersed in the country / territory",0,0,0,0,*,0,0,*,0,0,0,*,*,0,0,*
2017,Morocco,Morocco : Dispersed in the country / territory,335,413,0,303,1278,51,0,2380,320,441,0,603,2961,74,0,4399
2017,Monaco,Monaco : Dispersed in the country / territory,0,0,0,0,0,0,0,0,0,0,0,0,0,0,0,0
2017,Rep. of Moldova,Republic of Moldova : Dispersed in the country / territory,*,22,0,14,98,24,0,161,5,18,0,15,265,18,0,321
2017,Madagascar,Madagascar : Dispersed in the country / territory,*,10,0,*,21,*,0,40,6,8,0,8,43,*,0,67
2017,Mexico,Mexico : Dispersed in the country / territory,0,0,0,0,0,0,0,0,0,0,0,0,0,0,0,0
2017,The former Yugoslav Republic of Macedonia,Berovo : Op?ítina - Municipality,0,0,0,0,*,0,0,*,0,0,0,0,0,0,0,0
2017,The former Yugoslav Republic of Macedonia,Kavadarci : Op?ítina - Municipality,0,0,0,0,*,0,0,*,0,0,0,0,0,0,0,0
2017,The former Yugoslav Republic of Macedonia,Kocani : Op?ítina - Municipality,0,0,0,0,*,0,0,*,0,0,0,0,0,0,0,0
2017,The former Yugoslav Republic of Macedonia,Negotino,0,0,0,0,*,0,0,*,0,0,0,0,0,0,0,0
2017,The former Yugoslav Republic of Macedonia,Probistip : Op?ítina - Municipality,0,0,0,0,0,*,0,*,0,0,0,0,0,0,0,0
2017,The former Yugoslav Republic of Macedonia,Veles,0,*,0,*,*,0,0,*,0,*,0,0,0,*,0,*
2017,The former Yugoslav Republic of Macedonia,Vizbegovo : Point,*,*,0,*,7,0,0,14,*,*,0,*,16,0,0,24
2017,The former Yugoslav Republic of Macedonia,Bitola : Op?ítina - Municipality,0,*,0,*,*,0,0,5,0,*,0,*,*,*,0,7
2017,The former Yugoslav Republic of Macedonia,Gostivar : Op?ítina - Municipality,*,*,0,*,10,*,0,17,0,*,0,0,*,0,0,5
2017,The former Yugoslav Republic of Macedonia,Kicevo : Op?ítina - Municipality,0,0,0,0,*,*,0,5,0,0,0,0,*,0,0,*
2017,The former Yugoslav Republic of Macedonia,Kumanovo,*,8,0,*,25,*,0,42,0,8,0,7,11,*,0,27
2017,The former Yugoslav Republic of Macedonia,Prilep : Op?ítina - Municipality,0,*,0,0,*,0,0,*,*,0,0,*,6,0,0,8
2017,The former Yugoslav Republic of Macedonia,Skopje : City,10,41,0,58,247,28,0,384,32,65,0,57,235,14,0,403
2017,The former Yugoslav Republic of Macedonia,Stip : Op?ítina - Municipality,*,*,0,*,*,*,0,10,*,*,0,*,*,0,0,9
2017,The former Yugoslav Republic of Macedonia,Tetovo : Op?ítina - Municipality,0,5,0,10,12,*,0,28,*,*,0,*,17,*,0,28
2017,Mali,Bamako : District,143,225,0,178,608,31,0,1185,131,233,0,168,483,28,0,1043
2017,Mali,Gao : Region,62,125,0,75,243,26,0,531,55,126,0,69,159,26,0,435
2017,Mali,Kayes : R??gion,0,*,0,*,*,0,0,5,*,*,0,*,*,0,0,6
2017,Mali,Kayes : Region,989,1988,0,1314,2941,196,0,7428,1033,2115,0,1312,3046,330,0,7836
2017,Mali,Kidal : R??gion,18,12,0,18,58,0,0,106,8,14,0,22,96,*,0,141
2017,Mali,Koulikoro : R??gion,0,0,0,0,0,0,0,0,0,0,0,0,0,0,0,0
2017,Mali,Menaka : Region,166,248,0,139,332,17,0,902,171,255,0,132,225,23,0,806
2017,Mali,Mopti : Region,34,70,0,26,98,11,0,239,36,55,0,21,43,9,0,164
2017,Mali,Segou : Region,*,16,0,12,34,*,0,64,0,19,0,11,12,*,0,44
2017,Mali,Sikasso : Region,9,9,0,*,22,0,0,44,6,6,0,13,27,*,0,53
2017,Mali,Tombouctou : Region,103,199,0,130,403,39,0,874,90,187,0,119,232,38,0,666
2017,Malta,Block C Registrations : Point,0,0,0,0,0,0,0,0,0,0,0,0,0,0,0,0
2017,Malta,Community,0,0,0,0,0,0,0,0,0,0,0,0,0,0,0,0
2017,Malta,Dar Il-Liedna : Point,0,0,0,0,0,0,0,0,0,0,0,0,0,0,0,0
2017,Malta,Hal Far Family Centre,0,0,0,0,0,0,0,0,0,0,0,0,0,0,0,0
2017,Malta,Hal Far Tent Village : Point,0,0,0,0,0,0,0,0,0,0,0,0,0,0,0,0
2017,Malta,Marsa Open Centre,0,0,0,0,0,0,0,0,0,0,0,0,0,0,0,0
2017,Malta,MEC Balzan : Point,0,0,0,0,0,0,0,0,0,0,0,0,0,0,0,0
2017,Malta,MEC Houses : Point,0,0,0,0,0,0,0,0,0,0,0,0,0,0,0,0
2017,Malta,Peace Lab,0,0,0,0,0,0,0,0,0,0,0,0,0,0,0,0
2017,Myanmar,"Kayah, Kayin and Mon states and Bago and Tanintharyi region : Regional grouping",0,0,0,0,0,0,0,0,0,0,0,0,0,0,0,0
2017,Myanmar,Rakhine : State,13069,11440,0,9045,29598,2385,0,65537,12875,12432,0,9644,25437,2495,0,62883
2017,Myanmar,Kachin and northern Shan states : Regional grouping,7419,7884,0,8139,24323,4082,0,51847,7041,8012,0,8108,21228,2800,0,47189
2017,Montenegro,Bar : Op?à?ítina - Municipality,5,5,0,*,9,5,0,25,6,8,0,*,11,*,0,30
2017,Montenegro,Plav : Op?à?ítina - Municipality,0,0,0,0,*,0,0,*,0,0,0,0,*,0,0,*
2017,Montenegro,Rozaj : Op?ítina - Municipality,0,0,0,0,5,*,0,6,0,*,0,*,*,0,0,6
2017,Montenegro,Tivat : Op?ítina - Municipality,0,0,0,*,*,*,0,8,0,0,0,*,*,0,0,6
2017,Montenegro,Andrijevica : Op?à?ítina - Municipality,0,0,0,*,*,0,0,*,0,0,0,0,*,*,0,*
2017,Montenegro,Berane : Op?à?ítina - Municipality,5,10,0,*,31,7,0,56,*,14,0,6,29,*,0,55
2017,Montenegro,Bijelo Polje : Op?à?ítina - Municipality,0,0,0,0,0,0,0,0,0,0,0,0,*,0,0,*
2017,Montenegro,Budva : Op?à?ítina - Municipality,*,0,0,*,*,*,0,6,*,*,0,0,*,*,0,7
2017,Montenegro,Cetinje : Op?à?ítina - Municipality,*,0,0,0,0,0,0,*,0,*,0,0,*,0,0,*
2017,Montenegro,Danilovgrad : Op?à?ítina - Municipality,0,0,0,*,0,*,0,5,0,0,0,0,7,*,0,8
2017,Montenegro,Herceg Novi : Op?à?ítina - Municipality,0,0,0,0,5,0,0,5,0,0,0,0,*,0,0,*
2017,Montenegro,Kolasin : Op?à?ítina - Municipality,0,0,0,0,0,0,0,0,0,0,0,0,*,0,0,*
2017,Montenegro,Kotor : Op?à?ítina - Municipality,0,0,0,0,*,*,0,*,0,0,0,0,*,*,0,*
2017,Montenegro,Montenegro : Dispersed in the country / territory,*,14,0,*,69,15,0,106,5,12,0,14,90,13,0,134
2017,Montenegro,Niksic : Op?à?ítina - Municipality,6,8,0,*,11,0,0,27,7,7,0,*,18,0,0,34
2017,Montenegro,Pljevlja : Op?à?ítina - Municipality,0,*,0,0,*,0,0,*,0,0,0,*,*,0,0,*
2017,Montenegro,Podgorica : Op?à?ítina - Municipality,6,6,0,*,21,0,0,35,10,7,0,6,22,0,0,45
2017,Montenegro,Podgorica : Op?ítina - Municipality,*,9,0,18,102,16,0,147,*,11,0,20,108,8,0,148
2017,Montenegro,Ulcinj : Op?à?ítina - Municipality,*,0,0,*,*,0,0,6,0,*,0,*,*,0,0,5
2017,Mongolia,Mongolia : Dispersed in the country / territory,0,0,0,0,0,0,0,0,0,0,0,0,0,0,0,0
2017,Mongolia,Ulaanbaatar : Capital city,0,*,0,0,*,0,0,5,0,*,0,0,7,*,0,9
2017,Mozambique,Cabo Delgado : Provincia,25,23,0,*,101,0,0,152,6,*,0,*,379,*,0,390
2017,Mozambique,Gaza : Provincia,*,5,0,*,14,0,0,25,*,5,0,5,33,*,0,45
2017,Mozambique,Inhambane : Provincia,*,6,0,*,21,0,0,30,*,*,0,*,25,0,0,34
2017,Mozambique,Manica : Provincia,*,*,0,5,20,0,0,29,*,*,0,*,35,0,0,44
2017,Mozambique,Maputo Provincia : Provincia,201,233,0,168,1078,19,0,1699,190,264,0,172,2022,38,0,2686
2017,Mozambique,Maratane : Point,693,928,0,619,1897,90,0,4227,733,1013,0,690,2757,47,0,5240
2017,Mozambique,Mozambique : Dispersed in the country / territory,0,0,0,0,0,0,0,0,0,0,0,0,0,0,0,0
2017,Mozambique,Nampula : Provincia,190,184,0,106,685,6,0,1171,211,180,0,84,1973,19,0,2467
2017,Mozambique,Niassa : Provincia,13,21,0,15,69,*,0,119,12,20,0,12,157,*,0,204
2017,Mozambique,Others,17,7,0,*,18,0,0,45,24,11,0,*,27,0,0,65
2017,Mozambique,Sofala : Provincia,6,5,0,*,50,0,0,64,5,10,0,*,148,*,0,166
2017,Mozambique,Tete : Provincia,27,52,0,44,196,7,0,326,17,54,0,29,431,19,0,550
2017,Mozambique,Zambezia : Provincia,32,37,0,15,94,0,0,178,29,25,0,17,228,0,0,299
2017,Mozambique,Maputo : Cidade capital - Capital City,130,144,0,109,799,30,0,1212,139,151,0,106,1786,26,0,2208
2017,Mauritania,Mauritania : Dispersed in the country / territory,0,0,0,0,0,0,0,0,0,0,0,0,0,0,0,0
2017,Mauritania,Mbera : Point,5025,6555,0,3178,11143,1124,0,27025,5071,6211,0,3056,7439,1023,0,22800
2017,Mauritania,Nouakchott and Nouadhibou : Regional grouping,128,200,0,131,535,21,0,1015,113,164,0,131,900,34,0,1342
2017,Mauritius,Mauritius,0,0,0,0,*,0,0,*,0,0,0,*,*,0,0,*
2017,Malawi,Dzaleka : Point,2595,3389,0,2336,6300,237,0,14857,2636,3493,0,2537,8263,177,0,17106
2017,Malawi,Luwani Refugee Camp,323,429,0,266,680,55,0,1753,326,438,0,281,518,51,0,1614
2017,Malaysia,Sabah,0,0,0,0,0,0,0,0,0,0,0,0,0,0,0,0
2017,Malaysia,Kuala Lumpur : Wilayah Persekutuan - Federal territory,9410,5740,0,3205,32434,763,0,51552,9969,6028,0,4482,78068,1271,0,99818
2017,Namibia,Osire : Point,286,364,0,254,800,17,0,1721,300,373,0,400,1292,19,0,2384
2017,Niger,Ayourou : Point,45,54,0,38,144,12,0,293,45,69,0,28,65,14,0,221
2017,Niger,Camp Abala : Point,1653,2119,0,1206,3284,207,0,8469,1662,2156,0,1215,1698,198,0,6929
2017,Niger,Diffa,25751,41545,0,14300,53184,4457,0,139237,22871,33554,0,12107,37700,6836,0,113068
2017,Niger,Intikane,1473,2877,0,1514,3759,243,0,9866,1444,3042,0,1440,2092,346,0,8364
2017,Niger,Mangaize : Point,757,1141,0,582,1706,126,0,4312,766,1213,0,647,1130,144,0,3900
2017,Niger,Niamey : Capital district,225,462,0,451,1235,177,0,2550,241,430,0,489,623,89,0,1872
2017,Niger,Tabareybarey : Point,1127,1463,0,956,2409,164,0,6119,1161,1454,0,854,1043,144,0,4656
2017,Nigeria,Abuja FCT,*,0,0,0,*,0,0,*,*,*,0,0,*,0,0,5
2017,Nigeria,Ijebuode : Local government area,*,*,0,*,8,0,0,17,*,7,0,*,30,0,0,41
2017,Nigeria,Lagos : State,37,93,0,56,301,*,0,488,57,81,0,69,580,13,0,800
2017,Nigeria,Nigeria : Dispersed in the country / territory,711,710,0,2254,1140,324,0,5139,711,509,0,1491,1200,169,0,4080
2017,Nicaragua,Nicaragua : Dispersed in the country / territory,15,11,0,34,301,22,0,383,18,27,0,27,262,20,0,354
2017,Netherlands,Netherlands : Dispersed in the country / territory,0,0,0,0,0,0,0,0,0,0,0,0,0,0,0,0
2017,Norway,Norway : Dispersed in the country / territory,0,0,0,0,0,0,0,0,0,0,0,0,0,0,0,0
2017,Nepal,Beldangi : Point,200,383,0,322,1980,277,0,3162,234,446,0,333,1775,393,0,3181
2017,Nepal,Kathmandu : District,39,54,0,29,178,*,0,303,42,58,0,44,237,8,0,389
2017,Nepal,Kathmandu: District,0,0,0,0,*,0,0,*,0,0,0,*,*,0,0,7
2017,Nepal,Sanischare : Point,66,114,0,93,521,68,0,862,78,101,0,82,471,78,0,810
2017,Nepal,Nepal : Dispersed in the country / territory,0,0,0,*,7008,*,0,7012,0,*,0,*,6513,6,0,6521
2017,Nauru,Nauru,0,0,0,0,0,0,0,0,0,0,0,0,0,0,0,0
2017,New Zealand,New Zealand : Dispersed in the country / territory,0,0,0,0,0,0,0,0,0,0,0,0,0,0,0,0
2017,Oman,Oman : Dispersed in the country / territory,9,51,0,58,47,194,0,359,23,52,0,32,60,182,0,349
2017,Pakistan,Quetta : District,165,248,0,201,687,38,0,1339,141,350,0,238,447,14,0,1190
2017,Pakistan,Saranan : Point,2241,1461,0,1349,2613,241,0,7905,2355,1584,0,1487,4048,602,0,10076
2017,Pakistan,Sindh : Province,3454,6513,0,4601,13779,954,0,29301,3766,6887,0,4901,16439,1855,0,33848
2017,Pakistan,Surkhab : Point,305,485,0,519,1102,96,0,2507,399,495,0,587,1438,234,0,3153
2017,Pakistan,Thall : Point,754,921,0,661,1909,238,0,4483,812,945,0,677,2305,368,0,5107
2017,Pakistan,Timer : Point,939,1120,0,884,2127,154,0,5224,1019,1217,0,907,2250,221,0,5614
2017,Pakistan,Toor : Point,256,372,0,232,613,50,0,1523,264,402,0,265,854,81,0,1866
2017,Pakistan,Turkmen,0,0,0,0,0,0,0,0,0,0,0,0,0,0,0,0
2017,Pakistan,Utmanzai : Point,240,315,0,280,672,67,0,1574,267,382,0,308,768,102,0,1827
2017,Pakistan,Zafarabad : Point,183,341,0,289,640,62,0,1515,191,347,0,290,983,132,0,1943
2017,Pakistan,Zangal Patai : Point,10,6,0,11,23,0,0,50,17,10,0,10,26,*,0,67
2017,Pakistan,Zar Karez : Point,395,431,0,420,797,92,0,2135,410,444,0,435,962,143,0,2394
2017,Pakistan,Akora Khattak,2074,3504,0,2163,6032,439,0,14212,2173,3642,0,2407,7185,795,0,16202
2017,Pakistan,Badaber : Point,1197,1909,0,1321,3572,273,0,8272,1343,1977,0,1325,4369,456,0,9470
2017,Pakistan,Baghicha : Point,111,215,0,153,383,31,0,893,133,223,0,164,437,41,0,998
2017,Pakistan,Balochistan : Province,18864,26730,0,21561,53283,4921,0,125359,19619,28629,0,23422,61918,9339,0,142927
2017,Pakistan,Barakai : Point,1826,2019,0,1565,4459,311,0,10180,1851,2201,0,1669,5017,590,0,11328
2017,Pakistan,Barari : Point,522,731,0,498,1546,142,0,3439,562,699,0,535,1794,214,0,3804
2017,Pakistan,Barawal : Point,*,22,0,30,53,*,0,110,5,26,0,21,97,9,0,158
2017,Pakistan,Basu Mera : Point,338,373,0,344,1038,77,0,2170,338,401,0,372,1124,129,0,2364
2017,Pakistan,Bizen Khel : Point,128,175,0,119,357,28,0,807,138,168,0,156,417,43,0,922
2017,Pakistan,Chagai,9,9,0,19,33,5,0,75,6,24,0,14,41,5,0,90
2017,Pakistan,Chakdara : Point,1150,1400,0,1011,2530,162,0,6253,1186,1501,0,978,2999,272,0,6936
2017,Pakistan,Chichana : Point,272,320,0,225,744,70,0,1631,320,352,0,210,999,137,0,2018
2017,Pakistan,Dabara : Point,71,126,0,61,119,13,0,390,53,179,0,63,192,28,0,515
2017,Pakistan,Darsamand : Point,269,341,0,242,719,91,0,1662,305,380,0,263,923,135,0,2006
2017,Pakistan,Gahzgai Minara : Point,150,154,0,160,304,29,0,797,138,171,0,218,393,64,0,984
2017,Pakistan,Gamkol : Point,2373,3317,0,2396,6406,496,0,14988,2590,3377,0,2398,7938,793,0,17096
2017,Pakistan,Gandaf : Point,1019,1234,0,879,2129,187,0,5448,1066,1270,0,934,2493,228,0,5991
2017,Pakistan,Gandhi Khan Khel : Point,272,445,0,399,971,97,0,2184,295,524,0,412,1085,167,0,2483
2017,Pakistan,Ghulam Banda : Point,748,919,0,638,1779,132,0,4216,715,944,0,662,2097,244,0,4662
2017,Pakistan,Ichrian : Point,192,248,0,176,490,44,0,1150,214,238,0,187,664,63,0,1366
2017,Pakistan,Jalala : Point,752,1018,0,713,2004,180,0,4667,735,1070,0,776,2419,268,0,5268
2017,Pakistan,Kababian : Point,560,885,0,547,1640,95,0,3727,608,950,0,561,2439,192,0,4750
2017,Pakistan,Kahi,331,422,0,278,834,105,0,1970,344,478,0,264,1151,159,0,2396
2017,Pakistan,Kalkatak : Point,74,195,0,139,384,23,0,815,92,215,0,150,482,47,0,986
2017,Pakistan,Karachi : District,23,57,0,58,174,7,0,319,29,64,0,54,117,5,0,269
2017,Pakistan,Kata Kanri : Point,618,750,0,456,1317,163,0,3304,602,816,0,514,1672,199,0,3803
2017,Pakistan,Khairabad : Point,817,1613,0,1268,2713,283,0,6694,962,1713,0,1255,2962,359,0,7251
2017,Pakistan,Khaki : Point,756,950,0,701,1886,192,0,4485,758,1034,0,697,2328,267,0,5084
2017,Pakistan,Khazana : Point,397,514,0,364,978,80,0,2333,402,495,0,357,1188,117,0,2559
2017,Pakistan,Khurasan : Point,193,286,0,190,689,70,0,1428,201,263,0,191,848,82,0,1585
2017,Pakistan,Khyber Pakhtunkhwa : Province,36577,45763,0,22943,96153,9143,0,210579,45689,59454,0,32065,96047,13697,0,246952
2017,Pakistan,Koga : Point,754,989,0,732,1770,144,0,4389,831,1046,0,751,1907,218,0,4753
2017,Pakistan,Kot Chandna : Point,1390,1755,0,1023,3198,183,0,7549,1395,1899,0,974,3099,365,0,7732
2017,Pakistan,Kotwai : Point,425,550,0,509,1057,118,0,2659,497,585,0,556,1003,211,0,2852
2017,Pakistan,Lakhti Banda : Point,393,459,0,232,832,117,0,2033,432,457,0,301,984,162,0,2336
2017,Pakistan,Lejay Karez : Point,19,56,0,48,119,15,0,257,24,63,0,38,184,39,0,348
2017,Pakistan,Malgagai : Point,590,579,0,444,1089,139,0,2841,591,630,0,518,1437,221,0,3397
2017,Pakistan,Mera Kachori : Point,200,295,0,230,650,56,0,1431,176,299,0,217,738,79,0,1509
2017,Pakistan,Mohammad Kheil : Point,502,605,0,551,1017,81,0,2756,563,595,0,630,1158,165,0,3111
2017,Pakistan,Munda : Point,324,535,0,426,1064,91,0,2440,373,548,0,395,1346,155,0,2817
2017,Pakistan,Naguman : Point,236,230,0,202,459,39,0,1166,233,257,0,179,576,63,0,1308
2017,Pakistan,New Hajizai,0,0,0,0,0,0,0,0,0,0,0,0,0,0,0,0
2017,Pakistan,Oblan : Point,688,999,0,686,1889,165,0,4427,754,1094,0,715,2206,257,0,5026
2017,Pakistan,Old Shamshatoo,2073,3490,0,2522,8131,501,0,16717,2234,3768,0,2852,9863,1060,0,19777
2017,Pakistan,Padhana : Point,580,653,0,674,1659,130,0,3696,568,623,0,717,1855,236,0,3999
2017,Pakistan,Panian : Point,2913,3774,0,4248,9100,927,0,20962,3024,3946,0,4620,9978,1295,0,22863
2017,Pakistan,Peshawar : District,25614,43331,0,29639,92995,7206,0,198785,26630,47028,0,32309,114558,11916,0,232441
2017,Pakistan,Punjab : Province,9961,14286,0,10883,28793,2565,0,66488,10646,15116,0,11796,37501,4007,0,79066
2017,Pakistan,Posti : Point,*,21,0,14,34,*,0,76,10,28,0,18,34,9,0,99
2017,Pakistan,Azad Kashmir : Pakistan administered area,273,331,0,236,767,63,0,1670,305,382,0,293,1096,134,0,2210
2017,Pakistan,Islamabad : Federal capital territory,2258,3280,0,2577,7127,591,0,15833,2541,3473,0,2831,8577,971,0,18393
2017,Panama,Panama : Dispersed in the country / territory,398,360,0,348,3071,107,0,4284,412,410,0,567,3938,120,0,5447
2017,Peru,Peru : Dispersed in the country / territory,602,701,0,374,11356,134,0,13167,644,703,0,371,19146,99,0,20963
2017,Philippines,Agusan del Norte,0,0,0,0,0,0,0,0,0,0,0,0,0,0,0,0
2017,Philippines,Agusan del Sur,0,0,0,0,0,0,0,0,0,0,0,0,0,0,0,0
2017,Philippines,BASILAN,0,0,0,0,0,0,0,0,0,0,0,0,0,0,0,0
2017,Philippines,Bicol (Region 5),0,0,0,0,0,0,0,0,0,0,0,0,*,*,0,*
2017,Philippines,BUKIDNON,0,0,0,0,0,0,0,0,0,0,0,0,0,0,0,0
2017,Philippines,Central Luzon (Region III) : Region,0,*,0,*,9,0,0,12,0,0,0,0,37,*,0,40
2017,Philippines,Central Visayas (Region 7),0,0,0,0,*,0,0,*,0,0,0,0,18,*,0,19
2017,Philippines,Compostela Valley,0,0,0,0,0,0,0,0,0,0,0,0,0,0,0,0
2017,Philippines,Cordillera Administrative Region,0,0,0,0,0,0,0,0,0,0,0,0,6,*,0,7
2017,Philippines,Davao (Region XI) : Region,0,*,0,0,*,0,0,*,0,*,0,0,6,0,0,7
2017,Philippines,Davao del Norte,0,0,0,0,0,0,0,0,0,0,0,0,0,0,0,0
2017,Philippines,Davao del Sur,0,0,0,0,0,0,0,0,0,0,0,0,0,0,0,0
2017,Philippines,DAVAO ORIENTAL,0,0,0,0,0,0,0,0,0,0,0,0,0,0,0,0
2017,Philippines,Eastern Visayas (Region 8),0,0,0,0,0,0,0,0,0,0,0,0,*,0,0,*
2017,Philippines,Ilocos Region,0,0,0,*,*,0,0,5,0,0,0,0,17,0,0,17
2017,Philippines,LANAO DEL NORTE,0,0,0,0,0,0,0,0,0,0,0,0,0,0,0,0
2017,Philippines,LANAO DEL SUR,0,0,0,0,0,0,0,0,0,0,0,0,0,0,0,0
2017,Philippines,MAGUINDANAO,0,0,0,0,0,0,0,0,0,0,0,0,0,0,0,0
2017,Philippines,MIMAROPA (Region IV-B) : Region,0,0,0,0,0,0,0,0,0,0,0,0,0,*,0,*
2017,Philippines,Misamis Oriental,0,0,0,0,0,0,0,0,0,0,0,0,0,0,0,0
2017,Philippines,National Capital Region,*,14,0,14,87,9,0,128,11,19,0,7,257,21,0,315
2017,Philippines,NORTH COTABATO,0,0,0,0,0,0,0,0,0,0,0,0,0,0,0,0
2017,Philippines,Northern Mindanao,0,0,0,0,*,0,0,*,0,0,0,0,*,*,0,*
2017,Philippines,Philippines : Dispersed in the country / territory,0,0,0,0,5,*,0,6,0,*,0,*,20,0,0,22
2017,Philippines,SARANGANI PROVINCE,0,0,0,0,0,0,0,0,0,0,0,0,0,0,0,0
2017,Philippines,SOCCSKSARGEN,0,0,0,0,0,0,0,0,0,0,0,0,*,0,0,*
2017,Philippines,South Cotabato,0,0,0,0,0,0,0,0,0,0,0,0,0,0,0,0
2017,Philippines,SULTAN KUDARAT,0,0,0,0,0,0,0,0,0,0,0,0,0,0,0,0
2017,Philippines,SULU,0,0,0,0,0,0,0,0,0,0,0,0,0,0,0,0
2017,Philippines,Western Visayas (Region VI) : Region,0,0,0,0,*,0,0,*,0,0,0,0,*,0,0,*
2017,Philippines,Zamboanga del Norte,0,0,0,0,0,0,0,0,0,0,0,0,0,0,0,0
2017,Philippines,Zamboanga del Sur,0,0,0,0,0,0,0,0,0,0,0,0,0,0,0,0
2017,Philippines,Zamboanga Peninsula (Region IX) : Region,0,0,0,0,0,0,0,0,0,0,0,0,0,*,0,*
2017,Philippines,CALABARZON (Region IV-A ) : Region,*,*,0,*,20,*,0,31,*,8,0,6,77,7,0,100
2017,Papua New Guinea,Papua New Guinea : Dispersed in the country / territory,0,0,0,0,0,0,0,0,0,0,0,0,0,0,0,0
2017,Poland,Bezwola,13,30,0,11,36,*,0,91,12,33,0,22,32,*,0,100
2017,Poland,Biala Podlaska : Powiat - County,5,8,0,*,21,*,0,38,9,11,0,6,15,*,0,42
2017,Poland,Bialystok : Powiat - County,19,32,0,15,34,0,0,100,22,17,0,10,32,*,0,82
2017,Poland,Czerwony Bor : Point,17,19,0,6,27,*,0,70,17,18,0,*,27,0,0,63
2017,Poland,Debak : Point,13,15,0,7,33,0,0,68,14,11,0,8,52,*,0,87
2017,Poland,Grotniki : Point,7,15,0,*,18,0,0,44,10,15,0,6,17,0,0,48
2017,Poland,Grupa : Point,10,14,0,5,21,0,0,50,9,12,0,11,29,*,0,62
2017,Poland,Horbow : Point,12,14,0,5,15,0,0,46,14,12,0,*,17,*,0,48
2017,Poland,Linin : Point,6,9,0,*,17,0,0,36,17,19,0,10,20,0,0,66
2017,Poland,Lukow : Powiat - County,11,23,0,14,27,0,0,75,14,21,0,15,22,0,0,72
2017,Poland,Poland,0,0,0,0,0,0,0,0,0,0,0,0,0,0,0,0
2017,Poland,Warsaw : Powiat - County,15,20,0,12,37,*,0,86,*,14,0,10,0,0,0,25
2017,Portugal,Portugal : Dispersed in the country / territory,0,0,0,0,0,0,0,0,0,0,0,0,0,0,0,0
2017,Paraguay,Paraguay : Dispersed in the country / territory,*,13,0,10,75,5,0,107,*,14,0,11,140,*,0,170
2017,Qatar,Qatar : Dispersed in the country / territory,7,23,0,14,22,92,0,158,6,25,0,6,24,95,0,156
2017,Romania,Romania : Dispersed in the country / territory,158,218,0,133,786,50,0,1345,176,256,0,161,1906,80,0,2579
2017,Russian Federation,Russian Federation : Dispersed in the country / territory,0,0,0,0,0,0,0,0,0,0,0,0,0,0,0,0
2017,Rwanda,Bugesera,52,49,0,30,107,8,0,246,44,48,0,49,317,7,0,465
2017,Rwanda,Gatore,12,9,0,6,50,0,0,77,10,8,0,14,71,*,0,105
2017,Rwanda,Gatsibo : Akarere - District,1024,1733,0,1638,3867,309,0,8571,1085,1693,0,1579,2777,221,0,7355
2017,Rwanda,Gihembe,1016,1161,0,1173,3902,468,0,7720,1044,1295,0,1194,3310,239,0,7082
2017,Rwanda,Gisagara : Akarere - District,755,1280,0,1024,2832,248,0,6139,799,1258,0,931,1628,165,0,4781
2017,Rwanda,Huye : Akarere - District,127,352,0,243,1051,27,0,1800,142,353,0,289,802,13,0,1599
2017,Rwanda,Kigali : Point,1167,2517,0,1787,9731,234,0,15436,1195,2536,0,1778,9215,379,0,15103
2017,Rwanda,Kijote,1219,1191,0,390,2244,78,0,5122,1222,1104,0,361,834,64,0,3585
2017,Rwanda,Kirehe,5023,5358,0,3541,12845,864,0,27631,5292,5491,0,3822,13415,555,0,28575
2017,Rwanda,Kiziba : Point,1216,1768,0,1528,4967,533,0,10012,1200,1620,0,1528,4034,414,0,8796
2017,Rwanda,Nyamagabe : Akarere - District,1512,2440,0,1847,5564,437,0,11800,1499,2446,0,1835,3865,352,0,9997
2017,Rwanda,Nyanza,388,323,0,104,630,33,0,1478,350,350,0,123,283,19,0,1125
2017,Rwanda,Nyarushishi,756,779,0,270,1496,53,0,3354,766,717,0,238,670,34,0,2425
2017,Saudi Arabia,KSA various,*,7,0,9,15,67,0,101,0,7,0,12,16,100,0,135
2017,Sudan,Abu Gabra,440,739,0,338,1196,60,0,2773,488,717,0,318,1130,79,0,2732
2017,Sudan,Abu Karaynka,81,116,0,48,171,19,0,435,67,97,0,41,362,52,0,619
2017,Sudan,Abu Rakham,*,16,0,15,7,0,0,42,*,13,0,8,7,*,0,34
2017,Sudan,Abu Rakham area : Point,*,33,0,93,21,19,0,167,*,45,0,95,22,25,0,188
2017,Sudan,Abuda : Point,136,307,0,253,904,99,0,1699,125,309,0,256,755,130,0,1575
2017,Sudan,Adila,199,312,0,186,545,55,0,1297,239,334,0,153,683,120,0,1529
2017,Sudan,Adingrar,0,0,0,0,0,*,0,*,0,0,0,*,0,0,0,*
2017,Sudan,Al Nimir Camp,430,865,0,486,1459,93,0,3333,466,837,0,459,892,68,0,2722
2017,Sudan,Aroma : Point,0,*,0,*,*,0,0,6,0,*,0,*,0,0,0,*
2017,Sudan,Asotriba,*,0,0,*,*,0,0,5,*,0,0,5,*,*,0,9
2017,Sudan,Awad El Seid : Point,0,39,0,170,25,30,0,264,0,48,0,132,33,44,0,257
2017,Sudan,Basonda,0,*,0,*,0,0,0,*,0,*,0,*,*,0,0,*
2017,Sudan,Blue Nile : Wilayat - State,0,0,0,0,0,0,0,0,0,0,0,0,0,0,0,0
2017,Sudan,Central Darfur : Wilayat - State,0,0,0,0,0,0,0,0,0,0,0,0,0,0,0,0
2017,Sudan,Daim : Point,20,75,0,84,539,25,0,743,20,96,0,78,428,44,0,666
2017,Sudan,Dehama,0,0,0,0,0,0,0,0,0,0,0,*,0,*,0,*
2017,Sudan,Diam El-Nour : Point,*,26,0,40,166,14,0,249,8,29,0,70,254,32,0,393
2017,Sudan,Doka : Point,*,*,0,*,*,*,0,11,*,10,0,*,*,*,0,16
2017,Sudan,Dordeab,0,*,0,*,0,*,0,8,0,0,0,*,*,0,0,*
2017,Sudan,Eastern Darfur : Wilayat - State,0,0,0,0,0,0,0,0,0,0,0,0,0,0,0,0
2017,Sudan,El Geneina : Point,0,*,0,*,11,0,0,13,0,*,0,*,53,0,0,56
2017,Sudan,Fath El Rahman,0,18,0,97,11,19,0,145,0,23,0,69,14,28,0,134
2017,Sudan,Fau 5 : Point,7,70,0,64,242,35,0,418,5,80,0,72,231,57,0,445
2017,Sudan,Fau Town : Point,0,*,0,*,0,0,0,*,0,*,0,0,*,0,0,*
2017,Sudan,Ferdus,466,813,0,442,1580,176,0,3477,455,735,0,445,861,92,0,2588
2017,Sudan,Gedaref,135,325,0,206,705,43,0,1414,133,448,0,230,793,86,0,1690
2017,Sudan,Geref : Point,11,73,0,80,519,36,0,719,13,68,0,76,636,74,0,867
2017,Sudan,Girba,149,444,0,1868,597,245,0,3303,151,433,0,1385,652,326,0,2947
2017,Sudan,GIRBA TOWN,0,*,0,8,*,*,0,17,*,*,0,14,5,*,0,25
2017,Sudan,Gulsa : Point,0,5,0,26,*,*,0,34,0,*,0,12,*,*,0,19
2017,Sudan,Hasahisa : Point,9,31,0,*,15,0,0,59,*,24,0,*,9,0,0,38
2017,Sudan,Hawata : Point,0,0,0,*,*,0,0,6,0,*,0,0,*,0,0,*
2017,Sudan,Kalakla,*,8,0,15,92,14,0,131,*,5,0,11,109,17,0,143
2017,Sudan,Kario,1274,2290,0,1057,3920,362,0,8903,1437,2436,0,1307,4375,624,0,10179
2017,Sudan,Karkora,0,*,0,11,*,*,0,20,0,*,0,11,*,*,0,18
2017,Sudan,Kassala : Wilayat - State,61,304,0,288,1282,127,0,2062,39,316,0,319,1506,170,0,2350
2017,Sudan,Khartoum : Wilayat - State,1022,2306,0,1751,9298,491,0,14868,1166,2433,0,2122,11752,716,0,18189
2017,Sudan,Khartoum North : Point,15,54,0,35,197,6,0,307,18,72,0,42,249,22,0,403
2017,Sudan,Kilo 26 : Point,689,854,0,630,2584,347,0,5104,694,955,0,625,2023,438,0,4735
2017,Sudan,KILO 7,0,21,0,84,10,19,0,134,0,24,0,76,22,18,0,140
2017,Sudan,Koneina,0,0,0,0,0,0,0,0,0,*,0,0,0,0,0,*
2017,Sudan,Laffa : Point,0,0,0,5,*,*,0,8,0,*,0,0,0,0,0,*
2017,Sudan,Mafaza,0,*,0,*,*,0,0,5,*,7,0,0,*,0,0,11
2017,Sudan,Marghania : Point,0,14,0,81,12,6,0,113,*,9,0,119,10,10,0,149
2017,Sudan,Mukjar : Point,48,58,0,37,81,10,0,234,53,64,0,31,60,11,0,219
2017,Sudan,New Halfa : Point,8,6,0,83,10,0,0,107,5,10,0,817,17,11,0,860
2017,Sudan,North Kordofan : Wilayat - State,0,0,0,0,0,0,0,0,0,0,0,0,0,0,0,0
2017,Sudan,Northern Darfur : Wilayat - State,628,725,0,385,1186,135,0,3059,694,684,0,490,2406,493,0,4767
2017,Sudan,Nyala : Region,441,812,0,486,1372,128,0,3239,476,794,0,534,1689,131,0,3624
2017,Sudan,Port Sudan : District,45,119,0,501,115,50,0,830,33,111,0,811,155,105,0,1215
2017,Sudan,Safawa,0,0,0,*,0,*,0,*,0,0,0,0,0,0,0,0
2017,Sudan,Salalab : Point,9,31,0,134,38,*,0,215,13,29,0,178,38,23,0,281
2017,Sudan,Salmin,0,0,0,*,*,0,0,*,0,*,0,*,0,0,0,*
2017,Sudan,Shagarab 1 : Point,1235,2386,0,1605,6431,390,0,12047,1285,2760,0,1888,7390,546,0,13869
2017,Sudan,Shagarab 2 : Point,594,1114,0,2702,1255,251,0,5916,369,960,0,1913,1246,417,0,4905
2017,Sudan,Shagarab 3 : Point,192,526,0,1737,617,203,0,3275,167,465,0,1175,602,296,0,2705
2017,Sudan,Showak,*,12,0,9,5,*,0,32,5,13,0,21,9,*,0,51
2017,Sudan,Sinkat : District,0,0,0,0,0,0,0,0,0,0,0,*,0,0,0,*
2017,Sudan,South Kordofan - Abu Jubaiyha,1074,1394,0,899,1924,339,0,5630,1176,1400,0,785,1255,171,0,4787
2017,Sudan,South Kordofan - El Leri,1225,1620,0,1105,2588,466,0,7004,1284,1779,0,1217,1772,282,0,6334
2017,Sudan,South Kordofan - Rashad,22,33,0,19,39,*,0,115,28,33,0,13,23,*,0,100
2017,Sudan,South Kordofan : Wilayat - State,0,0,0,0,0,0,0,0,0,0,0,0,0,0,0,0
2017,Sudan,Southern Darfur : Wilayat - State,133,191,0,144,296,32,0,796,173,223,0,146,136,19,0,697
2017,Sudan,Suwakin : Point,0,*,0,16,9,*,0,30,0,5,0,46,5,6,0,62
2017,Sudan,Tawawa,0,*,0,0,0,0,0,*,0,0,0,*,0,0,0,*
2017,Sudan,Tenedba,*,25,0,*,11,0,0,41,10,42,0,*,9,0,0,65
2017,Sudan,Tokar : District,*,0,0,*,0,0,0,*,0,0,0,*,0,0,0,*
2017,Sudan,Um Ali,0,12,0,16,7,*,0,37,*,6,0,12,6,*,0,27
2017,Sudan,Um Bada,*,*,0,*,*,0,0,12,*,*,0,0,*,0,0,8
2017,Sudan,Um Brosh,0,0,0,0,0,0,0,0,0,*,0,0,0,0,0,*
2017,Sudan,Um Gargur : Point,288,867,0,646,2690,346,0,4837,308,908,0,714,2533,483,0,4946
2017,Sudan,Um Gulja,109,217,0,137,590,129,0,1182,128,245,0,137,682,271,0,1463
2017,Sudan,Um Rakuba,42,71,0,35,166,24,0,338,38,77,0,56,204,39,0,414
2017,Sudan,Um Sagata,0,*,0,*,0,0,0,*,0,*,0,*,0,*,0,*
2017,Sudan,Um Shalaya,665,984,0,621,1421,190,0,3881,669,891,0,560,891,132,0,3143
2017,Sudan,Wad El Hileau,16,78,0,82,52,10,0,238,14,69,0,70,42,9,0,204
2017,Sudan,Wad Medani : Point,18,155,0,23,34,0,0,230,28,137,0,18,43,*,0,227
2017,Sudan,Wad Sherife : Point,456,1315,0,5871,1452,1009,0,10103,499,1351,0,3797,1578,835,0,8060
2017,Sudan,West Kordofan - El Meram,1073,1262,0,605,2418,280,0,5638,1182,1237,0,526,1356,296,0,4597
2017,Sudan,West Kordofan - Keilak,516,631,0,284,993,48,0,2472,563,667,0,343,982,71,0,2626
2017,Sudan,West Kordofan - Muglad,434,552,0,273,983,114,0,2356,433,508,0,276,731,151,0,2099
2017,Sudan,West Kordofan : Wilayat - State,0,0,0,0,0,0,0,0,0,0,0,0,0,0,0,0
2017,Sudan,West Kordofan: Babanusa,86,114,0,73,208,47,0,528,87,109,0,48,165,41,0,450
2017,Sudan,West Kordofan: El Tibbun,216,293,0,168,502,63,0,1242,287,297,0,176,891,140,0,1791
2017,Sudan,Western Darfur : Wilayat - State,0,0,0,0,0,0,0,0,0,0,0,0,0,0,0,0
2017,Sudan,White Nile - Al kashafa,1126,1883,0,1315,2785,275,0,7384,1128,1893,0,1228,1293,90,0,5632
2017,Sudan,White Nile - Alagaya,1737,2020,0,1006,3000,285,0,8048,1834,2085,0,1062,2022,122,0,7125
2017,Sudan,White Nile - Alredais1,1127,1724,0,1029,2324,266,0,6470,1074,1701,0,993,1081,82,0,4931
2017,Sudan,White Nile - Alredais2,1927,3104,0,2138,4844,579,0,12592,1993,3163,0,2007,2397,195,0,9755
2017,Sudan,White Nile - Dabat Bosin,369,386,0,184,588,41,0,1568,322,384,0,204,535,36,0,1481
2017,Sudan,White Nile - Jouri,850,1405,0,871,1951,245,0,5322,867,1277,0,861,1170,117,0,4292
2017,Sudan,White Nile - Khor Al waral,5160,6388,0,4241,11023,1691,0,28503,5186,6352,0,4046,4211,598,0,20393
2017,Sudan,White Nile - State,0,0,0,0,0,0,0,0,0,0,0,0,0,0,0,0
2017,Sudan,White Nile - Um Sangour,2073,1869,0,840,3036,185,0,8003,2029,1889,0,986,3053,176,0,8133
2017,Sudan,Zallingei Rural,0,*,0,0,*,0,0,*,*,0,0,0,0,0,0,*
2017,Senegal,Dakar : Point,130,238,0,216,1317,28,0,1929,124,270,0,242,2463,45,0,3144
2017,Senegal,Dakar/Thies : Point,6,17,0,16,29,*,0,69,10,25,0,20,57,*,0,115
2017,Senegal,Richard Toll : Point,959,1662,0,955,2780,367,0,6723,1003,1604,0,878,2189,331,0,6005
2017,Senegal,Saint Louis,*,*,0,5,14,*,0,24,*,5,0,*,12,0,0,22
2017,Singapore,Singapore : Dispersed in the country / territory,0,0,0,0,*,0,0,*,0,0,0,0,0,0,0,0
2017,Sierra Leone,Bandajuma,*,0,0,*,7,0,0,10,*,0,0,*,*,*,0,9
2017,Sierra Leone,Bo : District,*,0,0,*,9,*,0,14,0,0,0,*,*,0,0,6
2017,Sierra Leone,Freetown,11,5,0,8,53,*,0,81,12,12,0,11,44,*,0,81
2017,Sierra Leone,Freetown : Point,0,0,0,0,0,0,0,0,0,0,0,0,*,0,0,*
2017,Sierra Leone,Gerihun : Point,*,6,0,*,11,*,0,22,*,*,0,*,11,0,0,17
2017,Sierra Leone,Gondama : Point,6,7,0,17,48,0,0,78,8,8,0,16,29,*,0,63
2017,Sierra Leone,Jembe : Point,0,*,0,*,11,0,0,15,*,5,0,8,9,0,0,23
2017,Sierra Leone,Jimmi Bago,7,11,0,7,25,*,0,51,12,8,0,10,29,0,0,59
2017,Sierra Leone,Kenema : District,*,*,0,*,19,*,0,29,*,5,0,*,21,*,0,32
2017,Sierra Leone,Largo : Point,*,*,0,*,7,*,0,17,*,*,0,*,*,0,0,9
2017,Sierra Leone,Taiama : Point,*,0,0,6,15,*,0,26,*,5,0,7,14,*,0,30
2017,Sierra Leone,Tobanda : Point,*,0,0,*,*,0,0,5,0,0,0,0,*,*,0,*
2017,El Salvador,El Salvador : Dispersed in the country / territory,*,*,0,*,9,*,0,18,*,0,0,*,24,*,0,30
2017,Somalia,Awdal : Gobolka - Region,633,1020,0,440,1299,273,0,3665,643,1069,0,502,1151,317,0,3682
2017,Somalia,Bakool : Gobolka - Region,5418,8624,0,3633,10779,2341,0,30795,5480,9052,0,4125,9486,2709,0,30852
2017,Somalia,Banaadir : Gobolka - Region,47838,75983,0,32282,95780,20449,0,272332,48413,79778,0,36606,84767,23703,0,273267
2017,Somalia,Bari : Gobolka - Region,13670,21910,0,9368,27901,5787,0,78636,13797,23002,0,10577,24986,6739,0,79101
2017,Somalia,Bay : Gobolka - Region,20174,31999,0,13548,40018,8638,0,114377,20398,33628,0,15400,35210,10008,0,114644
2017,Somalia,Galgaduud : Gobolka - Region,4867,7736,0,3262,9677,2100,0,27642,4917,8122,0,3700,8513,2433,0,27685
2017,Somalia,Gedo : Gobolka - Region,14219,22615,0,9542,28261,6121,0,80758,14379,23725,0,10875,24876,7081,0,80936
2017,Somalia,Hiraan : Gobolka - Region,5265,8394,0,3531,10500,2272,0,29962,5327,8818,0,4012,9234,2634,0,30025
2017,Somalia,Juba Dhexe : Gobolka - Region,1491,2342,0,1034,2962,615,0,8444,1511,2482,0,1157,2580,718,0,8448
2017,Somalia,Juba Hoose : Gobolka - Region,11383,17375,0,8082,21966,4083,0,62889,11669,18268,0,9364,18735,4758,0,62794
2017,Somalia,Mudug : Gobolka - Region,12992,20658,0,8713,25866,5592,0,73821,13150,21698,0,9882,22759,6478,0,73967
2017,Somalia,Nugaal : Gobolka - Region,3917,6225,0,2616,7915,1662,0,22335,3966,6536,0,2967,7024,1934,0,22427
2017,Somalia,Sanaag : Gobolka - Region,4335,6900,0,2904,8639,1873,0,24651,4382,7240,0,3307,7608,2168,0,24705
2017,Somalia,Shabelle Dhexe : Gobolka - Region,3042,4822,0,2071,6029,1286,0,17250,3071,5067,0,2352,5297,1489,0,17276
2017,Somalia,Shabelle Hoose : Gobolka - Region,8765,13978,0,5893,17473,3780,0,49889,8867,14680,0,6683,15377,4376,0,49983
2017,Somalia,Sool : Gobolka - Region,13146,20916,0,8814,26147,5679,0,74702,13296,21962,0,10009,23017,6574,0,74858
2017,Somalia,Togdheer : Gobolka - Region,7503,11970,0,5049,14979,3235,0,42736,7593,12553,0,5735,13215,3746,0,42842
2017,Somalia,Woqooyi Galbeed : Gobolka - Region,13184,20986,0,9073,28201,5411,0,76855,13335,22018,0,10260,26402,6308,0,78323
2017,Serbia and Kosovo (S/RES/1244 (1999)),Belgrade area,10,2253,0,3406,19678,7798,0,33145,7,2407,0,3621,20180,5852,0,32067
2017,Serbia and Kosovo (S/RES/1244 (1999)),Governmental facilities,123,232,0,293,2126,25,0,2799,102,205,0,135,557,9,0,1008
2017,Serbia and Kosovo (S/RES/1244 (1999)),Kosovo (S/RES/1244 (1999)) : Dispersed in the country / territory,1010,1115,0,1151,3327,1243,0,7846,1072,1098,0,1184,4491,1238,0,9083
2017,Serbia and Kosovo (S/RES/1244 (1999)),Serbia : Dispersed in the country / territory,220,5204,0,7604,42110,15467,0,70605,211,5541,0,8062,42785,12075,0,68674
2017,Serbia and Kosovo (S/RES/1244 (1999)),Vojvodina : Autonomous province,*,589,0,1083,7904,4557,0,14135,*,629,0,1139,8389,2815,0,12973
2017,South Sudan,Tambura : County,55,138,0,57,193,7,0,450,64,121,0,62,110,*,0,361
2017,South Sudan,Unity : Wilayat - State,0,0,0,0,0,0,0,0,0,0,0,0,0,0,0,0
2017,South Sudan,Upper Nile : Wilayat - State,0,0,0,0,0,0,0,0,0,0,0,0,0,0,0,0
2017,South Sudan,Warab : Wilayat - State,0,0,0,0,0,0,0,0,0,0,0,0,0,0,0,0
2017,South Sudan,Western Bahr El Ghazal : Wilayat - State,0,0,0,0,0,0,0,0,0,0,0,0,0,0,0,0
2017,South Sudan,Western Equatoria : Wilayat - State,0,0,0,0,0,0,0,0,0,0,0,0,0,0,0,0
2017,South Sudan,Yei : County,27,33,0,20,84,*,0,167,37,30,0,24,80,*,0,172
2017,South Sudan,Yida : Point,5186,8922,0,4978,11575,563,0,31224,5337,9026,0,4171,4789,349,0,23672
2017,South Sudan,Yusuf Batil,4099,5139,0,3308,9021,853,0,22420,4392,5314,0,3190,6391,1056,0,20343
2017,South Sudan,Abyei Region,0,0,0,0,0,0,0,0,0,0,0,0,0,0,0,0
2017,South Sudan,Ajuong Thok,4113,4837,0,2989,7609,308,0,19856,4064,4769,0,3448,7216,233,0,19730
2017,South Sudan,Andari : Point,23,32,0,19,80,8,0,162,21,39,0,14,53,11,0,138
2017,South Sudan,Central Equatoria : Wilayat - State,0,0,0,0,0,0,0,0,0,0,0,0,*,0,0,*
2017,South Sudan,Doro : Point,5607,7291,0,4567,11675,725,0,29865,5982,7561,0,4801,9150,611,0,28105
2017,South Sudan,Eastern Equatoria,0,0,0,0,0,0,0,0,0,0,0,0,0,0,0,0
2017,South Sudan,Ezo : County,91,210,0,178,789,73,0,1341,97,244,0,153,486,71,0,1051
2017,South Sudan,Gendrassa,1642,2080,0,1343,3728,299,0,9092,1724,2117,0,1299,3093,381,0,8614
2017,South Sudan,Gorom : Point,175,226,0,135,434,30,0,1000,158,240,0,161,470,10,0,1039
2017,South Sudan,Jonglei : Wilayat - State,0,0,0,0,0,0,0,0,0,0,0,0,0,0,0,0
2017,South Sudan,Juba : County,167,151,0,81,661,*,0,1062,172,149,0,90,2539,77,0,3027
2017,South Sudan,Kaya,2095,2669,0,1744,5138,456,0,12102,2347,2757,0,1757,4085,635,0,11581
2017,South Sudan,Kodok,66,358,0,144,413,31,0,1012,57,342,0,140,337,29,0,905
2017,South Sudan,Lakes,0,0,0,0,0,0,0,0,0,0,0,0,0,0,0,0
2017,South Sudan,Lasu : Point,710,1284,0,785,1977,203,0,4959,734,1288,0,762,1739,111,0,4634
2017,South Sudan,Makpandu : Point,300,500,0,253,860,57,0,1970,295,435,0,260,830,68,0,1888
2017,South Sudan,Maridi : County,*,37,0,22,51,0,0,113,*,35,0,20,65,*,0,125
2017,South Sudan,Morobo : County,25,46,0,24,62,*,0,160,22,59,0,30,42,5,0,158
2017,South Sudan,Naandi : Point,21,29,0,21,49,7,0,127,17,30,0,24,50,6,0,127
2017,South Sudan,Northern Bahr El Ghazal : Wilayat - State,0,0,0,0,0,0,0,0,0,0,0,0,0,0,0,0
2017,South Sudan,Pamir,2230,2576,0,1585,3656,161,0,10208,2320,2552,0,1582,2313,113,0,8880
2017,South Sudan,Pochalla : County,132,279,0,332,654,36,0,1433,160,274,0,364,248,12,0,1058
2017,South Sudan,Source Yubu : Point,47,133,0,67,274,14,0,535,67,141,0,66,153,14,0,441
2017,South Sudan,South Sudan,0,0,0,0,0,0,0,0,0,0,0,0,0,0,0,0
2017,Suriname,Suriname,*,*,0,*,31,*,0,39,*,*,0,*,63,*,0,71
2017,Slovakia,Slovakia : Dispersed in country / territory,6,29,0,32,746,0,0,813,*,58,0,68,1539,*,0,1667
2017,Slovenia,Ljubljana : Obcine - Municipality,*,0,0,6,41,0,0,48,0,0,0,35,191,0,0,226
2017,Slovenia,Slovenia : Dispersed in the country / territory,11,46,0,21,120,*,0,201,10,50,0,55,295,7,0,417
2017,Sweden,Sweden : Dispersed in the country / territory,0,0,0,0,0,0,0,0,0,0,0,0,0,0,0,0
2017,Swaziland,Swaziland : Dispersed in the country / territory,58,96,0,50,296,6,0,506,38,96,0,73,622,14,0,843
2017,Sint Maarten (Dutch part),Sint Maarten (Dutch part) : Dispersed in the country / territory,0,0,0,0,*,0,0,*,0,0,0,0,*,0,0,*
2017,Seychelles,Seychelles,0,0,0,0,0,0,0,0,0,0,0,0,0,0,0,0
2017,Syrian Arab Rep.,Al Qunaytirah : Mohafazah - Governorate,0,0,0,0,*,0,0,*,0,0,0,0,0,0,0,0
2017,Syrian Arab Rep.,As-Suweida : Mohafazah - Governorate,0,*,0,*,*,0,0,7,*,*,0,*,*,0,0,5
2017,Syrian Arab Rep.,Idleb : Mohafazah - Governorate,0,*,0,*,8,0,0,12,0,*,0,*,5,*,0,10
2017,Syrian Arab Rep.,Raqqa : Mohafazah - Governorate,0,5,0,*,*,*,0,11,0,*,0,0,0,0,0,*
2017,Syrian Arab Rep.,Syrian Arab Republic : Dispersed in the country / territory,0,0,0,0,0,0,0,0,0,0,0,0,0,0,0,0
2017,Syrian Arab Rep.,Aleppo : Mohafazah - Governorate,18,36,0,29,131,10,0,224,26,46,0,33,141,23,0,269
2017,Syrian Arab Rep.,Damascus : Mohafazah - Governorate,249,500,0,518,2007,264,0,3538,260,509,0,475,1838,478,0,3560
2017,Syrian Arab Rep.,Dara : Mohafazah - Governorate,*,16,0,11,22,*,0,53,*,17,0,19,18,6,0,62
2017,Syrian Arab Rep.,Dayr Az-Zor : Mohafazah - Governorate,6,14,0,10,27,*,0,58,6,16,0,8,17,*,0,48
2017,Syrian Arab Rep.,Hama : Mohafazah - Governorate,*,6,0,10,26,*,0,48,*,9,0,*,23,*,0,44
2017,Syrian Arab Rep.,Hassakeh : Mohafazah - Governorate,2285,2765,0,1537,4850,455,0,11892,2304,2735,0,1525,3596,292,0,10452
2017,Syrian Arab Rep.,Homs : Mohafazah - Governorate,20,38,0,26,103,9,0,196,16,33,0,18,96,31,0,194
2017,Syrian Arab Rep.,Lattakia : Mohafazah - Governorate,6,19,0,32,98,13,0,168,18,32,0,40,152,21,0,263
2017,Syrian Arab Rep.,Rural Damascus : Mohafazah - Governorate,265,464,0,427,1560,215,0,2931,312,498,0,420,1505,329,0,3064
2017,Syrian Arab Rep.,Tartous : Mohafazah - Governorate,15,37,0,18,132,14,0,216,16,27,0,34,111,21,0,209
2017,Turks and Caicos Islands,Turks and Caicos Islands : Dispersed in the country / territory,0,0,0,0,*,0,0,*,0,0,0,0,*,0,0,*
2017,Chad,Abgadam : Point,226,509,0,235,658,58,0,1686,220,479,0,177,242,32,0,1150
2017,Chad,Am Nabak : Point,1540,2386,0,6389,2608,583,0,13506,1493,2051,0,2260,2584,367,0,8755
2017,Chad,Amboko : Point,408,790,0,2196,1039,167,0,4600,415,861,0,1824,933,137,0,4170
2017,Chad,Bekourou : Point,241,137,0,445,309,17,0,1149,204,145,0,305,342,16,0,1012
2017,Chad,Belome : Point,1467,1679,0,4627,2524,483,0,10780,1468,1770,0,3358,2513,286,0,9395
2017,Chad,Bohoma,10,14,0,7,20,*,0,52,10,14,0,6,18,*,0,50
2017,Chad,Bongor,29,22,0,66,29,*,0,150,21,40,0,75,37,7,0,180
2017,Chad,Bongor : Point,98,41,0,185,101,6,0,431,85,51,0,252,162,14,0,564
2017,Chad,Bredjing : Point,3614,5306,0,3321,10668,1234,0,24143,3512,5380,0,3328,7589,894,0,20703
2017,Chad,Daha 1,24,42,0,113,55,7,0,241,29,19,0,52,50,9,0,159
2017,Chad,Daha 2,44,37,0,114,91,*,0,290,45,44,0,52,64,5,0,210
2017,Chad,Dar Es Salam : Point,638,842,0,457,1200,68,0,3205,641,810,0,426,1209,122,0,3208
2017,Chad,Dembo : Point,270,145,0,602,431,49,0,1497,285,175,0,383,431,26,0,1300
2017,Chad,Diba,352,185,0,754,453,49,0,1793,373,176,0,713,420,37,0,1719
2017,Chad,Djabal : Point,1890,1687,0,5051,2643,485,0,11756,2046,1697,0,3308,2670,398,0,10119
2017,Chad,Doholo : Point,225,191,0,602,362,45,0,1425,239,200,0,545,425,43,0,1452
2017,Chad,Dosseye : Point,749,1169,0,2852,1838,237,0,6845,812,1225,0,2071,1803,243,0,6154
2017,Chad,Farchana : Point,1951,3391,0,2439,7017,767,0,15565,2006,3463,0,2363,4379,484,0,12695
2017,Chad,Gaga : Point,2006,3182,0,2192,5658,415,0,13453,2030,3131,0,2111,3730,326,0,11328
2017,Chad,Gondje : Point,248,1001,0,2040,840,140,0,4269,298,944,0,1479,880,75,0,3676
2017,Chad,Gore : Region,3254,4585,0,2956,8328,875,0,19998,3425,4432,0,2850,5474,539,0,16720
2017,Chad,Goz Amer : Point,2995,2624,0,7428,4169,965,0,18181,3232,2641,0,4724,4245,752,0,15594
2017,Chad,Goz-Beida: Region R,95,108,0,95,202,39,0,539,103,131,0,62,82,25,0,403
2017,Chad,Iridimi : Point,1480,1828,0,5010,2461,481,0,11260,1438,1628,0,2514,2385,259,0,8224
2017,Chad,Kaiga,63,93,0,49,131,6,0,342,63,90,0,45,120,12,0,330
2017,Chad,Kerfi,140,85,0,292,234,26,0,777,179,95,0,219,226,29,0,748
2017,Chad,Kounoungou : Point,1252,2048,0,5033,2273,383,0,10989,1195,1816,0,2111,2170,264,0,7556
2017,Chad,Lac Region,10923,14764,0,5795,21433,1691,0,54606,10607,14885,0,6159,12133,1593,0,45377
2017,Chad,Mile : Point,1401,1927,0,5192,2546,468,0,11534,1529,1644,0,2376,2473,277,0,8299
2017,Chad,Moissala : Point,78,64,0,205,169,7,0,523,85,62,0,125,178,9,0,459
2017,Chad,Moyo : Point,746,716,0,1784,1159,195,0,4600,746,632,0,880,1146,101,0,3505
2017,Chad,N'Djamena : Region,262,441,0,1138,543,54,0,2438,274,405,0,1157,660,74,0,2570
2017,Chad,Ngouboua : Point,86,103,0,326,237,18,0,770,103,107,0,197,231,26,0,664
2017,Chad,Oure Cassoni : Point,2164,2995,0,8220,3656,733,0,17768,2218,2445,0,2973,3508,249,0,11393
2017,Chad,Tchoukoutalia : Point,46,61,0,35,84,*,0,227,32,62,0,15,71,7,0,187
2017,Chad,Touloum : Point,1802,2332,0,6086,2979,653,0,13852,1908,2036,0,2836,3006,345,0,10131
2017,Chad,Treguine : Point,2157,1716,0,5484,2992,610,0,12959,2060,1764,0,3744,3056,460,0,11084
2017,Chad,Vom,132,68,0,253,189,15,0,657,112,52,0,204,161,8,0,537
2017,Chad,Refugees located along the border : point,624,1191,0,845,2318,244,0,5222,627,1181,0,768,1196,155,0,3927
2017,Togo,Avepozo,80,110,0,63,361,12,0,626,99,94,0,66,437,9,0,705
2017,Togo,Dankpen : Prefecture,103,131,0,62,181,33,0,510,98,142,0,72,118,20,0,450
2017,Togo,Lome : Commune,90,122,0,127,560,25,0,924,90,127,0,79,909,33,0,1238
2017,Togo,Site Tandjouare: Prefecture,48,43,0,14,83,10,0,198,45,46,0,17,20,*,0,131
2017,Togo,Sotouboua : Prefecture,368,468,0,138,713,76,0,1763,352,520,0,233,484,73,0,1662
2017,Togo,Tandjoare : Prefecture,666,746,0,326,1254,159,0,3151,637,789,0,252,117,25,0,1820
2017,Thailand,Ban Don Yang : Point,155,273,0,173,720,75,0,1396,167,259,0,203,653,74,0,1356
2017,Thailand,Ban Mae Surin : Point,150,199,0,175,582,54,0,1160,137,197,0,177,559,52,0,1122
2017,Thailand,Mae La : Point,1751,3207,0,2774,9785,1094,0,18611,1895,3301,0,2942,8926,938,0,18002
2017,Thailand,Mae La Oon : Point,693,865,0,703,2292,231,0,4784,753,853,0,705,2209,261,0,4781
2017,Thailand,Mae Ra Ma Luang : Point,695,872,0,834,2625,280,0,5306,785,966,0,845,2397,301,0,5294
2017,Thailand,Mae Sot,0,13,0,11,75,*,0,101,*,6,0,10,127,*,0,148
2017,Thailand,Mai Nai Soi : Point,494,838,0,702,2447,280,0,4761,496,873,0,700,2635,263,0,4967
2017,Thailand,Nu Po : Point,548,954,0,767,2888,247,0,5404,612,920,0,759,2706,245,0,5242
2017,Thailand,Tham Hin : Point,377,633,0,396,1641,155,0,3202,398,595,0,439,1400,150,0,2982
2017,Thailand,Umpium : Point,564,936,0,806,3155,335,0,5796,575,1009,0,856,3078,272,0,5790
2017,Thailand,Bangkok : Metropolitan administration,316,465,0,282,1662,110,0,2835,319,495,0,359,2368,111,0,3652
2017,Thailand,Thailand : Dispersed in the country / territory,22975,24309,0,24070,153394,18276,0,243024,24249,26090,0,24611,151465,17110,0,243525
2017,Tajikistan,Dushanbe : Capital city,0,0,0,0,*,0,0,*,0,0,0,0,6,0,0,6
2017,Tajikistan,Khatlon Province,157,759,0,686,2679,45,0,4326,180,807,0,651,876,38,0,2552
2017,Tajikistan,Khujand : City of provincial subordination,0,0,0,0,0,0,0,0,0,0,0,0,0,0,0,0
2017,Tajikistan,Sughd Province,*,75,0,73,236,14,0,401,16,78,0,77,198,32,0,401
2017,Tajikistan,Tajikistan : Dispersed in the country / territory,0,0,0,0,0,0,0,0,0,0,0,0,0,0,0,0
2017,Tajikistan,Wahdat City,0,0,0,0,0,0,0,0,0,0,0,0,0,0,0,0
2017,Tajikistan,Districts of Republican Subordination,43,184,0,138,906,28,0,1299,50,178,0,159,342,23,0,752
2017,Turkmenistan,Turkmenistan : Dispersed in the country / territory,0,0,0,0,7,5,0,12,0,0,0,0,11,*,0,12
2017,Timor-Leste,Timor-Leste : Dispersed in the country/territory,0,0,0,0,0,0,0,0,0,0,0,0,0,0,0,0
2017,Trinidad and Tobago,Port of Spain : Municipality,36,41,0,34,694,11,0,816,41,39,0,35,1343,9,0,1467
2017,Tunisia,Ben Gardane : Mutamadiyah - Delegation,*,*,0,0,*,0,0,5,0,*,0,*,11,0,0,14
2017,Tunisia,Bizerte : Wilayah - Governorate,*,0,0,*,6,0,0,11,0,0,0,*,8,0,0,11
2017,Tunisia,Gabes : Wilayah - Governorate,9,16,0,10,30,*,0,66,14,10,0,10,35,*,0,71
2017,Tunisia,Gafsa : Wilayah - Governorate,5,15,0,10,29,*,0,62,9,9,0,12,25,*,0,59
2017,Tunisia,Jendouba,0,*,0,0,0,0,0,*,0,*,0,0,*,0,0,*
2017,Tunisia,Kairouan,0,*,0,*,*,0,0,*,0,*,0,0,*,0,0,*
2017,Tunisia,Kebili Governorate,*,*,0,*,*,0,0,5,*,*,0,0,*,0,0,5
2017,Tunisia,Medenine : Wilayah - Governorate,5,*,0,*,13,*,0,26,*,*,0,10,24,0,0,42
2017,Tunisia,Monastir : Mutamadiyah - Delegation,0,0,0,*,*,*,0,*,0,*,0,0,*,0,0,6
2017,Tunisia,Nabeul,0,0,0,*,*,*,0,5,0,*,0,*,*,*,0,6
2017,Tunisia,Sfax : Wilayah - Governorate,*,0,0,*,11,*,0,19,*,*,0,*,14,*,0,19
2017,Tunisia,Sidi Bouzid Governorate,0,*,0,*,6,*,0,9,*,0,0,*,7,0,0,11
2017,Tunisia,Sousse : Wilayah - Governorate,*,*,0,*,13,*,0,23,*,*,0,*,22,*,0,30
2017,Tunisia,Tataouine,*,*,0,*,*,0,0,7,0,*,0,*,*,0,0,6
2017,Tunisia,Tunis : Wilayah - Governorate,6,10,0,8,56,11,0,91,8,18,0,10,105,6,0,147
2017,Turkey,Zonguldak,281,524,0,328,1829,64,0,3026,358,638,0,445,4839,89,0,6369
2017,Turkey,Kutahya : Province,505,869,0,501,2412,109,0,4396,531,919,0,615,4148,123,0,6336
2017,Turkey,Malatya,0,0,0,0,0,0,0,0,0,0,0,0,0,0,0,0
2017,Turkey,Malatya : Province,73,110,0,83,281,7,0,554,62,137,0,86,368,16,0,669
2017,Turkey,Manisa : Province,372,685,0,405,2409,100,0,3971,350,783,0,551,5737,103,0,7524
2017,Turkey,Mardin,0,0,0,0,0,0,0,0,0,0,0,0,0,0,0,0
2017,Turkey,Mardin : Province,210,458,0,400,1217,107,0,2392,197,466,0,399,1127,86,0,2275
2017,Turkey,Mersin : Province,57,144,0,101,472,57,0,831,63,152,0,86,517,61,0,879
2017,Turkey,Mugla,*,0,0,0,*,0,0,*,*,*,0,*,6,*,0,11
2017,Turkey,Mus : Province,0,7,0,0,6,0,0,13,0,*,0,*,8,0,0,12
2017,Turkey,Nevsehir : Province,361,625,0,346,1980,65,0,3377,401,667,0,528,4300,76,0,5972
2017,Turkey,Nigde : Province,73,202,0,127,709,44,0,1155,80,253,0,156,1335,38,0,1862
2017,Turkey,Ordu,347,565,0,288,1441,68,0,2709,356,586,0,385,2421,78,0,3826
2017,Turkey,Osmaniye,0,0,0,0,0,0,0,0,0,0,0,0,0,0,0,0
2017,Turkey,OSMANIYE : Province,0,0,0,0,*,0,0,*,0,0,0,0,0,0,0,0
2017,Turkey,Sakarya : Province,611,1001,0,624,2823,175,0,5234,676,1128,0,817,5931,179,0,8731
2017,Turkey,Adana,0,0,0,0,0,0,0,0,0,0,0,0,0,0,0,0
2017,Turkey,Adana : Province,113,174,0,101,524,32,0,944,97,192,0,155,774,23,0,1241
2017,Turkey,Adiyaman,0,0,0,0,0,0,0,0,0,0,0,0,0,0,0,0
2017,Turkey,Adiyaman : Province,47,75,0,30,176,5,0,333,70,69,0,51,1281,6,0,1477
2017,Turkey,Afyonkarahisar : Province,412,775,0,498,2443,137,0,4265,408,763,0,541,4455,135,0,6302
2017,Turkey,Agri : Province,17,20,0,19,88,*,0,147,12,33,0,69,243,*,0,360
2017,Turkey,Aksaray : Province,510,685,0,411,1862,136,0,3604,552,780,0,518,5233,124,0,7207
2017,Turkey,Amasya : Province,137,324,0,208,916,58,0,1643,158,348,0,246,1322,86,0,2160
2017,Turkey,Ankara : Province,109,153,0,154,591,38,0,1045,110,239,0,310,645,37,0,1341
2017,Turkey,Antalya : Province,*,0,0,*,18,0,0,22,*,*,0,5,21,0,0,31
2017,Turkey,Ardahan : Province,*,*,0,*,13,0,0,20,*,*,0,*,86,0,0,97
2017,Turkey,Artvin,6,12,0,*,34,*,0,57,*,20,0,7,166,*,0,197
2017,Turkey,Aydin,*,*,0,*,6,0,0,12,*,0,0,0,8,*,0,10
2017,Turkey,Balikesir : Province,287,561,0,320,1765,85,0,3018,320,585,0,437,3182,73,0,4597
2017,Turkey,Bartin : Province,*,*,0,0,*,0,0,7,0,0,0,0,*,0,0,*
2017,Turkey,Batman : Province,53,113,0,76,282,15,0,539,51,127,0,95,315,15,0,603
2017,Turkey,Bayburt : Province,11,23,0,20,93,*,0,151,17,45,0,29,516,*,0,611
2017,Turkey,Samsun,924,1566,0,920,3609,240,0,7259,942,1596,0,1036,4686,249,0,8509
2017,Turkey,Sanliurfa,0,0,0,0,0,0,0,0,0,0,0,0,0,0,0,0
2017,Turkey,Bilecik : Province,315,591,0,351,1976,103,0,3336,353,641,0,500,4586,105,0,6185
2017,Turkey,Bingol : Province,0,0,0,0,0,0,0,0,0,0,0,0,*,0,0,*
2017,Turkey,Bitlis : Province,0,*,0,*,*,0,0,*,*,*,0,0,*,0,0,5
2017,Turkey,Bolu : Province,367,638,0,422,1977,114,0,3518,373,735,0,480,2941,119,0,4648
2017,Turkey,Burdur : Province,48,98,0,80,717,24,0,967,75,141,0,95,1196,26,0,1533
2017,Turkey,Bursa : Province,*,*,0,0,9,*,0,12,*,*,0,*,14,0,0,21
2017,Turkey,Sanliurfa : Province,13,45,0,17,92,*,0,171,15,44,0,31,106,6,0,202
2017,Turkey,Canakkale : Province,44,98,0,61,475,10,0,688,49,123,0,101,2805,10,0,3088
2017,Turkey,Cankiri : Province,417,712,0,397,2148,141,0,3815,467,798,0,537,6218,125,0,8145
2017,Turkey,Corum : Province,837,1338,0,700,2809,170,0,5854,811,1511,0,901,3758,151,0,7132
2017,Turkey,Denizli : Province,182,316,0,229,1823,50,0,2600,187,392,0,273,3905,58,0,4815
2017,Turkey,Diyarbakir : Province,70,230,0,189,565,36,0,1090,88,285,0,233,647,24,0,1277
2017,Turkey,Duzce : Province,247,416,0,228,1079,71,0,2041,257,431,0,300,2425,65,0,3478
2017,Turkey,Edirne : Province,*,5,0,*,17,0,0,27,5,*,0,*,28,*,0,42
2017,Turkey,Elazig,84,137,0,95,416,12,0,744,100,179,0,126,1601,20,0,2026
2017,Turkey,Erzincan : Province,158,252,0,153,665,29,0,1257,157,273,0,242,2415,24,0,3111
2017,Turkey,Erzurum : Province,125,215,0,139,527,24,0,1030,149,196,0,175,1458,24,0,2002
2017,Turkey,Eskisehir : Province,437,797,0,462,2271,126,0,4093,542,826,0,597,2901,146,0,5012
2017,Turkey,Gaziantep,0,0,0,0,0,0,0,0,0,0,0,0,0,0,0,0
2017,Turkey,Gaziantep : Province,38,97,0,54,230,18,0,437,46,78,0,70,322,21,0,537
2017,Turkey,Giresun,196,333,0,229,1038,53,0,1849,193,345,0,317,2510,43,0,3408
2017,Turkey,Gumushane : Province,55,118,0,59,369,6,0,607,56,132,0,111,1817,9,0,2125
2017,Turkey,Hakkari : Province,*,*,0,0,*,0,0,*,0,*,0,0,16,0,0,19
2017,Turkey,Hatay,0,0,0,0,0,0,0,0,0,0,0,0,0,0,0,0
2017,Turkey,Hatay : Province,18,28,0,16,49,5,0,116,6,24,0,14,46,5,0,95
2017,Turkey,Igdir : Province,*,6,0,*,22,*,0,37,5,11,0,5,62,*,0,84
2017,Turkey,Siirt : Province,22,62,0,38,135,6,0,263,25,48,0,48,162,7,0,290
2017,Turkey,Sinop : Province,194,393,0,264,1306,44,0,2201,204,448,0,331,2797,57,0,3837
2017,Turkey,Isparta : Province,218,389,0,289,1932,68,0,2896,229,458,0,310,2898,67,0,3962
2017,Turkey,Istanbul : Province,72,223,0,158,1021,57,0,1531,100,253,0,267,1935,94,0,2649
2017,Turkey,Izmir : Province,6,19,0,14,64,*,0,106,*,21,0,18,116,5,0,163
2017,Turkey,Sirnak : Province,29,92,0,68,229,12,0,430,22,88,0,85,244,20,0,459
2017,Turkey,Sivas : Province,342,513,0,361,1598,59,0,2873,348,634,0,458,3406,89,0,4935
2017,Turkey,Tekirdag : Province,*,*,0,*,6,*,0,12,*,*,0,*,11,0,0,15
2017,Turkey,Tokat : Province,372,694,0,466,2206,120,0,3858,376,815,0,638,4917,124,0,6870
2017,Turkey,Trabzon,330,575,0,342,1731,52,0,3030,337,669,0,496,3455,58,0,5015
2017,Turkey,Kahramanmaras,0,0,0,0,0,0,0,0,0,0,0,0,0,0,0,0
2017,Turkey,Kahramanmaras : Province,22,37,0,17,79,5,0,160,12,39,0,21,104,*,0,179
2017,Turkey,Karabuk,346,583,0,375,1778,76,0,3158,351,669,0,458,4822,98,0,6398
2017,Turkey,Usak : Province,352,673,0,367,2153,74,0,3619,396,742,0,548,4326,88,0,6100
2017,Turkey,Karaman : Province,315,510,0,291,1348,59,0,2523,310,601,0,403,4398,62,0,5774
2017,Turkey,Kars : Province,18,38,0,19,76,*,0,153,19,29,0,20,494,*,0,565
2017,Turkey,Kastamonu : Province,306,557,0,357,1768,60,0,3048,336,621,0,473,4149,76,0,5655
2017,Turkey,Kayseri : Province,179,333,0,200,1171,69,0,1952,176,326,0,235,1752,53,0,2542
2017,Turkey,Kilis,0,0,0,0,0,0,0,0,0,0,0,0,0,0,0,0
2017,Turkey,Van : Province,75,123,0,77,524,14,0,813,81,125,0,150,943,23,0,1322
2017,Turkey,Kilis : Province,*,*,0,*,9,0,0,13,*,*,0,0,8,0,0,13
2017,Turkey,Kirikkale : Province,467,724,0,429,2202,110,0,3932,539,807,0,607,3972,104,0,6029
2017,Turkey,Kirklareli : Province,6,8,0,*,23,0,0,41,5,13,0,*,28,0,0,47
2017,Turkey,Yalova : Province,344,577,0,383,2308,145,0,3757,381,666,0,480,5794,133,0,7454
2017,Turkey,Kirsehir : Province,579,788,0,477,2182,155,0,4181,609,904,0,597,3840,161,0,6111
2017,Turkey,Kocaeli,*,*,0,*,12,0,0,19,*,*,0,*,19,*,0,31
2017,Turkey,Konya : Province,392,592,0,335,1691,91,0,3101,431,666,0,493,7486,86,0,9162
2017,Turkey,Yozgat : Province,410,616,0,343,1437,103,0,2909,404,628,0,458,2353,90,0,3933
2017,Turkey,Turkey : Dispersed in the country / territory,35,52,0,38,327,18,0,470,32,62,0,182,889,15,0,1180
2017,United Rep. of Tanzania,Chogo settlement,6,7,0,13,47,0,0,73,5,8,0,11,52,*,0,77
2017,United Rep. of Tanzania,Dar es Salaam,11,17,0,12,63,*,0,105,9,24,0,24,88,*,0,149
2017,United Rep. of Tanzania,Katumba settlement,514,5144,0,6754,22226,1985,0,36623,520,5279,0,6800,22052,2095,0,36746
2017,United Rep. of Tanzania,Kigoma villages,1929,2331,0,2101,4589,309,0,11259,1790,2293,0,2033,5186,486,0,11788
2017,United Rep. of Tanzania,Mishamo settlement,121,4525,0,5453,17042,1763,0,28904,155,4477,0,5413,15193,1782,0,27020
2017,United Rep. of Tanzania,Mtendeli camp,4366,5016,0,3517,9316,572,0,22787,4524,4846,0,3843,8989,539,0,22741
2017,United Rep. of Tanzania,Nduta camp,12589,11966,0,7473,22993,1240,0,56261,12827,12417,0,8497,27360,1303,0,62404
2017,United Rep. of Tanzania,Nyarugusu camp,14825,16902,0,12902,31405,2413,0,78447,13222,16997,0,13058,28786,1784,0,73847
2017,United Rep. of Tanzania,Ulyankulu settlement,184,4103,0,5234,15224,1671,0,26416,182,3944,0,5087,14807,1614,0,25634
2017,Uganda,Adjumani : District,16062,32956,0,22420,45280,4714,0,121432,16735,34228,0,23928,28318,1808,0,105017
2017,Uganda,Imvepi,10469,15768,0,9441,26522,2131,0,64331,10562,16254,0,10279,24650,1008,0,62753
2017,Uganda,Kampala : City,3744,8143,0,7225,29546,858,0,49516,3816,8269,0,7043,34211,839,0,54178
2017,Uganda,Kiryandongo : District,4360,7786,0,5794,10358,889,0,29187,4554,8244,0,6400,8762,492,0,28452
2017,Uganda,Kyaka II,2493,3899,0,2412,7118,540,0,16462,2526,3932,0,2448,6803,485,0,16194
2017,Uganda,Kyaka II RC,0,0,0,0,0,0,0,0,0,0,0,0,0,0,0,0
2017,Uganda,Kyangwali : Point,3953,4402,0,2664,7195,483,0,18697,3993,4578,0,2714,6294,437,0,18016
2017,Uganda,Kyangwali RC,0,0,0,0,0,0,0,0,0,0,0,0,0,0,0,0
2017,Uganda,Lamwo,2065,3053,0,1653,4076,377,0,11224,2189,3391,0,1998,2539,131,0,10248
2017,Uganda,Lamwo RC,0,0,0,0,0,0,0,0,0,0,0,0,0,0,0,0
2017,Uganda,Lobule,276,696,0,523,787,77,0,2359,267,710,0,554,511,40,0,2082
2017,Uganda,Moyo,9942,17456,0,12749,27935,3157,0,71239,10131,17838,0,13230,19414,1502,0,62115
2017,Uganda,Nakivale : Point,8230,11330,0,7970,22048,1110,0,50688,8416,11667,0,7991,22265,982,0,51321
2017,Uganda,Nakivale RC (Nakivale),0,0,0,0,0,0,0,0,0,0,0,0,0,0,0,0
2017,Uganda,Nyakabande TC (Kisoro),0,0,0,0,0,0,0,0,0,0,0,0,0,0,0,0
2017,Uganda,Nyumanzi RC (Adjumani),0,0,0,0,0,0,0,0,0,0,0,0,0,0,0,0
2017,Uganda,Ocea RC (Rhino Camp),0,0,0,0,0,0,0,0,0,0,0,0,0,0,0,0
2017,Uganda,Oruchinga : Point,580,831,0,537,1467,89,0,3504,613,869,0,523,1261,82,0,3348
2017,Uganda,Palorinya RC (Moyo),0,0,0,0,0,0,0,0,0,0,0,0,0,0,0,0
2017,Uganda,Rhino Camp : Point,8091,15168,0,10452,25541,1615,0,60867,8113,15179,0,11312,24165,777,0,59546
2017,Uganda,Rwamanja : Point,8428,9660,0,4635,14876,925,0,38524,8322,9395,0,4719,15226,849,0,38511
2017,Uganda,Yumbe,29466,45145,0,26277,45571,4558,0,151017,29045,46969,0,28331,29703,2022,0,136070
2017,Uganda,Uganda : Dispersed in the country / territory,0,0,0,0,0,0,0,0,0,0,0,0,*,0,0,*
2017,Ukraine,Ukraine : Dispersed in the country / territory,0,0,0,0,0,0,0,0,0,0,0,0,0,0,0,0
2017,Uruguay,Montevideo : Department,13,31,0,26,611,17,0,698,9,27,0,20,1666,30,0,1752
2017,United States of America,United States of America : Dispersed in the country / territory,0,0,0,0,0,0,0,0,0,0,0,0,0,0,0,0
2017,Uzbekistan,Uzbekistan: Dispersed in the country,0,0,0,*,*,*,0,8,0,0,0,*,10,*,0,13
2017,Venezuela (Bolivarian Republic of),Bolivar,*,*,0,5,12,0,0,22,*,6,0,*,9,*,0,23
2017,Venezuela (Bolivarian Republic of),Apure : Point,8,8,0,15,29,*,0,63,*,12,0,16,34,5,0,69
2017,Venezuela (Bolivarian Republic of),Caracas : Point,0,*,0,0,5,7,0,15,*,*,0,*,5,7,0,15
2017,Venezuela (Bolivarian Republic of),Tachira : Point,8,27,0,33,96,5,0,169,15,25,0,29,105,10,0,184
2017,Venezuela (Bolivarian Republic of),Venezuela : Dispersed in the country / territory,558,743,0,929,1301,186,0,3717,604,805,0,1007,1409,201,0,4026
2017,Venezuela (Bolivarian Republic of),Zulia : Point,25,45,0,35,60,0,0,165,22,12,0,47,95,*,0,179
2017,British Virgin Islands,British Virgin Islands : Dispersed in the country / territory,0,0,0,0,0,0,0,0,0,0,0,0,*,0,0,*
2017,Viet Nam,Viet Nam : Dispersed in the country / territory,0,0,0,0,0,0,0,0,0,0,0,0,0,0,0,0
2017,Samoa,Apia,*,0,0,0,*,0,0,*,0,0,0,0,*,0,0,*
2017,Yemen,Lahij: Muhafazah ?Çô Governorate,2118,8458,0,5536,16027,1201,0,33340,2502,7771,0,9850,16306,1106,0,37535
2017,Yemen,Ma'arib: Muhafazah - Governorate,2887,9741,0,5775,16249,1445,0,36097,3004,7514,0,10517,15416,1128,0,37579
2017,Yemen,Raymah: Muhafazah - Governorate,2145,7241,0,4290,12067,1073,0,26816,1980,4950,0,6930,10150,744,0,24754
2017,Yemen,Sa'dah : Muhafazah - Governorate,0,*,0,5,29,6,0,42,0,*,0,*,63,5,0,73
2017,Yemen,Sa'dah': Muhafazah - Governorate,4468,15081,0,8937,25134,2234,0,55854,3962,9906,0,13869,20307,1486,0,49530
2017,Yemen,Sana?ÇÖa: Muhafazah ?Çô Governorate,6146,20748,0,12283,34683,3075,0,76935,5937,14762,0,20641,30411,2221,0,73972
2017,Yemen,Shabwah: Muhafazah - Governorate,681,2437,0,1362,4165,391,0,9036,746,2164,0,2933,3151,318,0,9312
2017,Yemen,Socotra: Muhafazah - Governorate,58,233,0,584,520,5,0,1400,109,60,0,379,449,*,0,1000
2017,Yemen,Taizz: Muhafazah - Governorate,12160,41118,0,24483,69242,6153,0,153156,13173,33032,0,46241,68095,4995,0,165536
2017,Yemen,Dhamar : Muhafazah - Governorate,1018,3445,0,2043,5784,519,0,12809,1060,2667,0,3719,5559,421,0,13426
2017,Yemen,Dhamar: Muhafazah - Governorate,4760,16063,0,9519,26772,2380,0,59494,4954,12384,0,17332,25388,1858,0,61916
2017,Yemen,Abyan: Muhafazah - Governorate,682,2303,0,1365,3839,341,0,8530,581,1454,0,2035,2980,218,0,7268
2017,Yemen,Hadramawt: Muhafazah - Governorate,630,1959,0,1727,5500,429,0,10245,533,1876,0,2658,7464,502,0,13033
2017,Yemen,Abyan: Muhafazah ?Çô Governorate,0,*,0,*,5,*,0,12,0,*,0,0,13,*,0,17
2017,Yemen,Hajjah : Muhafazah - Governorate,1684,6062,0,3569,11043,893,0,23251,1758,4345,0,6504,10529,697,0,23833
2017,Yemen,Aden: Muhafazah - Governorate,1477,4987,0,2958,8326,741,0,18489,1805,4516,0,6328,9269,679,0,22597
2017,Yemen,Hajjah: Muhafazah - Governorate,14800,49951,0,29602,83242,7110,0,184705,15405,38511,0,53880,77948,5577,0,191321
2017,Yemen,Aden: Muhafazah ?Çô Governorate,287,1400,0,1266,12984,533,0,16470,306,1501,0,1619,33379,598,0,37403
2017,Yemen,Al Bayda: Muhafazah - Governorate,1458,4921,0,2914,8235,730,0,18258,1346,3372,0,4709,7051,509,0,16987
2017,Yemen,Al Dali: Muhafazah - Governorate,1056,3563,0,2113,5947,527,0,13206,1099,2745,0,3847,5636,412,0,13739
2017,Yemen,Ibb: Muhafazah - Governorate,5502,18577,0,11022,31001,2755,0,68857,5505,13729,0,19165,28277,2075,0,68751
2017,Yemen,Al Hudaydah: Muhafazah - Governorate,4035,13629,0,8057,22255,2028,0,50004,4245,10314,0,15944,22624,1665,0,54792
2017,Yemen,Al Jawf : Muhafazah - Governorate,0,*,0,*,9,*,0,13,0,*,0,*,11,*,0,18
2017,Yemen,Al Jawf: Muhafazah - Governorate,2150,6256,0,4112,11864,970,0,25352,1764,3149,0,6174,9041,642,0,20770
2017,Yemen,Al Maharah: Muhafazah ?Çô Governorate,*,204,0,99,456,12,0,772,0,194,0,102,1119,36,0,1451
2017,Yemen,Al Mahrah: Muhafazah - Governorate,154,519,0,307,864,77,0,1921,136,341,0,477,698,51,0,1703
2017,Yemen,Al Mahwit: Muhafazah - Governorate,1874,6315,0,3741,10530,936,0,23396,1727,4318,0,6044,8856,648,0,21593
2017,Yemen,Amran : Muhafazah - Governorate,0,*,0,*,5,*,0,8,0,*,0,*,13,0,0,20
2017,Yemen,Lahij: Muhafazah - Governorate,140,472,0,289,842,70,0,1813,149,378,0,520,881,55,0,1983
2017,Yemen,Amran: Muhafazah - Governorate,6293,21631,0,12777,35468,3219,0,79388,6186,15466,0,21652,31300,2320,0,76924
2017,Yemen,Amanat Al Asimah: Muhafazah - Governorate,7214,25062,0,15462,52685,4275,0,104698,7333,19596,0,25561,50872,3507,0,106869
2017,Yemen,Yemen: Dispersed in the country/territory,680,7330,0,6666,43125,2305,0,60106,728,7907,0,6496,72200,2295,0,89626
2017,South Africa,South Africa : Dispersed in the country / territory,0,0,0,0,0,0,0,0,0,0,0,0,0,0,0,0
2017,Zambia,Lusaka : District,713,1058,0,821,2452,73,0,5117,704,996,0,850,3967,165,0,6682
2017,Zambia,Mayukwayukwa : Point,972,1255,0,849,2553,139,0,5768,959,1294,0,814,2648,321,0,6036
2017,Zambia,Meheba : Point,1475,2238,0,1531,3846,289,0,9379,1452,2279,0,1626,4382,450,0,10189
2017,Zambia,Nchelenge,1420,1553,0,861,2564,171,0,6569,1420,1503,0,886,2264,123,0,6196
2017,Zambia,Zambia : Dispersed in the country / territory,637,1444,0,979,2712,400,0,6172,602,1314,0,1018,2786,512,0,6232
2017,Zimbabwe,Manicaland : Province,740,1171,0,802,2115,85,0,4913,780,1191,0,933,2658,97,0,5659
2017,Zimbabwe,Harare : City,242,120,0,98,331,28,0,819,202,155,0,73,456,12,0,898
